,cid,label,left,right,top,bottom,width,height,score
0,2,car,591,911,482,650,320,168,0.99045604
0,2,car,593,912,482,651,319,169,0.99101853
1,2,car,591,911,482,650,320,168,0.99045604
0,2,car,592,912,482,651,320,169,0.9904916
1,2,car,593,912,482,651,319,169,0.99101853
2,2,car,591,911,482,650,320,168,0.99045604
0,2,car,723,1189,491,680,466,189,0.9941147
1,2,car,592,912,482,651,320,169,0.9904916
2,2,car,593,912,482,651,319,169,0.99101853
3,2,car,591,911,482,650,320,168,0.99045604
0,2,car,722,1191,490,681,469,191,0.9944046
1,2,car,723,1189,491,680,466,189,0.9941147
2,2,car,592,912,482,651,320,169,0.9904916
3,2,car,593,912,482,651,319,169,0.99101853
4,2,car,591,911,482,650,320,168,0.99045604
0,2,car,723,1190,490,680,467,190,0.993658
1,2,car,722,1191,490,681,469,191,0.9944046
2,2,car,723,1189,491,680,466,189,0.9941147
3,2,car,592,912,482,651,320,169,0.9904916
4,2,car,593,912,482,651,319,169,0.99101853
5,2,car,591,911,482,650,320,168,0.99045604
0,2,car,720,1189,490,681,469,191,0.99338204
1,2,car,723,1190,490,680,467,190,0.993658
2,2,car,722,1191,490,681,469,191,0.9944046
3,2,car,723,1189,491,680,466,189,0.9941147
4,2,car,592,912,482,651,320,169,0.9904916
5,2,car,593,912,482,651,319,169,0.99101853
6,2,car,591,911,482,650,320,168,0.99045604
0,2,car,720,1192,491,680,472,189,0.9947525
1,2,car,720,1189,490,681,469,191,0.99338204
2,2,car,723,1190,490,680,467,190,0.993658
3,2,car,722,1191,490,681,469,191,0.9944046
4,2,car,723,1189,491,680,466,189,0.9941147
5,2,car,592,912,482,651,320,169,0.9904916
6,2,car,593,912,482,651,319,169,0.99101853
7,2,car,591,911,482,650,320,168,0.99045604
0,2,car,720,1189,491,679,469,188,0.99389535
1,2,car,720,1192,491,680,472,189,0.9947525
2,2,car,720,1189,490,681,469,191,0.99338204
3,2,car,723,1190,490,680,467,190,0.993658
4,2,car,722,1191,490,681,469,191,0.9944046
5,2,car,723,1189,491,680,466,189,0.9941147
6,2,car,592,912,482,651,320,169,0.9904916
7,2,car,593,912,482,651,319,169,0.99101853
8,2,car,591,911,482,650,320,168,0.99045604
0,2,car,723,1190,491,680,467,189,0.9925984
1,2,car,720,1189,491,679,469,188,0.99389535
2,2,car,720,1192,491,680,472,189,0.9947525
3,2,car,720,1189,490,681,469,191,0.99338204
4,2,car,723,1190,490,680,467,190,0.993658
5,2,car,722,1191,490,681,469,191,0.9944046
6,2,car,723,1189,491,680,466,189,0.9941147
7,2,car,592,912,482,651,320,169,0.9904916
8,2,car,593,912,482,651,319,169,0.99101853
9,2,car,591,911,482,650,320,168,0.99045604
0,2,car,723,1188,491,680,465,189,0.9940172
1,2,car,723,1190,491,680,467,189,0.9925984
2,2,car,720,1189,491,679,469,188,0.99389535
3,2,car,720,1192,491,680,472,189,0.9947525
4,2,car,720,1189,490,681,469,191,0.99338204
5,2,car,723,1190,490,680,467,190,0.993658
6,2,car,722,1191,490,681,469,191,0.9944046
7,2,car,723,1189,491,680,466,189,0.9941147
8,2,car,592,912,482,651,320,169,0.9904916
9,2,car,593,912,482,651,319,169,0.99101853
10,2,car,591,911,482,650,320,168,0.99045604
0,2,car,720,1190,490,680,470,190,0.99366015
1,2,car,723,1188,491,680,465,189,0.9940172
2,2,car,723,1190,491,680,467,189,0.9925984
3,2,car,720,1189,491,679,469,188,0.99389535
4,2,car,720,1192,491,680,472,189,0.9947525
5,2,car,720,1189,490,681,469,191,0.99338204
6,2,car,723,1190,490,680,467,190,0.993658
7,2,car,722,1191,490,681,469,191,0.9944046
8,2,car,723,1189,491,680,466,189,0.9941147
9,2,car,592,912,482,651,320,169,0.9904916
10,2,car,593,912,482,651,319,169,0.99101853
11,2,car,591,911,482,650,320,168,0.99045604
0,2,car,720,1190,490,680,470,190,0.99316007
1,2,car,720,1190,490,680,470,190,0.99366015
2,2,car,723,1188,491,680,465,189,0.9940172
3,2,car,723,1190,491,680,467,189,0.9925984
4,2,car,720,1189,491,679,469,188,0.99389535
5,2,car,720,1192,491,680,472,189,0.9947525
6,2,car,720,1189,490,681,469,191,0.99338204
7,2,car,723,1190,490,680,467,190,0.993658
8,2,car,722,1191,490,681,469,191,0.9944046
9,2,car,723,1189,491,680,466,189,0.9941147
10,2,car,592,912,482,651,320,169,0.9904916
11,2,car,593,912,482,651,319,169,0.99101853
12,2,car,591,911,482,650,320,168,0.99045604
0,2,car,721,1190,490,680,469,190,0.9935835
1,2,car,720,1190,490,680,470,190,0.99316007
2,2,car,720,1190,490,680,470,190,0.99366015
3,2,car,723,1188,491,680,465,189,0.9940172
4,2,car,723,1190,491,680,467,189,0.9925984
5,2,car,720,1189,491,679,469,188,0.99389535
6,2,car,720,1192,491,680,472,189,0.9947525
7,2,car,720,1189,490,681,469,191,0.99338204
8,2,car,723,1190,490,680,467,190,0.993658
9,2,car,722,1191,490,681,469,191,0.9944046
10,2,car,723,1189,491,680,466,189,0.9941147
11,2,car,592,912,482,651,320,169,0.9904916
12,2,car,593,912,482,651,319,169,0.99101853
13,2,car,591,911,482,650,320,168,0.99045604
0,2,car,720,1190,491,680,470,189,0.99439865
1,2,car,721,1190,490,680,469,190,0.9935835
2,2,car,720,1190,490,680,470,190,0.99316007
3,2,car,720,1190,490,680,470,190,0.99366015
4,2,car,723,1188,491,680,465,189,0.9940172
5,2,car,723,1190,491,680,467,189,0.9925984
6,2,car,720,1189,491,679,469,188,0.99389535
7,2,car,720,1192,491,680,472,189,0.9947525
8,2,car,720,1189,490,681,469,191,0.99338204
9,2,car,723,1190,490,680,467,190,0.993658
10,2,car,722,1191,490,681,469,191,0.9944046
11,2,car,723,1189,491,680,466,189,0.9941147
12,2,car,592,912,482,651,320,169,0.9904916
13,2,car,593,912,482,651,319,169,0.99101853
14,2,car,591,911,482,650,320,168,0.99045604
0,2,car,721,1188,491,679,467,188,0.9941135
1,2,car,720,1190,491,680,470,189,0.99439865
2,2,car,721,1190,490,680,469,190,0.9935835
3,2,car,720,1190,490,680,470,190,0.99316007
4,2,car,720,1190,490,680,470,190,0.99366015
5,2,car,723,1188,491,680,465,189,0.9940172
6,2,car,723,1190,491,680,467,189,0.9925984
7,2,car,720,1189,491,679,469,188,0.99389535
8,2,car,720,1192,491,680,472,189,0.9947525
9,2,car,720,1189,490,681,469,191,0.99338204
10,2,car,723,1190,490,680,467,190,0.993658
11,2,car,722,1191,490,681,469,191,0.9944046
12,2,car,723,1189,491,680,466,189,0.9941147
13,2,car,592,912,482,651,320,169,0.9904916
14,2,car,593,912,482,651,319,169,0.99101853
15,2,car,591,911,482,650,320,168,0.99045604
0,2,car,721,1189,490,680,468,190,0.99420947
1,2,car,721,1188,491,679,467,188,0.9941135
2,2,car,720,1190,491,680,470,189,0.99439865
3,2,car,721,1190,490,680,469,190,0.9935835
4,2,car,720,1190,490,680,470,190,0.99316007
5,2,car,720,1190,490,680,470,190,0.99366015
6,2,car,723,1188,491,680,465,189,0.9940172
7,2,car,723,1190,491,680,467,189,0.9925984
8,2,car,720,1189,491,679,469,188,0.99389535
9,2,car,720,1192,491,680,472,189,0.9947525
10,2,car,720,1189,490,681,469,191,0.99338204
11,2,car,723,1190,490,680,467,190,0.993658
12,2,car,722,1191,490,681,469,191,0.9944046
13,2,car,723,1189,491,680,466,189,0.9941147
14,2,car,592,912,482,651,320,169,0.9904916
15,2,car,593,912,482,651,319,169,0.99101853
16,2,car,591,911,482,650,320,168,0.99045604
0,2,car,720,1190,491,680,470,189,0.9939705
1,2,car,721,1189,490,680,468,190,0.99420947
2,2,car,721,1188,491,679,467,188,0.9941135
3,2,car,720,1190,491,680,470,189,0.99439865
4,2,car,721,1190,490,680,469,190,0.9935835
5,2,car,720,1190,490,680,470,190,0.99316007
6,2,car,720,1190,490,680,470,190,0.99366015
7,2,car,723,1188,491,680,465,189,0.9940172
8,2,car,723,1190,491,680,467,189,0.9925984
9,2,car,720,1189,491,679,469,188,0.99389535
10,2,car,720,1192,491,680,472,189,0.9947525
11,2,car,720,1189,490,681,469,191,0.99338204
12,2,car,723,1190,490,680,467,190,0.993658
13,2,car,722,1191,490,681,469,191,0.9944046
14,2,car,723,1189,491,680,466,189,0.9941147
15,2,car,592,912,482,651,320,169,0.9904916
16,2,car,593,912,482,651,319,169,0.99101853
17,2,car,591,911,482,650,320,168,0.99045604
0,2,car,718,1192,491,680,474,189,0.9946807
1,2,car,720,1190,491,680,470,189,0.9939705
2,2,car,721,1189,490,680,468,190,0.99420947
3,2,car,721,1188,491,679,467,188,0.9941135
4,2,car,720,1190,491,680,470,189,0.99439865
5,2,car,721,1190,490,680,469,190,0.9935835
6,2,car,720,1190,490,680,470,190,0.99316007
7,2,car,720,1190,490,680,470,190,0.99366015
8,2,car,723,1188,491,680,465,189,0.9940172
9,2,car,723,1190,491,680,467,189,0.9925984
10,2,car,720,1189,491,679,469,188,0.99389535
11,2,car,720,1192,491,680,472,189,0.9947525
12,2,car,720,1189,490,681,469,191,0.99338204
13,2,car,723,1190,490,680,467,190,0.993658
14,2,car,722,1191,490,681,469,191,0.9944046
15,2,car,723,1189,491,680,466,189,0.9941147
16,2,car,592,912,482,651,320,169,0.9904916
17,2,car,593,912,482,651,319,169,0.99101853
18,2,car,591,911,482,650,320,168,0.99045604
0,2,car,721,1190,490,681,469,191,0.9950352
1,2,car,718,1192,491,680,474,189,0.9946807
2,2,car,720,1190,491,680,470,189,0.9939705
3,2,car,721,1189,490,680,468,190,0.99420947
4,2,car,721,1188,491,679,467,188,0.9941135
5,2,car,720,1190,491,680,470,189,0.99439865
6,2,car,721,1190,490,680,469,190,0.9935835
7,2,car,720,1190,490,680,470,190,0.99316007
8,2,car,720,1190,490,680,470,190,0.99366015
9,2,car,723,1188,491,680,465,189,0.9940172
10,2,car,723,1190,491,680,467,189,0.9925984
11,2,car,720,1189,491,679,469,188,0.99389535
12,2,car,720,1192,491,680,472,189,0.9947525
13,2,car,720,1189,490,681,469,191,0.99338204
14,2,car,723,1190,490,680,467,190,0.993658
15,2,car,722,1191,490,681,469,191,0.9944046
16,2,car,723,1189,491,680,466,189,0.9941147
17,2,car,592,912,482,651,320,169,0.9904916
18,2,car,593,912,482,651,319,169,0.99101853
19,2,car,591,911,482,650,320,168,0.99045604
0,2,car,719,1191,490,680,472,190,0.99448395
1,2,car,721,1190,490,681,469,191,0.9950352
2,2,car,718,1192,491,680,474,189,0.9946807
3,2,car,720,1190,491,680,470,189,0.9939705
4,2,car,721,1189,490,680,468,190,0.99420947
5,2,car,721,1188,491,679,467,188,0.9941135
6,2,car,720,1190,491,680,470,189,0.99439865
7,2,car,721,1190,490,680,469,190,0.9935835
8,2,car,720,1190,490,680,470,190,0.99316007
9,2,car,720,1190,490,680,470,190,0.99366015
10,2,car,723,1188,491,680,465,189,0.9940172
11,2,car,723,1190,491,680,467,189,0.9925984
12,2,car,720,1189,491,679,469,188,0.99389535
13,2,car,720,1192,491,680,472,189,0.9947525
14,2,car,720,1189,490,681,469,191,0.99338204
15,2,car,723,1190,490,680,467,190,0.993658
16,2,car,722,1191,490,681,469,191,0.9944046
17,2,car,723,1189,491,680,466,189,0.9941147
18,2,car,592,912,482,651,320,169,0.9904916
19,2,car,593,912,482,651,319,169,0.99101853
20,2,car,591,911,482,650,320,168,0.99045604
0,2,car,722,1192,491,679,470,188,0.9947086
1,2,car,719,1191,490,680,472,190,0.99448395
2,2,car,721,1190,490,681,469,191,0.9950352
3,2,car,718,1192,491,680,474,189,0.9946807
4,2,car,720,1190,491,680,470,189,0.9939705
5,2,car,721,1189,490,680,468,190,0.99420947
6,2,car,721,1188,491,679,467,188,0.9941135
7,2,car,720,1190,491,680,470,189,0.99439865
8,2,car,721,1190,490,680,469,190,0.9935835
9,2,car,720,1190,490,680,470,190,0.99316007
10,2,car,720,1190,490,680,470,190,0.99366015
11,2,car,723,1188,491,680,465,189,0.9940172
12,2,car,723,1190,491,680,467,189,0.9925984
13,2,car,720,1189,491,679,469,188,0.99389535
14,2,car,720,1192,491,680,472,189,0.9947525
15,2,car,720,1189,490,681,469,191,0.99338204
16,2,car,723,1190,490,680,467,190,0.993658
17,2,car,722,1191,490,681,469,191,0.9944046
18,2,car,723,1189,491,680,466,189,0.9941147
19,2,car,592,912,482,651,320,169,0.9904916
20,2,car,593,912,482,651,319,169,0.99101853
21,2,car,591,911,482,650,320,168,0.99045604
0,2,car,721,1191,490,681,470,191,0.9934978
1,2,car,722,1192,491,679,470,188,0.9947086
2,2,car,719,1191,490,680,472,190,0.99448395
3,2,car,721,1190,490,681,469,191,0.9950352
4,2,car,718,1192,491,680,474,189,0.9946807
5,2,car,720,1190,491,680,470,189,0.9939705
6,2,car,721,1189,490,680,468,190,0.99420947
7,2,car,721,1188,491,679,467,188,0.9941135
8,2,car,720,1190,491,680,470,189,0.99439865
9,2,car,721,1190,490,680,469,190,0.9935835
10,2,car,720,1190,490,680,470,190,0.99316007
11,2,car,720,1190,490,680,470,190,0.99366015
12,2,car,723,1188,491,680,465,189,0.9940172
13,2,car,723,1190,491,680,467,189,0.9925984
14,2,car,720,1189,491,679,469,188,0.99389535
15,2,car,720,1192,491,680,472,189,0.9947525
16,2,car,720,1189,490,681,469,191,0.99338204
17,2,car,723,1190,490,680,467,190,0.993658
18,2,car,722,1191,490,681,469,191,0.9944046
19,2,car,723,1189,491,680,466,189,0.9941147
20,2,car,592,912,482,651,320,169,0.9904916
21,2,car,593,912,482,651,319,169,0.99101853
22,2,car,591,911,482,650,320,168,0.99045604
0,2,car,722,1189,490,681,467,191,0.99316216
1,2,car,721,1191,490,681,470,191,0.9934978
2,2,car,722,1192,491,679,470,188,0.9947086
3,2,car,719,1191,490,680,472,190,0.99448395
4,2,car,721,1190,490,681,469,191,0.9950352
5,2,car,718,1192,491,680,474,189,0.9946807
6,2,car,720,1190,491,680,470,189,0.9939705
7,2,car,721,1189,490,680,468,190,0.99420947
8,2,car,721,1188,491,679,467,188,0.9941135
9,2,car,720,1190,491,680,470,189,0.99439865
10,2,car,721,1190,490,680,469,190,0.9935835
11,2,car,720,1190,490,680,470,190,0.99316007
12,2,car,720,1190,490,680,470,190,0.99366015
13,2,car,723,1188,491,680,465,189,0.9940172
14,2,car,723,1190,491,680,467,189,0.9925984
15,2,car,720,1189,491,679,469,188,0.99389535
16,2,car,720,1192,491,680,472,189,0.9947525
17,2,car,720,1189,490,681,469,191,0.99338204
18,2,car,723,1190,490,680,467,190,0.993658
19,2,car,722,1191,490,681,469,191,0.9944046
20,2,car,723,1189,491,680,466,189,0.9941147
21,2,car,592,912,482,651,320,169,0.9904916
22,2,car,593,912,482,651,319,169,0.99101853
23,2,car,591,911,482,650,320,168,0.99045604
0,2,car,722,1188,490,681,466,191,0.9941867
1,2,car,722,1189,490,681,467,191,0.99316216
2,2,car,721,1191,490,681,470,191,0.9934978
3,2,car,722,1192,491,679,470,188,0.9947086
4,2,car,719,1191,490,680,472,190,0.99448395
5,2,car,721,1190,490,681,469,191,0.9950352
6,2,car,718,1192,491,680,474,189,0.9946807
7,2,car,720,1190,491,680,470,189,0.9939705
8,2,car,721,1189,490,680,468,190,0.99420947
9,2,car,721,1188,491,679,467,188,0.9941135
10,2,car,720,1190,491,680,470,189,0.99439865
11,2,car,721,1190,490,680,469,190,0.9935835
12,2,car,720,1190,490,680,470,190,0.99316007
13,2,car,720,1190,490,680,470,190,0.99366015
14,2,car,723,1188,491,680,465,189,0.9940172
15,2,car,723,1190,491,680,467,189,0.9925984
16,2,car,720,1189,491,679,469,188,0.99389535
17,2,car,720,1192,491,680,472,189,0.9947525
18,2,car,720,1189,490,681,469,191,0.99338204
19,2,car,723,1190,490,680,467,190,0.993658
20,2,car,722,1191,490,681,469,191,0.9944046
21,2,car,723,1189,491,680,466,189,0.9941147
22,2,car,592,912,482,651,320,169,0.9904916
23,2,car,593,912,482,651,319,169,0.99101853
24,2,car,591,911,482,650,320,168,0.99045604
0,2,car,720,1188,490,681,468,191,0.9936452
1,2,car,722,1188,490,681,466,191,0.9941867
2,2,car,722,1189,490,681,467,191,0.99316216
3,2,car,721,1191,490,681,470,191,0.9934978
4,2,car,722,1192,491,679,470,188,0.9947086
5,2,car,719,1191,490,680,472,190,0.99448395
6,2,car,721,1190,490,681,469,191,0.9950352
7,2,car,718,1192,491,680,474,189,0.9946807
8,2,car,720,1190,491,680,470,189,0.9939705
9,2,car,721,1189,490,680,468,190,0.99420947
10,2,car,721,1188,491,679,467,188,0.9941135
11,2,car,720,1190,491,680,470,189,0.99439865
12,2,car,721,1190,490,680,469,190,0.9935835
13,2,car,720,1190,490,680,470,190,0.99316007
14,2,car,720,1190,490,680,470,190,0.99366015
15,2,car,723,1188,491,680,465,189,0.9940172
16,2,car,723,1190,491,680,467,189,0.9925984
17,2,car,720,1189,491,679,469,188,0.99389535
18,2,car,720,1192,491,680,472,189,0.9947525
19,2,car,720,1189,490,681,469,191,0.99338204
20,2,car,723,1190,490,680,467,190,0.993658
21,2,car,722,1191,490,681,469,191,0.9944046
22,2,car,723,1189,491,680,466,189,0.9941147
23,2,car,592,912,482,651,320,169,0.9904916
24,2,car,593,912,482,651,319,169,0.99101853
25,2,car,591,911,482,650,320,168,0.99045604
0,2,car,720,1192,491,680,472,189,0.99402833
1,2,car,720,1188,490,681,468,191,0.9936452
2,2,car,722,1188,490,681,466,191,0.9941867
3,2,car,722,1189,490,681,467,191,0.99316216
4,2,car,721,1191,490,681,470,191,0.9934978
5,2,car,722,1192,491,679,470,188,0.9947086
6,2,car,719,1191,490,680,472,190,0.99448395
7,2,car,721,1190,490,681,469,191,0.9950352
8,2,car,718,1192,491,680,474,189,0.9946807
9,2,car,720,1190,491,680,470,189,0.9939705
10,2,car,721,1189,490,680,468,190,0.99420947
11,2,car,721,1188,491,679,467,188,0.9941135
12,2,car,720,1190,491,680,470,189,0.99439865
13,2,car,721,1190,490,680,469,190,0.9935835
14,2,car,720,1190,490,680,470,190,0.99316007
15,2,car,720,1190,490,680,470,190,0.99366015
16,2,car,723,1188,491,680,465,189,0.9940172
17,2,car,723,1190,491,680,467,189,0.9925984
18,2,car,720,1189,491,679,469,188,0.99389535
19,2,car,720,1192,491,680,472,189,0.9947525
20,2,car,720,1189,490,681,469,191,0.99338204
21,2,car,723,1190,490,680,467,190,0.993658
22,2,car,722,1191,490,681,469,191,0.9944046
23,2,car,723,1189,491,680,466,189,0.9941147
24,2,car,592,912,482,651,320,169,0.9904916
25,2,car,593,912,482,651,319,169,0.99101853
26,2,car,591,911,482,650,320,168,0.99045604
0,2,car,718,1192,490,680,474,190,0.99396724
1,2,car,720,1192,491,680,472,189,0.99402833
2,2,car,720,1188,490,681,468,191,0.9936452
3,2,car,722,1188,490,681,466,191,0.9941867
4,2,car,722,1189,490,681,467,191,0.99316216
5,2,car,721,1191,490,681,470,191,0.9934978
6,2,car,722,1192,491,679,470,188,0.9947086
7,2,car,719,1191,490,680,472,190,0.99448395
8,2,car,721,1190,490,681,469,191,0.9950352
9,2,car,718,1192,491,680,474,189,0.9946807
10,2,car,720,1190,491,680,470,189,0.9939705
11,2,car,721,1189,490,680,468,190,0.99420947
12,2,car,721,1188,491,679,467,188,0.9941135
13,2,car,720,1190,491,680,470,189,0.99439865
14,2,car,721,1190,490,680,469,190,0.9935835
15,2,car,720,1190,490,680,470,190,0.99316007
16,2,car,720,1190,490,680,470,190,0.99366015
17,2,car,723,1188,491,680,465,189,0.9940172
18,2,car,723,1190,491,680,467,189,0.9925984
19,2,car,720,1189,491,679,469,188,0.99389535
20,2,car,720,1192,491,680,472,189,0.9947525
21,2,car,720,1189,490,681,469,191,0.99338204
22,2,car,723,1190,490,680,467,190,0.993658
23,2,car,722,1191,490,681,469,191,0.9944046
24,2,car,723,1189,491,680,466,189,0.9941147
25,2,car,592,912,482,651,320,169,0.9904916
26,2,car,593,912,482,651,319,169,0.99101853
27,2,car,591,911,482,650,320,168,0.99045604
0,2,car,722,1190,490,680,468,190,0.99356544
1,2,car,718,1192,490,680,474,190,0.99396724
2,2,car,720,1192,491,680,472,189,0.99402833
3,2,car,720,1188,490,681,468,191,0.9936452
4,2,car,722,1188,490,681,466,191,0.9941867
5,2,car,722,1189,490,681,467,191,0.99316216
6,2,car,721,1191,490,681,470,191,0.9934978
7,2,car,722,1192,491,679,470,188,0.9947086
8,2,car,719,1191,490,680,472,190,0.99448395
9,2,car,721,1190,490,681,469,191,0.9950352
10,2,car,718,1192,491,680,474,189,0.9946807
11,2,car,720,1190,491,680,470,189,0.9939705
12,2,car,721,1189,490,680,468,190,0.99420947
13,2,car,721,1188,491,679,467,188,0.9941135
14,2,car,720,1190,491,680,470,189,0.99439865
15,2,car,721,1190,490,680,469,190,0.9935835
16,2,car,720,1190,490,680,470,190,0.99316007
17,2,car,720,1190,490,680,470,190,0.99366015
18,2,car,723,1188,491,680,465,189,0.9940172
19,2,car,723,1190,491,680,467,189,0.9925984
20,2,car,720,1189,491,679,469,188,0.99389535
21,2,car,720,1192,491,680,472,189,0.9947525
22,2,car,720,1189,490,681,469,191,0.99338204
23,2,car,723,1190,490,680,467,190,0.993658
24,2,car,722,1191,490,681,469,191,0.9944046
25,2,car,723,1189,491,680,466,189,0.9941147
26,2,car,592,912,482,651,320,169,0.9904916
27,2,car,593,912,482,651,319,169,0.99101853
28,2,car,591,911,482,650,320,168,0.99045604
0,2,car,722,1192,490,680,470,190,0.9945114
1,2,car,722,1190,490,680,468,190,0.99356544
2,2,car,718,1192,490,680,474,190,0.99396724
3,2,car,720,1192,491,680,472,189,0.99402833
4,2,car,720,1188,490,681,468,191,0.9936452
5,2,car,722,1188,490,681,466,191,0.9941867
6,2,car,722,1189,490,681,467,191,0.99316216
7,2,car,721,1191,490,681,470,191,0.9934978
8,2,car,722,1192,491,679,470,188,0.9947086
9,2,car,719,1191,490,680,472,190,0.99448395
10,2,car,721,1190,490,681,469,191,0.9950352
11,2,car,718,1192,491,680,474,189,0.9946807
12,2,car,720,1190,491,680,470,189,0.9939705
13,2,car,721,1189,490,680,468,190,0.99420947
14,2,car,721,1188,491,679,467,188,0.9941135
15,2,car,720,1190,491,680,470,189,0.99439865
16,2,car,721,1190,490,680,469,190,0.9935835
17,2,car,720,1190,490,680,470,190,0.99316007
18,2,car,720,1190,490,680,470,190,0.99366015
19,2,car,723,1188,491,680,465,189,0.9940172
20,2,car,723,1190,491,680,467,189,0.9925984
21,2,car,720,1189,491,679,469,188,0.99389535
22,2,car,720,1192,491,680,472,189,0.9947525
23,2,car,720,1189,490,681,469,191,0.99338204
24,2,car,723,1190,490,680,467,190,0.993658
25,2,car,722,1191,490,681,469,191,0.9944046
26,2,car,723,1189,491,680,466,189,0.9941147
27,2,car,592,912,482,651,320,169,0.9904916
28,2,car,593,912,482,651,319,169,0.99101853
29,2,car,591,911,482,650,320,168,0.99045604
0,2,car,719,1192,490,681,473,191,0.994926
1,2,car,722,1192,490,680,470,190,0.9945114
2,2,car,722,1190,490,680,468,190,0.99356544
3,2,car,718,1192,490,680,474,190,0.99396724
4,2,car,720,1192,491,680,472,189,0.99402833
5,2,car,720,1188,490,681,468,191,0.9936452
6,2,car,722,1188,490,681,466,191,0.9941867
7,2,car,722,1189,490,681,467,191,0.99316216
8,2,car,721,1191,490,681,470,191,0.9934978
9,2,car,722,1192,491,679,470,188,0.9947086
10,2,car,719,1191,490,680,472,190,0.99448395
11,2,car,721,1190,490,681,469,191,0.9950352
12,2,car,718,1192,491,680,474,189,0.9946807
13,2,car,720,1190,491,680,470,189,0.9939705
14,2,car,721,1189,490,680,468,190,0.99420947
15,2,car,721,1188,491,679,467,188,0.9941135
16,2,car,720,1190,491,680,470,189,0.99439865
17,2,car,721,1190,490,680,469,190,0.9935835
18,2,car,720,1190,490,680,470,190,0.99316007
19,2,car,720,1190,490,680,470,190,0.99366015
20,2,car,723,1188,491,680,465,189,0.9940172
21,2,car,723,1190,491,680,467,189,0.9925984
22,2,car,720,1189,491,679,469,188,0.99389535
23,2,car,720,1192,491,680,472,189,0.9947525
24,2,car,720,1189,490,681,469,191,0.99338204
25,2,car,723,1190,490,680,467,190,0.993658
26,2,car,722,1191,490,681,469,191,0.9944046
27,2,car,723,1189,491,680,466,189,0.9941147
28,2,car,592,912,482,651,320,169,0.9904916
29,2,car,593,912,482,651,319,169,0.99101853
30,2,car,591,911,482,650,320,168,0.99045604
0,2,car,719,1191,490,680,472,190,0.99378115
1,2,car,719,1192,490,681,473,191,0.994926
2,2,car,722,1192,490,680,470,190,0.9945114
3,2,car,722,1190,490,680,468,190,0.99356544
4,2,car,718,1192,490,680,474,190,0.99396724
5,2,car,720,1192,491,680,472,189,0.99402833
6,2,car,720,1188,490,681,468,191,0.9936452
7,2,car,722,1188,490,681,466,191,0.9941867
8,2,car,722,1189,490,681,467,191,0.99316216
9,2,car,721,1191,490,681,470,191,0.9934978
10,2,car,722,1192,491,679,470,188,0.9947086
11,2,car,719,1191,490,680,472,190,0.99448395
12,2,car,721,1190,490,681,469,191,0.9950352
13,2,car,718,1192,491,680,474,189,0.9946807
14,2,car,720,1190,491,680,470,189,0.9939705
15,2,car,721,1189,490,680,468,190,0.99420947
16,2,car,721,1188,491,679,467,188,0.9941135
17,2,car,720,1190,491,680,470,189,0.99439865
18,2,car,721,1190,490,680,469,190,0.9935835
19,2,car,720,1190,490,680,470,190,0.99316007
20,2,car,720,1190,490,680,470,190,0.99366015
21,2,car,723,1188,491,680,465,189,0.9940172
22,2,car,723,1190,491,680,467,189,0.9925984
23,2,car,720,1189,491,679,469,188,0.99389535
24,2,car,720,1192,491,680,472,189,0.9947525
25,2,car,720,1189,490,681,469,191,0.99338204
26,2,car,723,1190,490,680,467,190,0.993658
27,2,car,722,1191,490,681,469,191,0.9944046
28,2,car,723,1189,491,680,466,189,0.9941147
29,2,car,592,912,482,651,320,169,0.9904916
30,2,car,593,912,482,651,319,169,0.99101853
31,2,car,591,911,482,650,320,168,0.99045604
0,2,car,721,1191,490,680,470,190,0.99485815
1,2,car,719,1191,490,680,472,190,0.99378115
2,2,car,719,1192,490,681,473,191,0.994926
3,2,car,722,1192,490,680,470,190,0.9945114
4,2,car,722,1190,490,680,468,190,0.99356544
5,2,car,718,1192,490,680,474,190,0.99396724
6,2,car,720,1192,491,680,472,189,0.99402833
7,2,car,720,1188,490,681,468,191,0.9936452
8,2,car,722,1188,490,681,466,191,0.9941867
9,2,car,722,1189,490,681,467,191,0.99316216
10,2,car,721,1191,490,681,470,191,0.9934978
11,2,car,722,1192,491,679,470,188,0.9947086
12,2,car,719,1191,490,680,472,190,0.99448395
13,2,car,721,1190,490,681,469,191,0.9950352
14,2,car,718,1192,491,680,474,189,0.9946807
15,2,car,720,1190,491,680,470,189,0.9939705
16,2,car,721,1189,490,680,468,190,0.99420947
17,2,car,721,1188,491,679,467,188,0.9941135
18,2,car,720,1190,491,680,470,189,0.99439865
19,2,car,721,1190,490,680,469,190,0.9935835
20,2,car,720,1190,490,680,470,190,0.99316007
21,2,car,720,1190,490,680,470,190,0.99366015
22,2,car,723,1188,491,680,465,189,0.9940172
23,2,car,723,1190,491,680,467,189,0.9925984
24,2,car,720,1189,491,679,469,188,0.99389535
25,2,car,720,1192,491,680,472,189,0.9947525
26,2,car,720,1189,490,681,469,191,0.99338204
27,2,car,723,1190,490,680,467,190,0.993658
28,2,car,722,1191,490,681,469,191,0.9944046
29,2,car,723,1189,491,680,466,189,0.9941147
30,2,car,592,912,482,651,320,169,0.9904916
31,2,car,593,912,482,651,319,169,0.99101853
32,2,car,591,911,482,650,320,168,0.99045604
0,2,car,721,1190,490,681,469,191,0.99308574
1,2,car,721,1191,490,680,470,190,0.99485815
2,2,car,719,1191,490,680,472,190,0.99378115
3,2,car,719,1192,490,681,473,191,0.994926
4,2,car,722,1192,490,680,470,190,0.9945114
5,2,car,722,1190,490,680,468,190,0.99356544
6,2,car,718,1192,490,680,474,190,0.99396724
7,2,car,720,1192,491,680,472,189,0.99402833
8,2,car,720,1188,490,681,468,191,0.9936452
9,2,car,722,1188,490,681,466,191,0.9941867
10,2,car,722,1189,490,681,467,191,0.99316216
11,2,car,721,1191,490,681,470,191,0.9934978
12,2,car,722,1192,491,679,470,188,0.9947086
13,2,car,719,1191,490,680,472,190,0.99448395
14,2,car,721,1190,490,681,469,191,0.9950352
15,2,car,718,1192,491,680,474,189,0.9946807
16,2,car,720,1190,491,680,470,189,0.9939705
17,2,car,721,1189,490,680,468,190,0.99420947
18,2,car,721,1188,491,679,467,188,0.9941135
19,2,car,720,1190,491,680,470,189,0.99439865
20,2,car,721,1190,490,680,469,190,0.9935835
21,2,car,720,1190,490,680,470,190,0.99316007
22,2,car,720,1190,490,680,470,190,0.99366015
23,2,car,723,1188,491,680,465,189,0.9940172
24,2,car,723,1190,491,680,467,189,0.9925984
25,2,car,720,1189,491,679,469,188,0.99389535
26,2,car,720,1192,491,680,472,189,0.9947525
27,2,car,720,1189,490,681,469,191,0.99338204
28,2,car,723,1190,490,680,467,190,0.993658
29,2,car,722,1191,490,681,469,191,0.9944046
30,2,car,723,1189,491,680,466,189,0.9941147
31,2,car,592,912,482,651,320,169,0.9904916
32,2,car,593,912,482,651,319,169,0.99101853
33,2,car,591,911,482,650,320,168,0.99045604
0,2,car,721,1193,490,681,472,191,0.9946054
1,2,car,721,1190,490,681,469,191,0.99308574
2,2,car,721,1191,490,680,470,190,0.99485815
3,2,car,719,1191,490,680,472,190,0.99378115
4,2,car,719,1192,490,681,473,191,0.994926
5,2,car,722,1192,490,680,470,190,0.9945114
6,2,car,722,1190,490,680,468,190,0.99356544
7,2,car,718,1192,490,680,474,190,0.99396724
8,2,car,720,1192,491,680,472,189,0.99402833
9,2,car,720,1188,490,681,468,191,0.9936452
10,2,car,722,1188,490,681,466,191,0.9941867
11,2,car,722,1189,490,681,467,191,0.99316216
12,2,car,721,1191,490,681,470,191,0.9934978
13,2,car,722,1192,491,679,470,188,0.9947086
14,2,car,719,1191,490,680,472,190,0.99448395
15,2,car,721,1190,490,681,469,191,0.9950352
16,2,car,718,1192,491,680,474,189,0.9946807
17,2,car,720,1190,491,680,470,189,0.9939705
18,2,car,721,1189,490,680,468,190,0.99420947
19,2,car,721,1188,491,679,467,188,0.9941135
20,2,car,720,1190,491,680,470,189,0.99439865
21,2,car,721,1190,490,680,469,190,0.9935835
22,2,car,720,1190,490,680,470,190,0.99316007
23,2,car,720,1190,490,680,470,190,0.99366015
24,2,car,723,1188,491,680,465,189,0.9940172
25,2,car,723,1190,491,680,467,189,0.9925984
26,2,car,720,1189,491,679,469,188,0.99389535
27,2,car,720,1192,491,680,472,189,0.9947525
28,2,car,720,1189,490,681,469,191,0.99338204
29,2,car,723,1190,490,680,467,190,0.993658
30,2,car,722,1191,490,681,469,191,0.9944046
31,2,car,723,1189,491,680,466,189,0.9941147
32,2,car,592,912,482,651,320,169,0.9904916
33,2,car,593,912,482,651,319,169,0.99101853
34,2,car,591,911,482,650,320,168,0.99045604
0,2,car,721,1189,491,680,468,189,0.9938193
1,2,car,721,1193,490,681,472,191,0.9946054
2,2,car,721,1190,490,681,469,191,0.99308574
3,2,car,721,1191,490,680,470,190,0.99485815
4,2,car,719,1191,490,680,472,190,0.99378115
5,2,car,719,1192,490,681,473,191,0.994926
6,2,car,722,1192,490,680,470,190,0.9945114
7,2,car,722,1190,490,680,468,190,0.99356544
8,2,car,718,1192,490,680,474,190,0.99396724
9,2,car,720,1192,491,680,472,189,0.99402833
10,2,car,720,1188,490,681,468,191,0.9936452
11,2,car,722,1188,490,681,466,191,0.9941867
12,2,car,722,1189,490,681,467,191,0.99316216
13,2,car,721,1191,490,681,470,191,0.9934978
14,2,car,722,1192,491,679,470,188,0.9947086
15,2,car,719,1191,490,680,472,190,0.99448395
16,2,car,721,1190,490,681,469,191,0.9950352
17,2,car,718,1192,491,680,474,189,0.9946807
18,2,car,720,1190,491,680,470,189,0.9939705
19,2,car,721,1189,490,680,468,190,0.99420947
20,2,car,721,1188,491,679,467,188,0.9941135
21,2,car,720,1190,491,680,470,189,0.99439865
22,2,car,721,1190,490,680,469,190,0.9935835
23,2,car,720,1190,490,680,470,190,0.99316007
24,2,car,720,1190,490,680,470,190,0.99366015
25,2,car,723,1188,491,680,465,189,0.9940172
26,2,car,723,1190,491,680,467,189,0.9925984
27,2,car,720,1189,491,679,469,188,0.99389535
28,2,car,720,1192,491,680,472,189,0.9947525
29,2,car,720,1189,490,681,469,191,0.99338204
30,2,car,723,1190,490,680,467,190,0.993658
31,2,car,722,1191,490,681,469,191,0.9944046
32,2,car,723,1189,491,680,466,189,0.9941147
33,2,car,592,912,482,651,320,169,0.9904916
34,2,car,593,912,482,651,319,169,0.99101853
35,2,car,591,911,482,650,320,168,0.99045604
0,2,car,721,1190,490,680,469,190,0.9937749
1,2,car,721,1189,491,680,468,189,0.9938193
2,2,car,721,1193,490,681,472,191,0.9946054
3,2,car,721,1190,490,681,469,191,0.99308574
4,2,car,721,1191,490,680,470,190,0.99485815
5,2,car,719,1191,490,680,472,190,0.99378115
6,2,car,719,1192,490,681,473,191,0.994926
7,2,car,722,1192,490,680,470,190,0.9945114
8,2,car,722,1190,490,680,468,190,0.99356544
9,2,car,718,1192,490,680,474,190,0.99396724
10,2,car,720,1192,491,680,472,189,0.99402833
11,2,car,720,1188,490,681,468,191,0.9936452
12,2,car,722,1188,490,681,466,191,0.9941867
13,2,car,722,1189,490,681,467,191,0.99316216
14,2,car,721,1191,490,681,470,191,0.9934978
15,2,car,722,1192,491,679,470,188,0.9947086
16,2,car,719,1191,490,680,472,190,0.99448395
17,2,car,721,1190,490,681,469,191,0.9950352
18,2,car,718,1192,491,680,474,189,0.9946807
19,2,car,720,1190,491,680,470,189,0.9939705
20,2,car,721,1189,490,680,468,190,0.99420947
21,2,car,721,1188,491,679,467,188,0.9941135
22,2,car,720,1190,491,680,470,189,0.99439865
23,2,car,721,1190,490,680,469,190,0.9935835
24,2,car,720,1190,490,680,470,190,0.99316007
25,2,car,720,1190,490,680,470,190,0.99366015
26,2,car,723,1188,491,680,465,189,0.9940172
27,2,car,723,1190,491,680,467,189,0.9925984
28,2,car,720,1189,491,679,469,188,0.99389535
29,2,car,720,1192,491,680,472,189,0.9947525
30,2,car,720,1189,490,681,469,191,0.99338204
31,2,car,723,1190,490,680,467,190,0.993658
32,2,car,722,1191,490,681,469,191,0.9944046
33,2,car,723,1189,491,680,466,189,0.9941147
34,2,car,592,912,482,651,320,169,0.9904916
35,2,car,593,912,482,651,319,169,0.99101853
36,2,car,591,911,482,650,320,168,0.99045604
0,2,car,720,1192,491,680,472,189,0.9943153
1,2,car,721,1190,490,680,469,190,0.9937749
2,2,car,721,1189,491,680,468,189,0.9938193
3,2,car,721,1193,490,681,472,191,0.9946054
4,2,car,721,1190,490,681,469,191,0.99308574
5,2,car,721,1191,490,680,470,190,0.99485815
6,2,car,719,1191,490,680,472,190,0.99378115
7,2,car,719,1192,490,681,473,191,0.994926
8,2,car,722,1192,490,680,470,190,0.9945114
9,2,car,722,1190,490,680,468,190,0.99356544
10,2,car,718,1192,490,680,474,190,0.99396724
11,2,car,720,1192,491,680,472,189,0.99402833
12,2,car,720,1188,490,681,468,191,0.9936452
13,2,car,722,1188,490,681,466,191,0.9941867
14,2,car,722,1189,490,681,467,191,0.99316216
15,2,car,721,1191,490,681,470,191,0.9934978
16,2,car,722,1192,491,679,470,188,0.9947086
17,2,car,719,1191,490,680,472,190,0.99448395
18,2,car,721,1190,490,681,469,191,0.9950352
19,2,car,718,1192,491,680,474,189,0.9946807
20,2,car,720,1190,491,680,470,189,0.9939705
21,2,car,721,1189,490,680,468,190,0.99420947
22,2,car,721,1188,491,679,467,188,0.9941135
23,2,car,720,1190,491,680,470,189,0.99439865
24,2,car,721,1190,490,680,469,190,0.9935835
25,2,car,720,1190,490,680,470,190,0.99316007
26,2,car,720,1190,490,680,470,190,0.99366015
27,2,car,723,1188,491,680,465,189,0.9940172
28,2,car,723,1190,491,680,467,189,0.9925984
29,2,car,720,1189,491,679,469,188,0.99389535
30,2,car,720,1192,491,680,472,189,0.9947525
31,2,car,720,1189,490,681,469,191,0.99338204
32,2,car,723,1190,490,680,467,190,0.993658
33,2,car,722,1191,490,681,469,191,0.9944046
34,2,car,723,1189,491,680,466,189,0.9941147
35,2,car,592,912,482,651,320,169,0.9904916
36,2,car,593,912,482,651,319,169,0.99101853
37,2,car,591,911,482,650,320,168,0.99045604
0,2,car,723,1187,491,680,464,189,0.9929273
1,2,car,720,1192,491,680,472,189,0.9943153
2,2,car,721,1190,490,680,469,190,0.9937749
3,2,car,721,1189,491,680,468,189,0.9938193
4,2,car,721,1193,490,681,472,191,0.9946054
5,2,car,721,1190,490,681,469,191,0.99308574
6,2,car,721,1191,490,680,470,190,0.99485815
7,2,car,719,1191,490,680,472,190,0.99378115
8,2,car,719,1192,490,681,473,191,0.994926
9,2,car,722,1192,490,680,470,190,0.9945114
10,2,car,722,1190,490,680,468,190,0.99356544
11,2,car,718,1192,490,680,474,190,0.99396724
12,2,car,720,1192,491,680,472,189,0.99402833
13,2,car,720,1188,490,681,468,191,0.9936452
14,2,car,722,1188,490,681,466,191,0.9941867
15,2,car,722,1189,490,681,467,191,0.99316216
16,2,car,721,1191,490,681,470,191,0.9934978
17,2,car,722,1192,491,679,470,188,0.9947086
18,2,car,719,1191,490,680,472,190,0.99448395
19,2,car,721,1190,490,681,469,191,0.9950352
20,2,car,718,1192,491,680,474,189,0.9946807
21,2,car,720,1190,491,680,470,189,0.9939705
22,2,car,721,1189,490,680,468,190,0.99420947
23,2,car,721,1188,491,679,467,188,0.9941135
24,2,car,720,1190,491,680,470,189,0.99439865
25,2,car,721,1190,490,680,469,190,0.9935835
26,2,car,720,1190,490,680,470,190,0.99316007
27,2,car,720,1190,490,680,470,190,0.99366015
28,2,car,723,1188,491,680,465,189,0.9940172
29,2,car,723,1190,491,680,467,189,0.9925984
30,2,car,720,1189,491,679,469,188,0.99389535
31,2,car,720,1192,491,680,472,189,0.9947525
32,2,car,720,1189,490,681,469,191,0.99338204
33,2,car,723,1190,490,680,467,190,0.993658
34,2,car,722,1191,490,681,469,191,0.9944046
35,2,car,723,1189,491,680,466,189,0.9941147
36,2,car,592,912,482,651,320,169,0.9904916
37,2,car,593,912,482,651,319,169,0.99101853
38,2,car,591,911,482,650,320,168,0.99045604
0,2,car,721,1192,490,680,471,190,0.9927697
1,2,car,723,1187,491,680,464,189,0.9929273
2,2,car,720,1192,491,680,472,189,0.9943153
3,2,car,721,1190,490,680,469,190,0.9937749
4,2,car,721,1189,491,680,468,189,0.9938193
5,2,car,721,1193,490,681,472,191,0.9946054
6,2,car,721,1190,490,681,469,191,0.99308574
7,2,car,721,1191,490,680,470,190,0.99485815
8,2,car,719,1191,490,680,472,190,0.99378115
9,2,car,719,1192,490,681,473,191,0.994926
10,2,car,722,1192,490,680,470,190,0.9945114
11,2,car,722,1190,490,680,468,190,0.99356544
12,2,car,718,1192,490,680,474,190,0.99396724
13,2,car,720,1192,491,680,472,189,0.99402833
14,2,car,720,1188,490,681,468,191,0.9936452
15,2,car,722,1188,490,681,466,191,0.9941867
16,2,car,722,1189,490,681,467,191,0.99316216
17,2,car,721,1191,490,681,470,191,0.9934978
18,2,car,722,1192,491,679,470,188,0.9947086
19,2,car,719,1191,490,680,472,190,0.99448395
20,2,car,721,1190,490,681,469,191,0.9950352
21,2,car,718,1192,491,680,474,189,0.9946807
22,2,car,720,1190,491,680,470,189,0.9939705
23,2,car,721,1189,490,680,468,190,0.99420947
24,2,car,721,1188,491,679,467,188,0.9941135
25,2,car,720,1190,491,680,470,189,0.99439865
26,2,car,721,1190,490,680,469,190,0.9935835
27,2,car,720,1190,490,680,470,190,0.99316007
28,2,car,720,1190,490,680,470,190,0.99366015
29,2,car,723,1188,491,680,465,189,0.9940172
30,2,car,723,1190,491,680,467,189,0.9925984
31,2,car,720,1189,491,679,469,188,0.99389535
32,2,car,720,1192,491,680,472,189,0.9947525
33,2,car,720,1189,490,681,469,191,0.99338204
34,2,car,723,1190,490,680,467,190,0.993658
35,2,car,722,1191,490,681,469,191,0.9944046
36,2,car,723,1189,491,680,466,189,0.9941147
37,2,car,592,912,482,651,320,169,0.9904916
38,2,car,593,912,482,651,319,169,0.99101853
39,2,car,591,911,482,650,320,168,0.99045604
0,2,car,721,1190,491,680,469,189,0.9941834
1,2,car,721,1192,490,680,471,190,0.9927697
2,2,car,723,1187,491,680,464,189,0.9929273
3,2,car,720,1192,491,680,472,189,0.9943153
4,2,car,721,1190,490,680,469,190,0.9937749
5,2,car,721,1189,491,680,468,189,0.9938193
6,2,car,721,1193,490,681,472,191,0.9946054
7,2,car,721,1190,490,681,469,191,0.99308574
8,2,car,721,1191,490,680,470,190,0.99485815
9,2,car,719,1191,490,680,472,190,0.99378115
10,2,car,719,1192,490,681,473,191,0.994926
11,2,car,722,1192,490,680,470,190,0.9945114
12,2,car,722,1190,490,680,468,190,0.99356544
13,2,car,718,1192,490,680,474,190,0.99396724
14,2,car,720,1192,491,680,472,189,0.99402833
15,2,car,720,1188,490,681,468,191,0.9936452
16,2,car,722,1188,490,681,466,191,0.9941867
17,2,car,722,1189,490,681,467,191,0.99316216
18,2,car,721,1191,490,681,470,191,0.9934978
19,2,car,722,1192,491,679,470,188,0.9947086
20,2,car,719,1191,490,680,472,190,0.99448395
21,2,car,721,1190,490,681,469,191,0.9950352
22,2,car,718,1192,491,680,474,189,0.9946807
23,2,car,720,1190,491,680,470,189,0.9939705
24,2,car,721,1189,490,680,468,190,0.99420947
25,2,car,721,1188,491,679,467,188,0.9941135
26,2,car,720,1190,491,680,470,189,0.99439865
27,2,car,721,1190,490,680,469,190,0.9935835
28,2,car,720,1190,490,680,470,190,0.99316007
29,2,car,720,1190,490,680,470,190,0.99366015
30,2,car,723,1188,491,680,465,189,0.9940172
31,2,car,723,1190,491,680,467,189,0.9925984
32,2,car,720,1189,491,679,469,188,0.99389535
33,2,car,720,1192,491,680,472,189,0.9947525
34,2,car,720,1189,490,681,469,191,0.99338204
35,2,car,723,1190,490,680,467,190,0.993658
36,2,car,722,1191,490,681,469,191,0.9944046
37,2,car,723,1189,491,680,466,189,0.9941147
38,2,car,592,912,482,651,320,169,0.9904916
39,2,car,593,912,482,651,319,169,0.99101853
40,2,car,591,911,482,650,320,168,0.99045604
0,2,car,721,1192,491,679,471,188,0.99353355
1,2,car,721,1190,491,680,469,189,0.9941834
2,2,car,721,1192,490,680,471,190,0.9927697
3,2,car,723,1187,491,680,464,189,0.9929273
4,2,car,720,1192,491,680,472,189,0.9943153
5,2,car,721,1190,490,680,469,190,0.9937749
6,2,car,721,1189,491,680,468,189,0.9938193
7,2,car,721,1193,490,681,472,191,0.9946054
8,2,car,721,1190,490,681,469,191,0.99308574
9,2,car,721,1191,490,680,470,190,0.99485815
10,2,car,719,1191,490,680,472,190,0.99378115
11,2,car,719,1192,490,681,473,191,0.994926
12,2,car,722,1192,490,680,470,190,0.9945114
13,2,car,722,1190,490,680,468,190,0.99356544
14,2,car,718,1192,490,680,474,190,0.99396724
15,2,car,720,1192,491,680,472,189,0.99402833
16,2,car,720,1188,490,681,468,191,0.9936452
17,2,car,722,1188,490,681,466,191,0.9941867
18,2,car,722,1189,490,681,467,191,0.99316216
19,2,car,721,1191,490,681,470,191,0.9934978
20,2,car,722,1192,491,679,470,188,0.9947086
21,2,car,719,1191,490,680,472,190,0.99448395
22,2,car,721,1190,490,681,469,191,0.9950352
23,2,car,718,1192,491,680,474,189,0.9946807
24,2,car,720,1190,491,680,470,189,0.9939705
25,2,car,721,1189,490,680,468,190,0.99420947
26,2,car,721,1188,491,679,467,188,0.9941135
27,2,car,720,1190,491,680,470,189,0.99439865
28,2,car,721,1190,490,680,469,190,0.9935835
29,2,car,720,1190,490,680,470,190,0.99316007
30,2,car,720,1190,490,680,470,190,0.99366015
31,2,car,723,1188,491,680,465,189,0.9940172
32,2,car,723,1190,491,680,467,189,0.9925984
33,2,car,720,1189,491,679,469,188,0.99389535
34,2,car,720,1192,491,680,472,189,0.9947525
35,2,car,720,1189,490,681,469,191,0.99338204
36,2,car,723,1190,490,680,467,190,0.993658
37,2,car,722,1191,490,681,469,191,0.9944046
38,2,car,723,1189,491,680,466,189,0.9941147
39,2,car,592,912,482,651,320,169,0.9904916
40,2,car,593,912,482,651,319,169,0.99101853
41,2,car,591,911,482,650,320,168,0.99045604
0,2,car,721,1189,491,679,468,188,0.9922223
1,2,car,721,1192,491,679,471,188,0.99353355
2,2,car,721,1190,491,680,469,189,0.9941834
3,2,car,721,1192,490,680,471,190,0.9927697
4,2,car,723,1187,491,680,464,189,0.9929273
5,2,car,720,1192,491,680,472,189,0.9943153
6,2,car,721,1190,490,680,469,190,0.9937749
7,2,car,721,1189,491,680,468,189,0.9938193
8,2,car,721,1193,490,681,472,191,0.9946054
9,2,car,721,1190,490,681,469,191,0.99308574
10,2,car,721,1191,490,680,470,190,0.99485815
11,2,car,719,1191,490,680,472,190,0.99378115
12,2,car,719,1192,490,681,473,191,0.994926
13,2,car,722,1192,490,680,470,190,0.9945114
14,2,car,722,1190,490,680,468,190,0.99356544
15,2,car,718,1192,490,680,474,190,0.99396724
16,2,car,720,1192,491,680,472,189,0.99402833
17,2,car,720,1188,490,681,468,191,0.9936452
18,2,car,722,1188,490,681,466,191,0.9941867
19,2,car,722,1189,490,681,467,191,0.99316216
20,2,car,721,1191,490,681,470,191,0.9934978
21,2,car,722,1192,491,679,470,188,0.9947086
22,2,car,719,1191,490,680,472,190,0.99448395
23,2,car,721,1190,490,681,469,191,0.9950352
24,2,car,718,1192,491,680,474,189,0.9946807
25,2,car,720,1190,491,680,470,189,0.9939705
26,2,car,721,1189,490,680,468,190,0.99420947
27,2,car,721,1188,491,679,467,188,0.9941135
28,2,car,720,1190,491,680,470,189,0.99439865
29,2,car,721,1190,490,680,469,190,0.9935835
30,2,car,720,1190,490,680,470,190,0.99316007
31,2,car,720,1190,490,680,470,190,0.99366015
32,2,car,723,1188,491,680,465,189,0.9940172
33,2,car,723,1190,491,680,467,189,0.9925984
34,2,car,720,1189,491,679,469,188,0.99389535
35,2,car,720,1192,491,680,472,189,0.9947525
36,2,car,720,1189,490,681,469,191,0.99338204
37,2,car,723,1190,490,680,467,190,0.993658
38,2,car,722,1191,490,681,469,191,0.9944046
39,2,car,723,1189,491,680,466,189,0.9941147
40,2,car,592,912,482,651,320,169,0.9904916
41,2,car,593,912,482,651,319,169,0.99101853
42,2,car,591,911,482,650,320,168,0.99045604
0,2,car,722,1191,491,679,469,188,0.99334544
1,2,car,721,1189,491,679,468,188,0.9922223
2,2,car,721,1192,491,679,471,188,0.99353355
3,2,car,721,1190,491,680,469,189,0.9941834
4,2,car,721,1192,490,680,471,190,0.9927697
5,2,car,723,1187,491,680,464,189,0.9929273
6,2,car,720,1192,491,680,472,189,0.9943153
7,2,car,721,1190,490,680,469,190,0.9937749
8,2,car,721,1189,491,680,468,189,0.9938193
9,2,car,721,1193,490,681,472,191,0.9946054
10,2,car,721,1190,490,681,469,191,0.99308574
11,2,car,721,1191,490,680,470,190,0.99485815
12,2,car,719,1191,490,680,472,190,0.99378115
13,2,car,719,1192,490,681,473,191,0.994926
14,2,car,722,1192,490,680,470,190,0.9945114
15,2,car,722,1190,490,680,468,190,0.99356544
16,2,car,718,1192,490,680,474,190,0.99396724
17,2,car,720,1192,491,680,472,189,0.99402833
18,2,car,720,1188,490,681,468,191,0.9936452
19,2,car,722,1188,490,681,466,191,0.9941867
20,2,car,722,1189,490,681,467,191,0.99316216
21,2,car,721,1191,490,681,470,191,0.9934978
22,2,car,722,1192,491,679,470,188,0.9947086
23,2,car,719,1191,490,680,472,190,0.99448395
24,2,car,721,1190,490,681,469,191,0.9950352
25,2,car,718,1192,491,680,474,189,0.9946807
26,2,car,720,1190,491,680,470,189,0.9939705
27,2,car,721,1189,490,680,468,190,0.99420947
28,2,car,721,1188,491,679,467,188,0.9941135
29,2,car,720,1190,491,680,470,189,0.99439865
30,2,car,721,1190,490,680,469,190,0.9935835
31,2,car,720,1190,490,680,470,190,0.99316007
32,2,car,720,1190,490,680,470,190,0.99366015
33,2,car,723,1188,491,680,465,189,0.9940172
34,2,car,723,1190,491,680,467,189,0.9925984
35,2,car,720,1189,491,679,469,188,0.99389535
36,2,car,720,1192,491,680,472,189,0.9947525
37,2,car,720,1189,490,681,469,191,0.99338204
38,2,car,723,1190,490,680,467,190,0.993658
39,2,car,722,1191,490,681,469,191,0.9944046
40,2,car,723,1189,491,680,466,189,0.9941147
41,2,car,592,912,482,651,320,169,0.9904916
42,2,car,593,912,482,651,319,169,0.99101853
43,2,car,591,911,482,650,320,168,0.99045604
0,2,car,721,1189,490,680,468,190,0.99278355
1,2,car,722,1191,491,679,469,188,0.99334544
2,2,car,721,1189,491,679,468,188,0.9922223
3,2,car,721,1192,491,679,471,188,0.99353355
4,2,car,721,1190,491,680,469,189,0.9941834
5,2,car,721,1192,490,680,471,190,0.9927697
6,2,car,723,1187,491,680,464,189,0.9929273
7,2,car,720,1192,491,680,472,189,0.9943153
8,2,car,721,1190,490,680,469,190,0.9937749
9,2,car,721,1189,491,680,468,189,0.9938193
10,2,car,721,1193,490,681,472,191,0.9946054
11,2,car,721,1190,490,681,469,191,0.99308574
12,2,car,721,1191,490,680,470,190,0.99485815
13,2,car,719,1191,490,680,472,190,0.99378115
14,2,car,719,1192,490,681,473,191,0.994926
15,2,car,722,1192,490,680,470,190,0.9945114
16,2,car,722,1190,490,680,468,190,0.99356544
17,2,car,718,1192,490,680,474,190,0.99396724
18,2,car,720,1192,491,680,472,189,0.99402833
19,2,car,720,1188,490,681,468,191,0.9936452
20,2,car,722,1188,490,681,466,191,0.9941867
21,2,car,722,1189,490,681,467,191,0.99316216
22,2,car,721,1191,490,681,470,191,0.9934978
23,2,car,722,1192,491,679,470,188,0.9947086
24,2,car,719,1191,490,680,472,190,0.99448395
25,2,car,721,1190,490,681,469,191,0.9950352
26,2,car,718,1192,491,680,474,189,0.9946807
27,2,car,720,1190,491,680,470,189,0.9939705
28,2,car,721,1189,490,680,468,190,0.99420947
29,2,car,721,1188,491,679,467,188,0.9941135
30,2,car,720,1190,491,680,470,189,0.99439865
31,2,car,721,1190,490,680,469,190,0.9935835
32,2,car,720,1190,490,680,470,190,0.99316007
33,2,car,720,1190,490,680,470,190,0.99366015
34,2,car,723,1188,491,680,465,189,0.9940172
35,2,car,723,1190,491,680,467,189,0.9925984
36,2,car,720,1189,491,679,469,188,0.99389535
37,2,car,720,1192,491,680,472,189,0.9947525
38,2,car,720,1189,490,681,469,191,0.99338204
39,2,car,723,1190,490,680,467,190,0.993658
40,2,car,722,1191,490,681,469,191,0.9944046
41,2,car,723,1189,491,680,466,189,0.9941147
42,2,car,592,912,482,651,320,169,0.9904916
43,2,car,593,912,482,651,319,169,0.99101853
44,2,car,591,911,482,650,320,168,0.99045604
0,2,car,720,1189,490,680,469,190,0.9933535
1,2,car,721,1189,490,680,468,190,0.99278355
2,2,car,722,1191,491,679,469,188,0.99334544
3,2,car,721,1189,491,679,468,188,0.9922223
4,2,car,721,1192,491,679,471,188,0.99353355
5,2,car,721,1190,491,680,469,189,0.9941834
6,2,car,721,1192,490,680,471,190,0.9927697
7,2,car,723,1187,491,680,464,189,0.9929273
8,2,car,720,1192,491,680,472,189,0.9943153
9,2,car,721,1190,490,680,469,190,0.9937749
10,2,car,721,1189,491,680,468,189,0.9938193
11,2,car,721,1193,490,681,472,191,0.9946054
12,2,car,721,1190,490,681,469,191,0.99308574
13,2,car,721,1191,490,680,470,190,0.99485815
14,2,car,719,1191,490,680,472,190,0.99378115
15,2,car,719,1192,490,681,473,191,0.994926
16,2,car,722,1192,490,680,470,190,0.9945114
17,2,car,722,1190,490,680,468,190,0.99356544
18,2,car,718,1192,490,680,474,190,0.99396724
19,2,car,720,1192,491,680,472,189,0.99402833
20,2,car,720,1188,490,681,468,191,0.9936452
21,2,car,722,1188,490,681,466,191,0.9941867
22,2,car,722,1189,490,681,467,191,0.99316216
23,2,car,721,1191,490,681,470,191,0.9934978
24,2,car,722,1192,491,679,470,188,0.9947086
25,2,car,719,1191,490,680,472,190,0.99448395
26,2,car,721,1190,490,681,469,191,0.9950352
27,2,car,718,1192,491,680,474,189,0.9946807
28,2,car,720,1190,491,680,470,189,0.9939705
29,2,car,721,1189,490,680,468,190,0.99420947
30,2,car,721,1188,491,679,467,188,0.9941135
31,2,car,720,1190,491,680,470,189,0.99439865
32,2,car,721,1190,490,680,469,190,0.9935835
33,2,car,720,1190,490,680,470,190,0.99316007
34,2,car,720,1190,490,680,470,190,0.99366015
35,2,car,723,1188,491,680,465,189,0.9940172
36,2,car,723,1190,491,680,467,189,0.9925984
37,2,car,720,1189,491,679,469,188,0.99389535
38,2,car,720,1192,491,680,472,189,0.9947525
39,2,car,720,1189,490,681,469,191,0.99338204
40,2,car,723,1190,490,680,467,190,0.993658
41,2,car,722,1191,490,681,469,191,0.9944046
42,2,car,723,1189,491,680,466,189,0.9941147
43,2,car,592,912,482,651,320,169,0.9904916
44,2,car,593,912,482,651,319,169,0.99101853
45,2,car,591,911,482,650,320,168,0.99045604
0,2,car,721,1189,490,681,468,191,0.99309224
1,2,car,720,1189,490,680,469,190,0.9933535
2,2,car,721,1189,490,680,468,190,0.99278355
3,2,car,722,1191,491,679,469,188,0.99334544
4,2,car,721,1189,491,679,468,188,0.9922223
5,2,car,721,1192,491,679,471,188,0.99353355
6,2,car,721,1190,491,680,469,189,0.9941834
7,2,car,721,1192,490,680,471,190,0.9927697
8,2,car,723,1187,491,680,464,189,0.9929273
9,2,car,720,1192,491,680,472,189,0.9943153
10,2,car,721,1190,490,680,469,190,0.9937749
11,2,car,721,1189,491,680,468,189,0.9938193
12,2,car,721,1193,490,681,472,191,0.9946054
13,2,car,721,1190,490,681,469,191,0.99308574
14,2,car,721,1191,490,680,470,190,0.99485815
15,2,car,719,1191,490,680,472,190,0.99378115
16,2,car,719,1192,490,681,473,191,0.994926
17,2,car,722,1192,490,680,470,190,0.9945114
18,2,car,722,1190,490,680,468,190,0.99356544
19,2,car,718,1192,490,680,474,190,0.99396724
20,2,car,720,1192,491,680,472,189,0.99402833
21,2,car,720,1188,490,681,468,191,0.9936452
22,2,car,722,1188,490,681,466,191,0.9941867
23,2,car,722,1189,490,681,467,191,0.99316216
24,2,car,721,1191,490,681,470,191,0.9934978
25,2,car,722,1192,491,679,470,188,0.9947086
26,2,car,719,1191,490,680,472,190,0.99448395
27,2,car,721,1190,490,681,469,191,0.9950352
28,2,car,718,1192,491,680,474,189,0.9946807
29,2,car,720,1190,491,680,470,189,0.9939705
30,2,car,721,1189,490,680,468,190,0.99420947
31,2,car,721,1188,491,679,467,188,0.9941135
32,2,car,720,1190,491,680,470,189,0.99439865
33,2,car,721,1190,490,680,469,190,0.9935835
34,2,car,720,1190,490,680,470,190,0.99316007
35,2,car,720,1190,490,680,470,190,0.99366015
36,2,car,723,1188,491,680,465,189,0.9940172
37,2,car,723,1190,491,680,467,189,0.9925984
38,2,car,720,1189,491,679,469,188,0.99389535
39,2,car,720,1192,491,680,472,189,0.9947525
40,2,car,720,1189,490,681,469,191,0.99338204
41,2,car,723,1190,490,680,467,190,0.993658
42,2,car,722,1191,490,681,469,191,0.9944046
43,2,car,723,1189,491,680,466,189,0.9941147
44,2,car,592,912,482,651,320,169,0.9904916
45,2,car,593,912,482,651,319,169,0.99101853
46,2,car,591,911,482,650,320,168,0.99045604
0,2,car,719,1189,490,681,470,191,0.9933415
1,2,car,721,1189,490,681,468,191,0.99309224
2,2,car,720,1189,490,680,469,190,0.9933535
3,2,car,721,1189,490,680,468,190,0.99278355
4,2,car,722,1191,491,679,469,188,0.99334544
5,2,car,721,1189,491,679,468,188,0.9922223
6,2,car,721,1192,491,679,471,188,0.99353355
7,2,car,721,1190,491,680,469,189,0.9941834
8,2,car,721,1192,490,680,471,190,0.9927697
9,2,car,723,1187,491,680,464,189,0.9929273
10,2,car,720,1192,491,680,472,189,0.9943153
11,2,car,721,1190,490,680,469,190,0.9937749
12,2,car,721,1189,491,680,468,189,0.9938193
13,2,car,721,1193,490,681,472,191,0.9946054
14,2,car,721,1190,490,681,469,191,0.99308574
15,2,car,721,1191,490,680,470,190,0.99485815
16,2,car,719,1191,490,680,472,190,0.99378115
17,2,car,719,1192,490,681,473,191,0.994926
18,2,car,722,1192,490,680,470,190,0.9945114
19,2,car,722,1190,490,680,468,190,0.99356544
20,2,car,718,1192,490,680,474,190,0.99396724
21,2,car,720,1192,491,680,472,189,0.99402833
22,2,car,720,1188,490,681,468,191,0.9936452
23,2,car,722,1188,490,681,466,191,0.9941867
24,2,car,722,1189,490,681,467,191,0.99316216
25,2,car,721,1191,490,681,470,191,0.9934978
26,2,car,722,1192,491,679,470,188,0.9947086
27,2,car,719,1191,490,680,472,190,0.99448395
28,2,car,721,1190,490,681,469,191,0.9950352
29,2,car,718,1192,491,680,474,189,0.9946807
30,2,car,720,1190,491,680,470,189,0.9939705
31,2,car,721,1189,490,680,468,190,0.99420947
32,2,car,721,1188,491,679,467,188,0.9941135
33,2,car,720,1190,491,680,470,189,0.99439865
34,2,car,721,1190,490,680,469,190,0.9935835
35,2,car,720,1190,490,680,470,190,0.99316007
36,2,car,720,1190,490,680,470,190,0.99366015
37,2,car,723,1188,491,680,465,189,0.9940172
38,2,car,723,1190,491,680,467,189,0.9925984
39,2,car,720,1189,491,679,469,188,0.99389535
40,2,car,720,1192,491,680,472,189,0.9947525
41,2,car,720,1189,490,681,469,191,0.99338204
42,2,car,723,1190,490,680,467,190,0.993658
43,2,car,722,1191,490,681,469,191,0.9944046
44,2,car,723,1189,491,680,466,189,0.9941147
45,2,car,592,912,482,651,320,169,0.9904916
46,2,car,593,912,482,651,319,169,0.99101853
47,2,car,591,911,482,650,320,168,0.99045604
0,2,car,722,1191,490,680,469,190,0.99388546
1,2,car,719,1189,490,681,470,191,0.9933415
2,2,car,721,1189,490,681,468,191,0.99309224
3,2,car,720,1189,490,680,469,190,0.9933535
4,2,car,721,1189,490,680,468,190,0.99278355
5,2,car,722,1191,491,679,469,188,0.99334544
6,2,car,721,1189,491,679,468,188,0.9922223
7,2,car,721,1192,491,679,471,188,0.99353355
8,2,car,721,1190,491,680,469,189,0.9941834
9,2,car,721,1192,490,680,471,190,0.9927697
10,2,car,723,1187,491,680,464,189,0.9929273
11,2,car,720,1192,491,680,472,189,0.9943153
12,2,car,721,1190,490,680,469,190,0.9937749
13,2,car,721,1189,491,680,468,189,0.9938193
14,2,car,721,1193,490,681,472,191,0.9946054
15,2,car,721,1190,490,681,469,191,0.99308574
16,2,car,721,1191,490,680,470,190,0.99485815
17,2,car,719,1191,490,680,472,190,0.99378115
18,2,car,719,1192,490,681,473,191,0.994926
19,2,car,722,1192,490,680,470,190,0.9945114
20,2,car,722,1190,490,680,468,190,0.99356544
21,2,car,718,1192,490,680,474,190,0.99396724
22,2,car,720,1192,491,680,472,189,0.99402833
23,2,car,720,1188,490,681,468,191,0.9936452
24,2,car,722,1188,490,681,466,191,0.9941867
25,2,car,722,1189,490,681,467,191,0.99316216
26,2,car,721,1191,490,681,470,191,0.9934978
27,2,car,722,1192,491,679,470,188,0.9947086
28,2,car,719,1191,490,680,472,190,0.99448395
29,2,car,721,1190,490,681,469,191,0.9950352
30,2,car,718,1192,491,680,474,189,0.9946807
31,2,car,720,1190,491,680,470,189,0.9939705
32,2,car,721,1189,490,680,468,190,0.99420947
33,2,car,721,1188,491,679,467,188,0.9941135
34,2,car,720,1190,491,680,470,189,0.99439865
35,2,car,721,1190,490,680,469,190,0.9935835
36,2,car,720,1190,490,680,470,190,0.99316007
37,2,car,720,1190,490,680,470,190,0.99366015
38,2,car,723,1188,491,680,465,189,0.9940172
39,2,car,723,1190,491,680,467,189,0.9925984
40,2,car,720,1189,491,679,469,188,0.99389535
41,2,car,720,1192,491,680,472,189,0.9947525
42,2,car,720,1189,490,681,469,191,0.99338204
43,2,car,723,1190,490,680,467,190,0.993658
44,2,car,722,1191,490,681,469,191,0.9944046
45,2,car,723,1189,491,680,466,189,0.9941147
46,2,car,592,912,482,651,320,169,0.9904916
47,2,car,593,912,482,651,319,169,0.99101853
48,2,car,591,911,482,650,320,168,0.99045604
0,2,car,721,1190,491,680,469,189,0.99408567
1,2,car,722,1191,490,680,469,190,0.99388546
2,2,car,719,1189,490,681,470,191,0.9933415
3,2,car,721,1189,490,681,468,191,0.99309224
4,2,car,720,1189,490,680,469,190,0.9933535
5,2,car,721,1189,490,680,468,190,0.99278355
6,2,car,722,1191,491,679,469,188,0.99334544
7,2,car,721,1189,491,679,468,188,0.9922223
8,2,car,721,1192,491,679,471,188,0.99353355
9,2,car,721,1190,491,680,469,189,0.9941834
10,2,car,721,1192,490,680,471,190,0.9927697
11,2,car,723,1187,491,680,464,189,0.9929273
12,2,car,720,1192,491,680,472,189,0.9943153
13,2,car,721,1190,490,680,469,190,0.9937749
14,2,car,721,1189,491,680,468,189,0.9938193
15,2,car,721,1193,490,681,472,191,0.9946054
16,2,car,721,1190,490,681,469,191,0.99308574
17,2,car,721,1191,490,680,470,190,0.99485815
18,2,car,719,1191,490,680,472,190,0.99378115
19,2,car,719,1192,490,681,473,191,0.994926
20,2,car,722,1192,490,680,470,190,0.9945114
21,2,car,722,1190,490,680,468,190,0.99356544
22,2,car,718,1192,490,680,474,190,0.99396724
23,2,car,720,1192,491,680,472,189,0.99402833
24,2,car,720,1188,490,681,468,191,0.9936452
25,2,car,722,1188,490,681,466,191,0.9941867
26,2,car,722,1189,490,681,467,191,0.99316216
27,2,car,721,1191,490,681,470,191,0.9934978
28,2,car,722,1192,491,679,470,188,0.9947086
29,2,car,719,1191,490,680,472,190,0.99448395
30,2,car,721,1190,490,681,469,191,0.9950352
31,2,car,718,1192,491,680,474,189,0.9946807
32,2,car,720,1190,491,680,470,189,0.9939705
33,2,car,721,1189,490,680,468,190,0.99420947
34,2,car,721,1188,491,679,467,188,0.9941135
35,2,car,720,1190,491,680,470,189,0.99439865
36,2,car,721,1190,490,680,469,190,0.9935835
37,2,car,720,1190,490,680,470,190,0.99316007
38,2,car,720,1190,490,680,470,190,0.99366015
39,2,car,723,1188,491,680,465,189,0.9940172
40,2,car,723,1190,491,680,467,189,0.9925984
41,2,car,720,1189,491,679,469,188,0.99389535
42,2,car,720,1192,491,680,472,189,0.9947525
43,2,car,720,1189,490,681,469,191,0.99338204
44,2,car,723,1190,490,680,467,190,0.993658
45,2,car,722,1191,490,681,469,191,0.9944046
46,2,car,723,1189,491,680,466,189,0.9941147
47,2,car,592,912,482,651,320,169,0.9904916
48,2,car,593,912,482,651,319,169,0.99101853
49,2,car,591,911,482,650,320,168,0.99045604
0,2,car,723,1191,491,680,468,189,0.99360245
1,2,car,721,1190,491,680,469,189,0.99408567
2,2,car,722,1191,490,680,469,190,0.99388546
3,2,car,719,1189,490,681,470,191,0.9933415
4,2,car,721,1189,490,681,468,191,0.99309224
5,2,car,720,1189,490,680,469,190,0.9933535
6,2,car,721,1189,490,680,468,190,0.99278355
7,2,car,722,1191,491,679,469,188,0.99334544
8,2,car,721,1189,491,679,468,188,0.9922223
9,2,car,721,1192,491,679,471,188,0.99353355
10,2,car,721,1190,491,680,469,189,0.9941834
11,2,car,721,1192,490,680,471,190,0.9927697
12,2,car,723,1187,491,680,464,189,0.9929273
13,2,car,720,1192,491,680,472,189,0.9943153
14,2,car,721,1190,490,680,469,190,0.9937749
15,2,car,721,1189,491,680,468,189,0.9938193
16,2,car,721,1193,490,681,472,191,0.9946054
17,2,car,721,1190,490,681,469,191,0.99308574
18,2,car,721,1191,490,680,470,190,0.99485815
19,2,car,719,1191,490,680,472,190,0.99378115
20,2,car,719,1192,490,681,473,191,0.994926
21,2,car,722,1192,490,680,470,190,0.9945114
22,2,car,722,1190,490,680,468,190,0.99356544
23,2,car,718,1192,490,680,474,190,0.99396724
24,2,car,720,1192,491,680,472,189,0.99402833
25,2,car,720,1188,490,681,468,191,0.9936452
26,2,car,722,1188,490,681,466,191,0.9941867
27,2,car,722,1189,490,681,467,191,0.99316216
28,2,car,721,1191,490,681,470,191,0.9934978
29,2,car,722,1192,491,679,470,188,0.9947086
30,2,car,719,1191,490,680,472,190,0.99448395
31,2,car,721,1190,490,681,469,191,0.9950352
32,2,car,718,1192,491,680,474,189,0.9946807
33,2,car,720,1190,491,680,470,189,0.9939705
34,2,car,721,1189,490,680,468,190,0.99420947
35,2,car,721,1188,491,679,467,188,0.9941135
36,2,car,720,1190,491,680,470,189,0.99439865
37,2,car,721,1190,490,680,469,190,0.9935835
38,2,car,720,1190,490,680,470,190,0.99316007
39,2,car,720,1190,490,680,470,190,0.99366015
40,2,car,723,1188,491,680,465,189,0.9940172
41,2,car,723,1190,491,680,467,189,0.9925984
42,2,car,720,1189,491,679,469,188,0.99389535
43,2,car,720,1192,491,680,472,189,0.9947525
44,2,car,720,1189,490,681,469,191,0.99338204
45,2,car,723,1190,490,680,467,190,0.993658
46,2,car,722,1191,490,681,469,191,0.9944046
47,2,car,723,1189,491,680,466,189,0.9941147
48,2,car,592,912,482,651,320,169,0.9904916
49,2,car,593,912,482,651,319,169,0.99101853
50,2,car,591,911,482,650,320,168,0.99045604
0,2,car,719,1191,490,681,472,191,0.99357724
1,2,car,723,1191,491,680,468,189,0.99360245
2,2,car,721,1190,491,680,469,189,0.99408567
3,2,car,722,1191,490,680,469,190,0.99388546
4,2,car,719,1189,490,681,470,191,0.9933415
5,2,car,721,1189,490,681,468,191,0.99309224
6,2,car,720,1189,490,680,469,190,0.9933535
7,2,car,721,1189,490,680,468,190,0.99278355
8,2,car,722,1191,491,679,469,188,0.99334544
9,2,car,721,1189,491,679,468,188,0.9922223
10,2,car,721,1192,491,679,471,188,0.99353355
11,2,car,721,1190,491,680,469,189,0.9941834
12,2,car,721,1192,490,680,471,190,0.9927697
13,2,car,723,1187,491,680,464,189,0.9929273
14,2,car,720,1192,491,680,472,189,0.9943153
15,2,car,721,1190,490,680,469,190,0.9937749
16,2,car,721,1189,491,680,468,189,0.9938193
17,2,car,721,1193,490,681,472,191,0.9946054
18,2,car,721,1190,490,681,469,191,0.99308574
19,2,car,721,1191,490,680,470,190,0.99485815
20,2,car,719,1191,490,680,472,190,0.99378115
21,2,car,719,1192,490,681,473,191,0.994926
22,2,car,722,1192,490,680,470,190,0.9945114
23,2,car,722,1190,490,680,468,190,0.99356544
24,2,car,718,1192,490,680,474,190,0.99396724
25,2,car,720,1192,491,680,472,189,0.99402833
26,2,car,720,1188,490,681,468,191,0.9936452
27,2,car,722,1188,490,681,466,191,0.9941867
28,2,car,722,1189,490,681,467,191,0.99316216
29,2,car,721,1191,490,681,470,191,0.9934978
30,2,car,722,1192,491,679,470,188,0.9947086
31,2,car,719,1191,490,680,472,190,0.99448395
32,2,car,721,1190,490,681,469,191,0.9950352
33,2,car,718,1192,491,680,474,189,0.9946807
34,2,car,720,1190,491,680,470,189,0.9939705
35,2,car,721,1189,490,680,468,190,0.99420947
36,2,car,721,1188,491,679,467,188,0.9941135
37,2,car,720,1190,491,680,470,189,0.99439865
38,2,car,721,1190,490,680,469,190,0.9935835
39,2,car,720,1190,490,680,470,190,0.99316007
40,2,car,720,1190,490,680,470,190,0.99366015
41,2,car,723,1188,491,680,465,189,0.9940172
42,2,car,723,1190,491,680,467,189,0.9925984
43,2,car,720,1189,491,679,469,188,0.99389535
44,2,car,720,1192,491,680,472,189,0.9947525
45,2,car,720,1189,490,681,469,191,0.99338204
46,2,car,723,1190,490,680,467,190,0.993658
47,2,car,722,1191,490,681,469,191,0.9944046
48,2,car,723,1189,491,680,466,189,0.9941147
49,2,car,592,912,482,651,320,169,0.9904916
50,2,car,593,912,482,651,319,169,0.99101853
51,2,car,591,911,482,650,320,168,0.99045604
0,2,car,721,1190,491,680,469,189,0.9950945
1,2,car,719,1191,490,681,472,191,0.99357724
2,2,car,723,1191,491,680,468,189,0.99360245
3,2,car,721,1190,491,680,469,189,0.99408567
4,2,car,722,1191,490,680,469,190,0.99388546
5,2,car,719,1189,490,681,470,191,0.9933415
6,2,car,721,1189,490,681,468,191,0.99309224
7,2,car,720,1189,490,680,469,190,0.9933535
8,2,car,721,1189,490,680,468,190,0.99278355
9,2,car,722,1191,491,679,469,188,0.99334544
10,2,car,721,1189,491,679,468,188,0.9922223
11,2,car,721,1192,491,679,471,188,0.99353355
12,2,car,721,1190,491,680,469,189,0.9941834
13,2,car,721,1192,490,680,471,190,0.9927697
14,2,car,723,1187,491,680,464,189,0.9929273
15,2,car,720,1192,491,680,472,189,0.9943153
16,2,car,721,1190,490,680,469,190,0.9937749
17,2,car,721,1189,491,680,468,189,0.9938193
18,2,car,721,1193,490,681,472,191,0.9946054
19,2,car,721,1190,490,681,469,191,0.99308574
20,2,car,721,1191,490,680,470,190,0.99485815
21,2,car,719,1191,490,680,472,190,0.99378115
22,2,car,719,1192,490,681,473,191,0.994926
23,2,car,722,1192,490,680,470,190,0.9945114
24,2,car,722,1190,490,680,468,190,0.99356544
25,2,car,718,1192,490,680,474,190,0.99396724
26,2,car,720,1192,491,680,472,189,0.99402833
27,2,car,720,1188,490,681,468,191,0.9936452
28,2,car,722,1188,490,681,466,191,0.9941867
29,2,car,722,1189,490,681,467,191,0.99316216
30,2,car,721,1191,490,681,470,191,0.9934978
31,2,car,722,1192,491,679,470,188,0.9947086
32,2,car,719,1191,490,680,472,190,0.99448395
33,2,car,721,1190,490,681,469,191,0.9950352
34,2,car,718,1192,491,680,474,189,0.9946807
35,2,car,720,1190,491,680,470,189,0.9939705
36,2,car,721,1189,490,680,468,190,0.99420947
37,2,car,721,1188,491,679,467,188,0.9941135
38,2,car,720,1190,491,680,470,189,0.99439865
39,2,car,721,1190,490,680,469,190,0.9935835
40,2,car,720,1190,490,680,470,190,0.99316007
41,2,car,720,1190,490,680,470,190,0.99366015
42,2,car,723,1188,491,680,465,189,0.9940172
43,2,car,723,1190,491,680,467,189,0.9925984
44,2,car,720,1189,491,679,469,188,0.99389535
45,2,car,720,1192,491,680,472,189,0.9947525
46,2,car,720,1189,490,681,469,191,0.99338204
47,2,car,723,1190,490,680,467,190,0.993658
48,2,car,722,1191,490,681,469,191,0.9944046
49,2,car,723,1189,491,680,466,189,0.9941147
50,2,car,592,912,482,651,320,169,0.9904916
51,2,car,593,912,482,651,319,169,0.99101853
52,2,car,591,911,482,650,320,168,0.99045604
0,2,car,721,1190,491,680,469,189,0.99315363
1,2,car,721,1190,491,680,469,189,0.9950945
2,2,car,719,1191,490,681,472,191,0.99357724
3,2,car,723,1191,491,680,468,189,0.99360245
4,2,car,721,1190,491,680,469,189,0.99408567
5,2,car,722,1191,490,680,469,190,0.99388546
6,2,car,719,1189,490,681,470,191,0.9933415
7,2,car,721,1189,490,681,468,191,0.99309224
8,2,car,720,1189,490,680,469,190,0.9933535
9,2,car,721,1189,490,680,468,190,0.99278355
10,2,car,722,1191,491,679,469,188,0.99334544
11,2,car,721,1189,491,679,468,188,0.9922223
12,2,car,721,1192,491,679,471,188,0.99353355
13,2,car,721,1190,491,680,469,189,0.9941834
14,2,car,721,1192,490,680,471,190,0.9927697
15,2,car,723,1187,491,680,464,189,0.9929273
16,2,car,720,1192,491,680,472,189,0.9943153
17,2,car,721,1190,490,680,469,190,0.9937749
18,2,car,721,1189,491,680,468,189,0.9938193
19,2,car,721,1193,490,681,472,191,0.9946054
20,2,car,721,1190,490,681,469,191,0.99308574
21,2,car,721,1191,490,680,470,190,0.99485815
22,2,car,719,1191,490,680,472,190,0.99378115
23,2,car,719,1192,490,681,473,191,0.994926
24,2,car,722,1192,490,680,470,190,0.9945114
25,2,car,722,1190,490,680,468,190,0.99356544
26,2,car,718,1192,490,680,474,190,0.99396724
27,2,car,720,1192,491,680,472,189,0.99402833
28,2,car,720,1188,490,681,468,191,0.9936452
29,2,car,722,1188,490,681,466,191,0.9941867
30,2,car,722,1189,490,681,467,191,0.99316216
31,2,car,721,1191,490,681,470,191,0.9934978
32,2,car,722,1192,491,679,470,188,0.9947086
33,2,car,719,1191,490,680,472,190,0.99448395
34,2,car,721,1190,490,681,469,191,0.9950352
35,2,car,718,1192,491,680,474,189,0.9946807
36,2,car,720,1190,491,680,470,189,0.9939705
37,2,car,721,1189,490,680,468,190,0.99420947
38,2,car,721,1188,491,679,467,188,0.9941135
39,2,car,720,1190,491,680,470,189,0.99439865
40,2,car,721,1190,490,680,469,190,0.9935835
41,2,car,720,1190,490,680,470,190,0.99316007
42,2,car,720,1190,490,680,470,190,0.99366015
43,2,car,723,1188,491,680,465,189,0.9940172
44,2,car,723,1190,491,680,467,189,0.9925984
45,2,car,720,1189,491,679,469,188,0.99389535
46,2,car,720,1192,491,680,472,189,0.9947525
47,2,car,720,1189,490,681,469,191,0.99338204
48,2,car,723,1190,490,680,467,190,0.993658
49,2,car,722,1191,490,681,469,191,0.9944046
50,2,car,723,1189,491,680,466,189,0.9941147
51,2,car,592,912,482,651,320,169,0.9904916
52,2,car,593,912,482,651,319,169,0.99101853
53,2,car,591,911,482,650,320,168,0.99045604
0,2,car,723,1192,490,680,469,190,0.992976
1,2,car,721,1190,491,680,469,189,0.99315363
2,2,car,721,1190,491,680,469,189,0.9950945
3,2,car,719,1191,490,681,472,191,0.99357724
4,2,car,723,1191,491,680,468,189,0.99360245
5,2,car,721,1190,491,680,469,189,0.99408567
6,2,car,722,1191,490,680,469,190,0.99388546
7,2,car,719,1189,490,681,470,191,0.9933415
8,2,car,721,1189,490,681,468,191,0.99309224
9,2,car,720,1189,490,680,469,190,0.9933535
10,2,car,721,1189,490,680,468,190,0.99278355
11,2,car,722,1191,491,679,469,188,0.99334544
12,2,car,721,1189,491,679,468,188,0.9922223
13,2,car,721,1192,491,679,471,188,0.99353355
14,2,car,721,1190,491,680,469,189,0.9941834
15,2,car,721,1192,490,680,471,190,0.9927697
16,2,car,723,1187,491,680,464,189,0.9929273
17,2,car,720,1192,491,680,472,189,0.9943153
18,2,car,721,1190,490,680,469,190,0.9937749
19,2,car,721,1189,491,680,468,189,0.9938193
20,2,car,721,1193,490,681,472,191,0.9946054
21,2,car,721,1190,490,681,469,191,0.99308574
22,2,car,721,1191,490,680,470,190,0.99485815
23,2,car,719,1191,490,680,472,190,0.99378115
24,2,car,719,1192,490,681,473,191,0.994926
25,2,car,722,1192,490,680,470,190,0.9945114
26,2,car,722,1190,490,680,468,190,0.99356544
27,2,car,718,1192,490,680,474,190,0.99396724
28,2,car,720,1192,491,680,472,189,0.99402833
29,2,car,720,1188,490,681,468,191,0.9936452
30,2,car,722,1188,490,681,466,191,0.9941867
31,2,car,722,1189,490,681,467,191,0.99316216
32,2,car,721,1191,490,681,470,191,0.9934978
33,2,car,722,1192,491,679,470,188,0.9947086
34,2,car,719,1191,490,680,472,190,0.99448395
35,2,car,721,1190,490,681,469,191,0.9950352
36,2,car,718,1192,491,680,474,189,0.9946807
37,2,car,720,1190,491,680,470,189,0.9939705
38,2,car,721,1189,490,680,468,190,0.99420947
39,2,car,721,1188,491,679,467,188,0.9941135
40,2,car,720,1190,491,680,470,189,0.99439865
41,2,car,721,1190,490,680,469,190,0.9935835
42,2,car,720,1190,490,680,470,190,0.99316007
43,2,car,720,1190,490,680,470,190,0.99366015
44,2,car,723,1188,491,680,465,189,0.9940172
45,2,car,723,1190,491,680,467,189,0.9925984
46,2,car,720,1189,491,679,469,188,0.99389535
47,2,car,720,1192,491,680,472,189,0.9947525
48,2,car,720,1189,490,681,469,191,0.99338204
49,2,car,723,1190,490,680,467,190,0.993658
50,2,car,722,1191,490,681,469,191,0.9944046
51,2,car,723,1189,491,680,466,189,0.9941147
52,2,car,592,912,482,651,320,169,0.9904916
53,2,car,593,912,482,651,319,169,0.99101853
54,2,car,591,911,482,650,320,168,0.99045604
0,2,car,719,1192,490,680,473,190,0.99388003
1,2,car,723,1192,490,680,469,190,0.992976
2,2,car,721,1190,491,680,469,189,0.99315363
3,2,car,721,1190,491,680,469,189,0.9950945
4,2,car,719,1191,490,681,472,191,0.99357724
5,2,car,723,1191,491,680,468,189,0.99360245
6,2,car,721,1190,491,680,469,189,0.99408567
7,2,car,722,1191,490,680,469,190,0.99388546
8,2,car,719,1189,490,681,470,191,0.9933415
9,2,car,721,1189,490,681,468,191,0.99309224
10,2,car,720,1189,490,680,469,190,0.9933535
11,2,car,721,1189,490,680,468,190,0.99278355
12,2,car,722,1191,491,679,469,188,0.99334544
13,2,car,721,1189,491,679,468,188,0.9922223
14,2,car,721,1192,491,679,471,188,0.99353355
15,2,car,721,1190,491,680,469,189,0.9941834
16,2,car,721,1192,490,680,471,190,0.9927697
17,2,car,723,1187,491,680,464,189,0.9929273
18,2,car,720,1192,491,680,472,189,0.9943153
19,2,car,721,1190,490,680,469,190,0.9937749
20,2,car,721,1189,491,680,468,189,0.9938193
21,2,car,721,1193,490,681,472,191,0.9946054
22,2,car,721,1190,490,681,469,191,0.99308574
23,2,car,721,1191,490,680,470,190,0.99485815
24,2,car,719,1191,490,680,472,190,0.99378115
25,2,car,719,1192,490,681,473,191,0.994926
26,2,car,722,1192,490,680,470,190,0.9945114
27,2,car,722,1190,490,680,468,190,0.99356544
28,2,car,718,1192,490,680,474,190,0.99396724
29,2,car,720,1192,491,680,472,189,0.99402833
30,2,car,720,1188,490,681,468,191,0.9936452
31,2,car,722,1188,490,681,466,191,0.9941867
32,2,car,722,1189,490,681,467,191,0.99316216
33,2,car,721,1191,490,681,470,191,0.9934978
34,2,car,722,1192,491,679,470,188,0.9947086
35,2,car,719,1191,490,680,472,190,0.99448395
36,2,car,721,1190,490,681,469,191,0.9950352
37,2,car,718,1192,491,680,474,189,0.9946807
38,2,car,720,1190,491,680,470,189,0.9939705
39,2,car,721,1189,490,680,468,190,0.99420947
40,2,car,721,1188,491,679,467,188,0.9941135
41,2,car,720,1190,491,680,470,189,0.99439865
42,2,car,721,1190,490,680,469,190,0.9935835
43,2,car,720,1190,490,680,470,190,0.99316007
44,2,car,720,1190,490,680,470,190,0.99366015
45,2,car,723,1188,491,680,465,189,0.9940172
46,2,car,723,1190,491,680,467,189,0.9925984
47,2,car,720,1189,491,679,469,188,0.99389535
48,2,car,720,1192,491,680,472,189,0.9947525
49,2,car,720,1189,490,681,469,191,0.99338204
50,2,car,723,1190,490,680,467,190,0.993658
51,2,car,722,1191,490,681,469,191,0.9944046
52,2,car,723,1189,491,680,466,189,0.9941147
53,2,car,592,912,482,651,320,169,0.9904916
54,2,car,593,912,482,651,319,169,0.99101853
55,2,car,591,911,482,650,320,168,0.99045604
0,2,car,722,1193,490,680,471,190,0.99402285
1,2,car,719,1192,490,680,473,190,0.99388003
2,2,car,723,1192,490,680,469,190,0.992976
3,2,car,721,1190,491,680,469,189,0.99315363
4,2,car,721,1190,491,680,469,189,0.9950945
5,2,car,719,1191,490,681,472,191,0.99357724
6,2,car,723,1191,491,680,468,189,0.99360245
7,2,car,721,1190,491,680,469,189,0.99408567
8,2,car,722,1191,490,680,469,190,0.99388546
9,2,car,719,1189,490,681,470,191,0.9933415
10,2,car,721,1189,490,681,468,191,0.99309224
11,2,car,720,1189,490,680,469,190,0.9933535
12,2,car,721,1189,490,680,468,190,0.99278355
13,2,car,722,1191,491,679,469,188,0.99334544
14,2,car,721,1189,491,679,468,188,0.9922223
15,2,car,721,1192,491,679,471,188,0.99353355
16,2,car,721,1190,491,680,469,189,0.9941834
17,2,car,721,1192,490,680,471,190,0.9927697
18,2,car,723,1187,491,680,464,189,0.9929273
19,2,car,720,1192,491,680,472,189,0.9943153
20,2,car,721,1190,490,680,469,190,0.9937749
21,2,car,721,1189,491,680,468,189,0.9938193
22,2,car,721,1193,490,681,472,191,0.9946054
23,2,car,721,1190,490,681,469,191,0.99308574
24,2,car,721,1191,490,680,470,190,0.99485815
25,2,car,719,1191,490,680,472,190,0.99378115
26,2,car,719,1192,490,681,473,191,0.994926
27,2,car,722,1192,490,680,470,190,0.9945114
28,2,car,722,1190,490,680,468,190,0.99356544
29,2,car,718,1192,490,680,474,190,0.99396724
30,2,car,720,1192,491,680,472,189,0.99402833
31,2,car,720,1188,490,681,468,191,0.9936452
32,2,car,722,1188,490,681,466,191,0.9941867
33,2,car,722,1189,490,681,467,191,0.99316216
34,2,car,721,1191,490,681,470,191,0.9934978
35,2,car,722,1192,491,679,470,188,0.9947086
36,2,car,719,1191,490,680,472,190,0.99448395
37,2,car,721,1190,490,681,469,191,0.9950352
38,2,car,718,1192,491,680,474,189,0.9946807
39,2,car,720,1190,491,680,470,189,0.9939705
40,2,car,721,1189,490,680,468,190,0.99420947
41,2,car,721,1188,491,679,467,188,0.9941135
42,2,car,720,1190,491,680,470,189,0.99439865
43,2,car,721,1190,490,680,469,190,0.9935835
44,2,car,720,1190,490,680,470,190,0.99316007
45,2,car,720,1190,490,680,470,190,0.99366015
46,2,car,723,1188,491,680,465,189,0.9940172
47,2,car,723,1190,491,680,467,189,0.9925984
48,2,car,720,1189,491,679,469,188,0.99389535
49,2,car,720,1192,491,680,472,189,0.9947525
50,2,car,720,1189,490,681,469,191,0.99338204
51,2,car,723,1190,490,680,467,190,0.993658
52,2,car,722,1191,490,681,469,191,0.9944046
53,2,car,723,1189,491,680,466,189,0.9941147
54,2,car,592,912,482,651,320,169,0.9904916
55,2,car,593,912,482,651,319,169,0.99101853
56,2,car,591,911,482,650,320,168,0.99045604
0,2,car,718,1190,490,681,472,191,0.99364763
1,2,car,722,1193,490,680,471,190,0.99402285
2,2,car,719,1192,490,680,473,190,0.99388003
3,2,car,723,1192,490,680,469,190,0.992976
4,2,car,721,1190,491,680,469,189,0.99315363
5,2,car,721,1190,491,680,469,189,0.9950945
6,2,car,719,1191,490,681,472,191,0.99357724
7,2,car,723,1191,491,680,468,189,0.99360245
8,2,car,721,1190,491,680,469,189,0.99408567
9,2,car,722,1191,490,680,469,190,0.99388546
10,2,car,719,1189,490,681,470,191,0.9933415
11,2,car,721,1189,490,681,468,191,0.99309224
12,2,car,720,1189,490,680,469,190,0.9933535
13,2,car,721,1189,490,680,468,190,0.99278355
14,2,car,722,1191,491,679,469,188,0.99334544
15,2,car,721,1189,491,679,468,188,0.9922223
16,2,car,721,1192,491,679,471,188,0.99353355
17,2,car,721,1190,491,680,469,189,0.9941834
18,2,car,721,1192,490,680,471,190,0.9927697
19,2,car,723,1187,491,680,464,189,0.9929273
20,2,car,720,1192,491,680,472,189,0.9943153
21,2,car,721,1190,490,680,469,190,0.9937749
22,2,car,721,1189,491,680,468,189,0.9938193
23,2,car,721,1193,490,681,472,191,0.9946054
24,2,car,721,1190,490,681,469,191,0.99308574
25,2,car,721,1191,490,680,470,190,0.99485815
26,2,car,719,1191,490,680,472,190,0.99378115
27,2,car,719,1192,490,681,473,191,0.994926
28,2,car,722,1192,490,680,470,190,0.9945114
29,2,car,722,1190,490,680,468,190,0.99356544
30,2,car,718,1192,490,680,474,190,0.99396724
31,2,car,720,1192,491,680,472,189,0.99402833
32,2,car,720,1188,490,681,468,191,0.9936452
33,2,car,722,1188,490,681,466,191,0.9941867
34,2,car,722,1189,490,681,467,191,0.99316216
35,2,car,721,1191,490,681,470,191,0.9934978
36,2,car,722,1192,491,679,470,188,0.9947086
37,2,car,719,1191,490,680,472,190,0.99448395
38,2,car,721,1190,490,681,469,191,0.9950352
39,2,car,718,1192,491,680,474,189,0.9946807
40,2,car,720,1190,491,680,470,189,0.9939705
41,2,car,721,1189,490,680,468,190,0.99420947
42,2,car,721,1188,491,679,467,188,0.9941135
43,2,car,720,1190,491,680,470,189,0.99439865
44,2,car,721,1190,490,680,469,190,0.9935835
45,2,car,720,1190,490,680,470,190,0.99316007
46,2,car,720,1190,490,680,470,190,0.99366015
47,2,car,723,1188,491,680,465,189,0.9940172
48,2,car,723,1190,491,680,467,189,0.9925984
49,2,car,720,1189,491,679,469,188,0.99389535
50,2,car,720,1192,491,680,472,189,0.9947525
51,2,car,720,1189,490,681,469,191,0.99338204
52,2,car,723,1190,490,680,467,190,0.993658
53,2,car,722,1191,490,681,469,191,0.9944046
54,2,car,723,1189,491,680,466,189,0.9941147
55,2,car,592,912,482,651,320,169,0.9904916
56,2,car,593,912,482,651,319,169,0.99101853
57,2,car,591,911,482,650,320,168,0.99045604
0,2,car,721,1190,491,680,469,189,0.993381
1,2,car,718,1190,490,681,472,191,0.99364763
2,2,car,722,1193,490,680,471,190,0.99402285
3,2,car,719,1192,490,680,473,190,0.99388003
4,2,car,723,1192,490,680,469,190,0.992976
5,2,car,721,1190,491,680,469,189,0.99315363
6,2,car,721,1190,491,680,469,189,0.9950945
7,2,car,719,1191,490,681,472,191,0.99357724
8,2,car,723,1191,491,680,468,189,0.99360245
9,2,car,721,1190,491,680,469,189,0.99408567
10,2,car,722,1191,490,680,469,190,0.99388546
11,2,car,719,1189,490,681,470,191,0.9933415
12,2,car,721,1189,490,681,468,191,0.99309224
13,2,car,720,1189,490,680,469,190,0.9933535
14,2,car,721,1189,490,680,468,190,0.99278355
15,2,car,722,1191,491,679,469,188,0.99334544
16,2,car,721,1189,491,679,468,188,0.9922223
17,2,car,721,1192,491,679,471,188,0.99353355
18,2,car,721,1190,491,680,469,189,0.9941834
19,2,car,721,1192,490,680,471,190,0.9927697
20,2,car,723,1187,491,680,464,189,0.9929273
21,2,car,720,1192,491,680,472,189,0.9943153
22,2,car,721,1190,490,680,469,190,0.9937749
23,2,car,721,1189,491,680,468,189,0.9938193
24,2,car,721,1193,490,681,472,191,0.9946054
25,2,car,721,1190,490,681,469,191,0.99308574
26,2,car,721,1191,490,680,470,190,0.99485815
27,2,car,719,1191,490,680,472,190,0.99378115
28,2,car,719,1192,490,681,473,191,0.994926
29,2,car,722,1192,490,680,470,190,0.9945114
30,2,car,722,1190,490,680,468,190,0.99356544
31,2,car,718,1192,490,680,474,190,0.99396724
32,2,car,720,1192,491,680,472,189,0.99402833
33,2,car,720,1188,490,681,468,191,0.9936452
34,2,car,722,1188,490,681,466,191,0.9941867
35,2,car,722,1189,490,681,467,191,0.99316216
36,2,car,721,1191,490,681,470,191,0.9934978
37,2,car,722,1192,491,679,470,188,0.9947086
38,2,car,719,1191,490,680,472,190,0.99448395
39,2,car,721,1190,490,681,469,191,0.9950352
40,2,car,718,1192,491,680,474,189,0.9946807
41,2,car,720,1190,491,680,470,189,0.9939705
42,2,car,721,1189,490,680,468,190,0.99420947
43,2,car,721,1188,491,679,467,188,0.9941135
44,2,car,720,1190,491,680,470,189,0.99439865
45,2,car,721,1190,490,680,469,190,0.9935835
46,2,car,720,1190,490,680,470,190,0.99316007
47,2,car,720,1190,490,680,470,190,0.99366015
48,2,car,723,1188,491,680,465,189,0.9940172
49,2,car,723,1190,491,680,467,189,0.9925984
50,2,car,720,1189,491,679,469,188,0.99389535
51,2,car,720,1192,491,680,472,189,0.9947525
52,2,car,720,1189,490,681,469,191,0.99338204
53,2,car,723,1190,490,680,467,190,0.993658
54,2,car,722,1191,490,681,469,191,0.9944046
55,2,car,723,1189,491,680,466,189,0.9941147
56,2,car,592,912,482,651,320,169,0.9904916
57,2,car,593,912,482,651,319,169,0.99101853
58,2,car,591,911,482,650,320,168,0.99045604
0,2,car,720,1191,489,681,471,192,0.99269456
1,2,car,721,1190,491,680,469,189,0.993381
2,2,car,718,1190,490,681,472,191,0.99364763
3,2,car,722,1193,490,680,471,190,0.99402285
4,2,car,719,1192,490,680,473,190,0.99388003
5,2,car,723,1192,490,680,469,190,0.992976
6,2,car,721,1190,491,680,469,189,0.99315363
7,2,car,721,1190,491,680,469,189,0.9950945
8,2,car,719,1191,490,681,472,191,0.99357724
9,2,car,723,1191,491,680,468,189,0.99360245
10,2,car,721,1190,491,680,469,189,0.99408567
11,2,car,722,1191,490,680,469,190,0.99388546
12,2,car,719,1189,490,681,470,191,0.9933415
13,2,car,721,1189,490,681,468,191,0.99309224
14,2,car,720,1189,490,680,469,190,0.9933535
15,2,car,721,1189,490,680,468,190,0.99278355
16,2,car,722,1191,491,679,469,188,0.99334544
17,2,car,721,1189,491,679,468,188,0.9922223
18,2,car,721,1192,491,679,471,188,0.99353355
19,2,car,721,1190,491,680,469,189,0.9941834
20,2,car,721,1192,490,680,471,190,0.9927697
21,2,car,723,1187,491,680,464,189,0.9929273
22,2,car,720,1192,491,680,472,189,0.9943153
23,2,car,721,1190,490,680,469,190,0.9937749
24,2,car,721,1189,491,680,468,189,0.9938193
25,2,car,721,1193,490,681,472,191,0.9946054
26,2,car,721,1190,490,681,469,191,0.99308574
27,2,car,721,1191,490,680,470,190,0.99485815
28,2,car,719,1191,490,680,472,190,0.99378115
29,2,car,719,1192,490,681,473,191,0.994926
30,2,car,722,1192,490,680,470,190,0.9945114
31,2,car,722,1190,490,680,468,190,0.99356544
32,2,car,718,1192,490,680,474,190,0.99396724
33,2,car,720,1192,491,680,472,189,0.99402833
34,2,car,720,1188,490,681,468,191,0.9936452
35,2,car,722,1188,490,681,466,191,0.9941867
36,2,car,722,1189,490,681,467,191,0.99316216
37,2,car,721,1191,490,681,470,191,0.9934978
38,2,car,722,1192,491,679,470,188,0.9947086
39,2,car,719,1191,490,680,472,190,0.99448395
40,2,car,721,1190,490,681,469,191,0.9950352
41,2,car,718,1192,491,680,474,189,0.9946807
42,2,car,720,1190,491,680,470,189,0.9939705
43,2,car,721,1189,490,680,468,190,0.99420947
44,2,car,721,1188,491,679,467,188,0.9941135
45,2,car,720,1190,491,680,470,189,0.99439865
46,2,car,721,1190,490,680,469,190,0.9935835
47,2,car,720,1190,490,680,470,190,0.99316007
48,2,car,720,1190,490,680,470,190,0.99366015
49,2,car,723,1188,491,680,465,189,0.9940172
50,2,car,723,1190,491,680,467,189,0.9925984
51,2,car,720,1189,491,679,469,188,0.99389535
52,2,car,720,1192,491,680,472,189,0.9947525
53,2,car,720,1189,490,681,469,191,0.99338204
54,2,car,723,1190,490,680,467,190,0.993658
55,2,car,722,1191,490,681,469,191,0.9944046
56,2,car,723,1189,491,680,466,189,0.9941147
57,2,car,592,912,482,651,320,169,0.9904916
58,2,car,593,912,482,651,319,169,0.99101853
59,2,car,591,911,482,650,320,168,0.99045604
0,2,car,721,1192,491,679,471,188,0.99167436
1,2,car,720,1191,489,681,471,192,0.99269456
2,2,car,721,1190,491,680,469,189,0.993381
3,2,car,718,1190,490,681,472,191,0.99364763
4,2,car,722,1193,490,680,471,190,0.99402285
5,2,car,719,1192,490,680,473,190,0.99388003
6,2,car,723,1192,490,680,469,190,0.992976
7,2,car,721,1190,491,680,469,189,0.99315363
8,2,car,721,1190,491,680,469,189,0.9950945
9,2,car,719,1191,490,681,472,191,0.99357724
10,2,car,723,1191,491,680,468,189,0.99360245
11,2,car,721,1190,491,680,469,189,0.99408567
12,2,car,722,1191,490,680,469,190,0.99388546
13,2,car,719,1189,490,681,470,191,0.9933415
14,2,car,721,1189,490,681,468,191,0.99309224
15,2,car,720,1189,490,680,469,190,0.9933535
16,2,car,721,1189,490,680,468,190,0.99278355
17,2,car,722,1191,491,679,469,188,0.99334544
18,2,car,721,1189,491,679,468,188,0.9922223
19,2,car,721,1192,491,679,471,188,0.99353355
20,2,car,721,1190,491,680,469,189,0.9941834
21,2,car,721,1192,490,680,471,190,0.9927697
22,2,car,723,1187,491,680,464,189,0.9929273
23,2,car,720,1192,491,680,472,189,0.9943153
24,2,car,721,1190,490,680,469,190,0.9937749
25,2,car,721,1189,491,680,468,189,0.9938193
26,2,car,721,1193,490,681,472,191,0.9946054
27,2,car,721,1190,490,681,469,191,0.99308574
28,2,car,721,1191,490,680,470,190,0.99485815
29,2,car,719,1191,490,680,472,190,0.99378115
30,2,car,719,1192,490,681,473,191,0.994926
31,2,car,722,1192,490,680,470,190,0.9945114
32,2,car,722,1190,490,680,468,190,0.99356544
33,2,car,718,1192,490,680,474,190,0.99396724
34,2,car,720,1192,491,680,472,189,0.99402833
35,2,car,720,1188,490,681,468,191,0.9936452
36,2,car,722,1188,490,681,466,191,0.9941867
37,2,car,722,1189,490,681,467,191,0.99316216
38,2,car,721,1191,490,681,470,191,0.9934978
39,2,car,722,1192,491,679,470,188,0.9947086
40,2,car,719,1191,490,680,472,190,0.99448395
41,2,car,721,1190,490,681,469,191,0.9950352
42,2,car,718,1192,491,680,474,189,0.9946807
43,2,car,720,1190,491,680,470,189,0.9939705
44,2,car,721,1189,490,680,468,190,0.99420947
45,2,car,721,1188,491,679,467,188,0.9941135
46,2,car,720,1190,491,680,470,189,0.99439865
47,2,car,721,1190,490,680,469,190,0.9935835
48,2,car,720,1190,490,680,470,190,0.99316007
49,2,car,720,1190,490,680,470,190,0.99366015
50,2,car,723,1188,491,680,465,189,0.9940172
51,2,car,723,1190,491,680,467,189,0.9925984
52,2,car,720,1189,491,679,469,188,0.99389535
53,2,car,720,1192,491,680,472,189,0.9947525
54,2,car,720,1189,490,681,469,191,0.99338204
55,2,car,723,1190,490,680,467,190,0.993658
56,2,car,722,1191,490,681,469,191,0.9944046
57,2,car,723,1189,491,680,466,189,0.9941147
58,2,car,592,912,482,651,320,169,0.9904916
59,2,car,593,912,482,651,319,169,0.99101853
60,2,car,591,911,482,650,320,168,0.99045604
0,2,car,721,1191,491,680,470,189,0.99370116
1,2,car,721,1192,491,679,471,188,0.99167436
2,2,car,720,1191,489,681,471,192,0.99269456
3,2,car,721,1190,491,680,469,189,0.993381
4,2,car,718,1190,490,681,472,191,0.99364763
5,2,car,722,1193,490,680,471,190,0.99402285
6,2,car,719,1192,490,680,473,190,0.99388003
7,2,car,723,1192,490,680,469,190,0.992976
8,2,car,721,1190,491,680,469,189,0.99315363
9,2,car,721,1190,491,680,469,189,0.9950945
10,2,car,719,1191,490,681,472,191,0.99357724
11,2,car,723,1191,491,680,468,189,0.99360245
12,2,car,721,1190,491,680,469,189,0.99408567
13,2,car,722,1191,490,680,469,190,0.99388546
14,2,car,719,1189,490,681,470,191,0.9933415
15,2,car,721,1189,490,681,468,191,0.99309224
16,2,car,720,1189,490,680,469,190,0.9933535
17,2,car,721,1189,490,680,468,190,0.99278355
18,2,car,722,1191,491,679,469,188,0.99334544
19,2,car,721,1189,491,679,468,188,0.9922223
20,2,car,721,1192,491,679,471,188,0.99353355
21,2,car,721,1190,491,680,469,189,0.9941834
22,2,car,721,1192,490,680,471,190,0.9927697
23,2,car,723,1187,491,680,464,189,0.9929273
24,2,car,720,1192,491,680,472,189,0.9943153
25,2,car,721,1190,490,680,469,190,0.9937749
26,2,car,721,1189,491,680,468,189,0.9938193
27,2,car,721,1193,490,681,472,191,0.9946054
28,2,car,721,1190,490,681,469,191,0.99308574
29,2,car,721,1191,490,680,470,190,0.99485815
30,2,car,719,1191,490,680,472,190,0.99378115
31,2,car,719,1192,490,681,473,191,0.994926
32,2,car,722,1192,490,680,470,190,0.9945114
33,2,car,722,1190,490,680,468,190,0.99356544
34,2,car,718,1192,490,680,474,190,0.99396724
35,2,car,720,1192,491,680,472,189,0.99402833
36,2,car,720,1188,490,681,468,191,0.9936452
37,2,car,722,1188,490,681,466,191,0.9941867
38,2,car,722,1189,490,681,467,191,0.99316216
39,2,car,721,1191,490,681,470,191,0.9934978
40,2,car,722,1192,491,679,470,188,0.9947086
41,2,car,719,1191,490,680,472,190,0.99448395
42,2,car,721,1190,490,681,469,191,0.9950352
43,2,car,718,1192,491,680,474,189,0.9946807
44,2,car,720,1190,491,680,470,189,0.9939705
45,2,car,721,1189,490,680,468,190,0.99420947
46,2,car,721,1188,491,679,467,188,0.9941135
47,2,car,720,1190,491,680,470,189,0.99439865
48,2,car,721,1190,490,680,469,190,0.9935835
49,2,car,720,1190,490,680,470,190,0.99316007
50,2,car,720,1190,490,680,470,190,0.99366015
51,2,car,723,1188,491,680,465,189,0.9940172
52,2,car,723,1190,491,680,467,189,0.9925984
53,2,car,720,1189,491,679,469,188,0.99389535
54,2,car,720,1192,491,680,472,189,0.9947525
55,2,car,720,1189,490,681,469,191,0.99338204
56,2,car,723,1190,490,680,467,190,0.993658
57,2,car,722,1191,490,681,469,191,0.9944046
58,2,car,723,1189,491,680,466,189,0.9941147
59,2,car,592,912,482,651,320,169,0.9904916
60,2,car,593,912,482,651,319,169,0.99101853
61,2,car,591,911,482,650,320,168,0.99045604
0,2,car,721,1192,490,681,471,191,0.9930029
1,2,car,721,1191,491,680,470,189,0.99370116
2,2,car,721,1192,491,679,471,188,0.99167436
3,2,car,720,1191,489,681,471,192,0.99269456
4,2,car,721,1190,491,680,469,189,0.993381
5,2,car,718,1190,490,681,472,191,0.99364763
6,2,car,722,1193,490,680,471,190,0.99402285
7,2,car,719,1192,490,680,473,190,0.99388003
8,2,car,723,1192,490,680,469,190,0.992976
9,2,car,721,1190,491,680,469,189,0.99315363
10,2,car,721,1190,491,680,469,189,0.9950945
11,2,car,719,1191,490,681,472,191,0.99357724
12,2,car,723,1191,491,680,468,189,0.99360245
13,2,car,721,1190,491,680,469,189,0.99408567
14,2,car,722,1191,490,680,469,190,0.99388546
15,2,car,719,1189,490,681,470,191,0.9933415
16,2,car,721,1189,490,681,468,191,0.99309224
17,2,car,720,1189,490,680,469,190,0.9933535
18,2,car,721,1189,490,680,468,190,0.99278355
19,2,car,722,1191,491,679,469,188,0.99334544
20,2,car,721,1189,491,679,468,188,0.9922223
21,2,car,721,1192,491,679,471,188,0.99353355
22,2,car,721,1190,491,680,469,189,0.9941834
23,2,car,721,1192,490,680,471,190,0.9927697
24,2,car,723,1187,491,680,464,189,0.9929273
25,2,car,720,1192,491,680,472,189,0.9943153
26,2,car,721,1190,490,680,469,190,0.9937749
27,2,car,721,1189,491,680,468,189,0.9938193
28,2,car,721,1193,490,681,472,191,0.9946054
29,2,car,721,1190,490,681,469,191,0.99308574
30,2,car,721,1191,490,680,470,190,0.99485815
31,2,car,719,1191,490,680,472,190,0.99378115
32,2,car,719,1192,490,681,473,191,0.994926
33,2,car,722,1192,490,680,470,190,0.9945114
34,2,car,722,1190,490,680,468,190,0.99356544
35,2,car,718,1192,490,680,474,190,0.99396724
36,2,car,720,1192,491,680,472,189,0.99402833
37,2,car,720,1188,490,681,468,191,0.9936452
38,2,car,722,1188,490,681,466,191,0.9941867
39,2,car,722,1189,490,681,467,191,0.99316216
40,2,car,721,1191,490,681,470,191,0.9934978
41,2,car,722,1192,491,679,470,188,0.9947086
42,2,car,719,1191,490,680,472,190,0.99448395
43,2,car,721,1190,490,681,469,191,0.9950352
44,2,car,718,1192,491,680,474,189,0.9946807
45,2,car,720,1190,491,680,470,189,0.9939705
46,2,car,721,1189,490,680,468,190,0.99420947
47,2,car,721,1188,491,679,467,188,0.9941135
48,2,car,720,1190,491,680,470,189,0.99439865
49,2,car,721,1190,490,680,469,190,0.9935835
50,2,car,720,1190,490,680,470,190,0.99316007
51,2,car,720,1190,490,680,470,190,0.99366015
52,2,car,723,1188,491,680,465,189,0.9940172
53,2,car,723,1190,491,680,467,189,0.9925984
54,2,car,720,1189,491,679,469,188,0.99389535
55,2,car,720,1192,491,680,472,189,0.9947525
56,2,car,720,1189,490,681,469,191,0.99338204
57,2,car,723,1190,490,680,467,190,0.993658
58,2,car,722,1191,490,681,469,191,0.9944046
59,2,car,723,1189,491,680,466,189,0.9941147
60,2,car,592,912,482,651,320,169,0.9904916
61,2,car,593,912,482,651,319,169,0.99101853
62,2,car,591,911,482,650,320,168,0.99045604
0,2,car,722,1189,490,681,467,191,0.9922209
1,2,car,721,1192,490,681,471,191,0.9930029
2,2,car,721,1191,491,680,470,189,0.99370116
3,2,car,721,1192,491,679,471,188,0.99167436
4,2,car,720,1191,489,681,471,192,0.99269456
5,2,car,721,1190,491,680,469,189,0.993381
6,2,car,718,1190,490,681,472,191,0.99364763
7,2,car,722,1193,490,680,471,190,0.99402285
8,2,car,719,1192,490,680,473,190,0.99388003
9,2,car,723,1192,490,680,469,190,0.992976
10,2,car,721,1190,491,680,469,189,0.99315363
11,2,car,721,1190,491,680,469,189,0.9950945
12,2,car,719,1191,490,681,472,191,0.99357724
13,2,car,723,1191,491,680,468,189,0.99360245
14,2,car,721,1190,491,680,469,189,0.99408567
15,2,car,722,1191,490,680,469,190,0.99388546
16,2,car,719,1189,490,681,470,191,0.9933415
17,2,car,721,1189,490,681,468,191,0.99309224
18,2,car,720,1189,490,680,469,190,0.9933535
19,2,car,721,1189,490,680,468,190,0.99278355
20,2,car,722,1191,491,679,469,188,0.99334544
21,2,car,721,1189,491,679,468,188,0.9922223
22,2,car,721,1192,491,679,471,188,0.99353355
23,2,car,721,1190,491,680,469,189,0.9941834
24,2,car,721,1192,490,680,471,190,0.9927697
25,2,car,723,1187,491,680,464,189,0.9929273
26,2,car,720,1192,491,680,472,189,0.9943153
27,2,car,721,1190,490,680,469,190,0.9937749
28,2,car,721,1189,491,680,468,189,0.9938193
29,2,car,721,1193,490,681,472,191,0.9946054
30,2,car,721,1190,490,681,469,191,0.99308574
31,2,car,721,1191,490,680,470,190,0.99485815
32,2,car,719,1191,490,680,472,190,0.99378115
33,2,car,719,1192,490,681,473,191,0.994926
34,2,car,722,1192,490,680,470,190,0.9945114
35,2,car,722,1190,490,680,468,190,0.99356544
36,2,car,718,1192,490,680,474,190,0.99396724
37,2,car,720,1192,491,680,472,189,0.99402833
38,2,car,720,1188,490,681,468,191,0.9936452
39,2,car,722,1188,490,681,466,191,0.9941867
40,2,car,722,1189,490,681,467,191,0.99316216
41,2,car,721,1191,490,681,470,191,0.9934978
42,2,car,722,1192,491,679,470,188,0.9947086
43,2,car,719,1191,490,680,472,190,0.99448395
44,2,car,721,1190,490,681,469,191,0.9950352
45,2,car,718,1192,491,680,474,189,0.9946807
46,2,car,720,1190,491,680,470,189,0.9939705
47,2,car,721,1189,490,680,468,190,0.99420947
48,2,car,721,1188,491,679,467,188,0.9941135
49,2,car,720,1190,491,680,470,189,0.99439865
50,2,car,721,1190,490,680,469,190,0.9935835
51,2,car,720,1190,490,680,470,190,0.99316007
52,2,car,720,1190,490,680,470,190,0.99366015
53,2,car,723,1188,491,680,465,189,0.9940172
54,2,car,723,1190,491,680,467,189,0.9925984
55,2,car,720,1189,491,679,469,188,0.99389535
56,2,car,720,1192,491,680,472,189,0.9947525
57,2,car,720,1189,490,681,469,191,0.99338204
58,2,car,723,1190,490,680,467,190,0.993658
59,2,car,722,1191,490,681,469,191,0.9944046
60,2,car,723,1189,491,680,466,189,0.9941147
61,2,car,592,912,482,651,320,169,0.9904916
62,2,car,593,912,482,651,319,169,0.99101853
63,2,car,591,911,482,650,320,168,0.99045604
0,2,car,722,1191,491,680,469,189,0.9921203
1,2,car,722,1189,490,681,467,191,0.9922209
2,2,car,721,1192,490,681,471,191,0.9930029
3,2,car,721,1191,491,680,470,189,0.99370116
4,2,car,721,1192,491,679,471,188,0.99167436
5,2,car,720,1191,489,681,471,192,0.99269456
6,2,car,721,1190,491,680,469,189,0.993381
7,2,car,718,1190,490,681,472,191,0.99364763
8,2,car,722,1193,490,680,471,190,0.99402285
9,2,car,719,1192,490,680,473,190,0.99388003
10,2,car,723,1192,490,680,469,190,0.992976
11,2,car,721,1190,491,680,469,189,0.99315363
12,2,car,721,1190,491,680,469,189,0.9950945
13,2,car,719,1191,490,681,472,191,0.99357724
14,2,car,723,1191,491,680,468,189,0.99360245
15,2,car,721,1190,491,680,469,189,0.99408567
16,2,car,722,1191,490,680,469,190,0.99388546
17,2,car,719,1189,490,681,470,191,0.9933415
18,2,car,721,1189,490,681,468,191,0.99309224
19,2,car,720,1189,490,680,469,190,0.9933535
20,2,car,721,1189,490,680,468,190,0.99278355
21,2,car,722,1191,491,679,469,188,0.99334544
22,2,car,721,1189,491,679,468,188,0.9922223
23,2,car,721,1192,491,679,471,188,0.99353355
24,2,car,721,1190,491,680,469,189,0.9941834
25,2,car,721,1192,490,680,471,190,0.9927697
26,2,car,723,1187,491,680,464,189,0.9929273
27,2,car,720,1192,491,680,472,189,0.9943153
28,2,car,721,1190,490,680,469,190,0.9937749
29,2,car,721,1189,491,680,468,189,0.9938193
30,2,car,721,1193,490,681,472,191,0.9946054
31,2,car,721,1190,490,681,469,191,0.99308574
32,2,car,721,1191,490,680,470,190,0.99485815
33,2,car,719,1191,490,680,472,190,0.99378115
34,2,car,719,1192,490,681,473,191,0.994926
35,2,car,722,1192,490,680,470,190,0.9945114
36,2,car,722,1190,490,680,468,190,0.99356544
37,2,car,718,1192,490,680,474,190,0.99396724
38,2,car,720,1192,491,680,472,189,0.99402833
39,2,car,720,1188,490,681,468,191,0.9936452
40,2,car,722,1188,490,681,466,191,0.9941867
41,2,car,722,1189,490,681,467,191,0.99316216
42,2,car,721,1191,490,681,470,191,0.9934978
43,2,car,722,1192,491,679,470,188,0.9947086
44,2,car,719,1191,490,680,472,190,0.99448395
45,2,car,721,1190,490,681,469,191,0.9950352
46,2,car,718,1192,491,680,474,189,0.9946807
47,2,car,720,1190,491,680,470,189,0.9939705
48,2,car,721,1189,490,680,468,190,0.99420947
49,2,car,721,1188,491,679,467,188,0.9941135
50,2,car,720,1190,491,680,470,189,0.99439865
51,2,car,721,1190,490,680,469,190,0.9935835
52,2,car,720,1190,490,680,470,190,0.99316007
53,2,car,720,1190,490,680,470,190,0.99366015
54,2,car,723,1188,491,680,465,189,0.9940172
55,2,car,723,1190,491,680,467,189,0.9925984
56,2,car,720,1189,491,679,469,188,0.99389535
57,2,car,720,1192,491,680,472,189,0.9947525
58,2,car,720,1189,490,681,469,191,0.99338204
59,2,car,723,1190,490,680,467,190,0.993658
60,2,car,722,1191,490,681,469,191,0.9944046
61,2,car,723,1189,491,680,466,189,0.9941147
62,2,car,592,912,482,651,320,169,0.9904916
63,2,car,593,912,482,651,319,169,0.99101853
64,2,car,591,911,482,650,320,168,0.99045604
0,2,car,722,1189,490,680,467,190,0.9928037
1,2,car,722,1191,491,680,469,189,0.9921203
2,2,car,722,1189,490,681,467,191,0.9922209
3,2,car,721,1192,490,681,471,191,0.9930029
4,2,car,721,1191,491,680,470,189,0.99370116
5,2,car,721,1192,491,679,471,188,0.99167436
6,2,car,720,1191,489,681,471,192,0.99269456
7,2,car,721,1190,491,680,469,189,0.993381
8,2,car,718,1190,490,681,472,191,0.99364763
9,2,car,722,1193,490,680,471,190,0.99402285
10,2,car,719,1192,490,680,473,190,0.99388003
11,2,car,723,1192,490,680,469,190,0.992976
12,2,car,721,1190,491,680,469,189,0.99315363
13,2,car,721,1190,491,680,469,189,0.9950945
14,2,car,719,1191,490,681,472,191,0.99357724
15,2,car,723,1191,491,680,468,189,0.99360245
16,2,car,721,1190,491,680,469,189,0.99408567
17,2,car,722,1191,490,680,469,190,0.99388546
18,2,car,719,1189,490,681,470,191,0.9933415
19,2,car,721,1189,490,681,468,191,0.99309224
20,2,car,720,1189,490,680,469,190,0.9933535
21,2,car,721,1189,490,680,468,190,0.99278355
22,2,car,722,1191,491,679,469,188,0.99334544
23,2,car,721,1189,491,679,468,188,0.9922223
24,2,car,721,1192,491,679,471,188,0.99353355
25,2,car,721,1190,491,680,469,189,0.9941834
26,2,car,721,1192,490,680,471,190,0.9927697
27,2,car,723,1187,491,680,464,189,0.9929273
28,2,car,720,1192,491,680,472,189,0.9943153
29,2,car,721,1190,490,680,469,190,0.9937749
30,2,car,721,1189,491,680,468,189,0.9938193
31,2,car,721,1193,490,681,472,191,0.9946054
32,2,car,721,1190,490,681,469,191,0.99308574
33,2,car,721,1191,490,680,470,190,0.99485815
34,2,car,719,1191,490,680,472,190,0.99378115
35,2,car,719,1192,490,681,473,191,0.994926
36,2,car,722,1192,490,680,470,190,0.9945114
37,2,car,722,1190,490,680,468,190,0.99356544
38,2,car,718,1192,490,680,474,190,0.99396724
39,2,car,720,1192,491,680,472,189,0.99402833
40,2,car,720,1188,490,681,468,191,0.9936452
41,2,car,722,1188,490,681,466,191,0.9941867
42,2,car,722,1189,490,681,467,191,0.99316216
43,2,car,721,1191,490,681,470,191,0.9934978
44,2,car,722,1192,491,679,470,188,0.9947086
45,2,car,719,1191,490,680,472,190,0.99448395
46,2,car,721,1190,490,681,469,191,0.9950352
47,2,car,718,1192,491,680,474,189,0.9946807
48,2,car,720,1190,491,680,470,189,0.9939705
49,2,car,721,1189,490,680,468,190,0.99420947
50,2,car,721,1188,491,679,467,188,0.9941135
51,2,car,720,1190,491,680,470,189,0.99439865
52,2,car,721,1190,490,680,469,190,0.9935835
53,2,car,720,1190,490,680,470,190,0.99316007
54,2,car,720,1190,490,680,470,190,0.99366015
55,2,car,723,1188,491,680,465,189,0.9940172
56,2,car,723,1190,491,680,467,189,0.9925984
57,2,car,720,1189,491,679,469,188,0.99389535
58,2,car,720,1192,491,680,472,189,0.9947525
59,2,car,720,1189,490,681,469,191,0.99338204
60,2,car,723,1190,490,680,467,190,0.993658
61,2,car,722,1191,490,681,469,191,0.9944046
62,2,car,723,1189,491,680,466,189,0.9941147
63,2,car,592,912,482,651,320,169,0.9904916
64,2,car,593,912,482,651,319,169,0.99101853
65,2,car,591,911,482,650,320,168,0.99045604
0,2,car,722,1189,492,678,467,186,0.99312747
1,2,car,722,1189,490,680,467,190,0.9928037
2,2,car,722,1191,491,680,469,189,0.9921203
3,2,car,722,1189,490,681,467,191,0.9922209
4,2,car,721,1192,490,681,471,191,0.9930029
5,2,car,721,1191,491,680,470,189,0.99370116
6,2,car,721,1192,491,679,471,188,0.99167436
7,2,car,720,1191,489,681,471,192,0.99269456
8,2,car,721,1190,491,680,469,189,0.993381
9,2,car,718,1190,490,681,472,191,0.99364763
10,2,car,722,1193,490,680,471,190,0.99402285
11,2,car,719,1192,490,680,473,190,0.99388003
12,2,car,723,1192,490,680,469,190,0.992976
13,2,car,721,1190,491,680,469,189,0.99315363
14,2,car,721,1190,491,680,469,189,0.9950945
15,2,car,719,1191,490,681,472,191,0.99357724
16,2,car,723,1191,491,680,468,189,0.99360245
17,2,car,721,1190,491,680,469,189,0.99408567
18,2,car,722,1191,490,680,469,190,0.99388546
19,2,car,719,1189,490,681,470,191,0.9933415
20,2,car,721,1189,490,681,468,191,0.99309224
21,2,car,720,1189,490,680,469,190,0.9933535
22,2,car,721,1189,490,680,468,190,0.99278355
23,2,car,722,1191,491,679,469,188,0.99334544
24,2,car,721,1189,491,679,468,188,0.9922223
25,2,car,721,1192,491,679,471,188,0.99353355
26,2,car,721,1190,491,680,469,189,0.9941834
27,2,car,721,1192,490,680,471,190,0.9927697
28,2,car,723,1187,491,680,464,189,0.9929273
29,2,car,720,1192,491,680,472,189,0.9943153
30,2,car,721,1190,490,680,469,190,0.9937749
31,2,car,721,1189,491,680,468,189,0.9938193
32,2,car,721,1193,490,681,472,191,0.9946054
33,2,car,721,1190,490,681,469,191,0.99308574
34,2,car,721,1191,490,680,470,190,0.99485815
35,2,car,719,1191,490,680,472,190,0.99378115
36,2,car,719,1192,490,681,473,191,0.994926
37,2,car,722,1192,490,680,470,190,0.9945114
38,2,car,722,1190,490,680,468,190,0.99356544
39,2,car,718,1192,490,680,474,190,0.99396724
40,2,car,720,1192,491,680,472,189,0.99402833
41,2,car,720,1188,490,681,468,191,0.9936452
42,2,car,722,1188,490,681,466,191,0.9941867
43,2,car,722,1189,490,681,467,191,0.99316216
44,2,car,721,1191,490,681,470,191,0.9934978
45,2,car,722,1192,491,679,470,188,0.9947086
46,2,car,719,1191,490,680,472,190,0.99448395
47,2,car,721,1190,490,681,469,191,0.9950352
48,2,car,718,1192,491,680,474,189,0.9946807
49,2,car,720,1190,491,680,470,189,0.9939705
50,2,car,721,1189,490,680,468,190,0.99420947
51,2,car,721,1188,491,679,467,188,0.9941135
52,2,car,720,1190,491,680,470,189,0.99439865
53,2,car,721,1190,490,680,469,190,0.9935835
54,2,car,720,1190,490,680,470,190,0.99316007
55,2,car,720,1190,490,680,470,190,0.99366015
56,2,car,723,1188,491,680,465,189,0.9940172
57,2,car,723,1190,491,680,467,189,0.9925984
58,2,car,720,1189,491,679,469,188,0.99389535
59,2,car,720,1192,491,680,472,189,0.9947525
60,2,car,720,1189,490,681,469,191,0.99338204
61,2,car,723,1190,490,680,467,190,0.993658
62,2,car,722,1191,490,681,469,191,0.9944046
63,2,car,723,1189,491,680,466,189,0.9941147
64,2,car,592,912,482,651,320,169,0.9904916
65,2,car,593,912,482,651,319,169,0.99101853
66,2,car,591,911,482,650,320,168,0.99045604
0,2,car,721,1191,490,681,470,191,0.99170077
1,2,car,722,1189,492,678,467,186,0.99312747
2,2,car,722,1189,490,680,467,190,0.9928037
3,2,car,722,1191,491,680,469,189,0.9921203
4,2,car,722,1189,490,681,467,191,0.9922209
5,2,car,721,1192,490,681,471,191,0.9930029
6,2,car,721,1191,491,680,470,189,0.99370116
7,2,car,721,1192,491,679,471,188,0.99167436
8,2,car,720,1191,489,681,471,192,0.99269456
9,2,car,721,1190,491,680,469,189,0.993381
10,2,car,718,1190,490,681,472,191,0.99364763
11,2,car,722,1193,490,680,471,190,0.99402285
12,2,car,719,1192,490,680,473,190,0.99388003
13,2,car,723,1192,490,680,469,190,0.992976
14,2,car,721,1190,491,680,469,189,0.99315363
15,2,car,721,1190,491,680,469,189,0.9950945
16,2,car,719,1191,490,681,472,191,0.99357724
17,2,car,723,1191,491,680,468,189,0.99360245
18,2,car,721,1190,491,680,469,189,0.99408567
19,2,car,722,1191,490,680,469,190,0.99388546
20,2,car,719,1189,490,681,470,191,0.9933415
21,2,car,721,1189,490,681,468,191,0.99309224
22,2,car,720,1189,490,680,469,190,0.9933535
23,2,car,721,1189,490,680,468,190,0.99278355
24,2,car,722,1191,491,679,469,188,0.99334544
25,2,car,721,1189,491,679,468,188,0.9922223
26,2,car,721,1192,491,679,471,188,0.99353355
27,2,car,721,1190,491,680,469,189,0.9941834
28,2,car,721,1192,490,680,471,190,0.9927697
29,2,car,723,1187,491,680,464,189,0.9929273
30,2,car,720,1192,491,680,472,189,0.9943153
31,2,car,721,1190,490,680,469,190,0.9937749
32,2,car,721,1189,491,680,468,189,0.9938193
33,2,car,721,1193,490,681,472,191,0.9946054
34,2,car,721,1190,490,681,469,191,0.99308574
35,2,car,721,1191,490,680,470,190,0.99485815
36,2,car,719,1191,490,680,472,190,0.99378115
37,2,car,719,1192,490,681,473,191,0.994926
38,2,car,722,1192,490,680,470,190,0.9945114
39,2,car,722,1190,490,680,468,190,0.99356544
40,2,car,718,1192,490,680,474,190,0.99396724
41,2,car,720,1192,491,680,472,189,0.99402833
42,2,car,720,1188,490,681,468,191,0.9936452
43,2,car,722,1188,490,681,466,191,0.9941867
44,2,car,722,1189,490,681,467,191,0.99316216
45,2,car,721,1191,490,681,470,191,0.9934978
46,2,car,722,1192,491,679,470,188,0.9947086
47,2,car,719,1191,490,680,472,190,0.99448395
48,2,car,721,1190,490,681,469,191,0.9950352
49,2,car,718,1192,491,680,474,189,0.9946807
50,2,car,720,1190,491,680,470,189,0.9939705
51,2,car,721,1189,490,680,468,190,0.99420947
52,2,car,721,1188,491,679,467,188,0.9941135
53,2,car,720,1190,491,680,470,189,0.99439865
54,2,car,721,1190,490,680,469,190,0.9935835
55,2,car,720,1190,490,680,470,190,0.99316007
56,2,car,720,1190,490,680,470,190,0.99366015
57,2,car,723,1188,491,680,465,189,0.9940172
58,2,car,723,1190,491,680,467,189,0.9925984
59,2,car,720,1189,491,679,469,188,0.99389535
60,2,car,720,1192,491,680,472,189,0.9947525
61,2,car,720,1189,490,681,469,191,0.99338204
62,2,car,723,1190,490,680,467,190,0.993658
63,2,car,722,1191,490,681,469,191,0.9944046
64,2,car,723,1189,491,680,466,189,0.9941147
65,2,car,592,912,482,651,320,169,0.9904916
66,2,car,593,912,482,651,319,169,0.99101853
67,2,car,591,911,482,650,320,168,0.99045604
0,2,car,724,1189,489,681,465,192,0.99227536
1,2,car,721,1191,490,681,470,191,0.99170077
2,2,car,722,1189,492,678,467,186,0.99312747
3,2,car,722,1189,490,680,467,190,0.9928037
4,2,car,722,1191,491,680,469,189,0.9921203
5,2,car,722,1189,490,681,467,191,0.9922209
6,2,car,721,1192,490,681,471,191,0.9930029
7,2,car,721,1191,491,680,470,189,0.99370116
8,2,car,721,1192,491,679,471,188,0.99167436
9,2,car,720,1191,489,681,471,192,0.99269456
10,2,car,721,1190,491,680,469,189,0.993381
11,2,car,718,1190,490,681,472,191,0.99364763
12,2,car,722,1193,490,680,471,190,0.99402285
13,2,car,719,1192,490,680,473,190,0.99388003
14,2,car,723,1192,490,680,469,190,0.992976
15,2,car,721,1190,491,680,469,189,0.99315363
16,2,car,721,1190,491,680,469,189,0.9950945
17,2,car,719,1191,490,681,472,191,0.99357724
18,2,car,723,1191,491,680,468,189,0.99360245
19,2,car,721,1190,491,680,469,189,0.99408567
20,2,car,722,1191,490,680,469,190,0.99388546
21,2,car,719,1189,490,681,470,191,0.9933415
22,2,car,721,1189,490,681,468,191,0.99309224
23,2,car,720,1189,490,680,469,190,0.9933535
24,2,car,721,1189,490,680,468,190,0.99278355
25,2,car,722,1191,491,679,469,188,0.99334544
26,2,car,721,1189,491,679,468,188,0.9922223
27,2,car,721,1192,491,679,471,188,0.99353355
28,2,car,721,1190,491,680,469,189,0.9941834
29,2,car,721,1192,490,680,471,190,0.9927697
30,2,car,723,1187,491,680,464,189,0.9929273
31,2,car,720,1192,491,680,472,189,0.9943153
32,2,car,721,1190,490,680,469,190,0.9937749
33,2,car,721,1189,491,680,468,189,0.9938193
34,2,car,721,1193,490,681,472,191,0.9946054
35,2,car,721,1190,490,681,469,191,0.99308574
36,2,car,721,1191,490,680,470,190,0.99485815
37,2,car,719,1191,490,680,472,190,0.99378115
38,2,car,719,1192,490,681,473,191,0.994926
39,2,car,722,1192,490,680,470,190,0.9945114
40,2,car,722,1190,490,680,468,190,0.99356544
41,2,car,718,1192,490,680,474,190,0.99396724
42,2,car,720,1192,491,680,472,189,0.99402833
43,2,car,720,1188,490,681,468,191,0.9936452
44,2,car,722,1188,490,681,466,191,0.9941867
45,2,car,722,1189,490,681,467,191,0.99316216
46,2,car,721,1191,490,681,470,191,0.9934978
47,2,car,722,1192,491,679,470,188,0.9947086
48,2,car,719,1191,490,680,472,190,0.99448395
49,2,car,721,1190,490,681,469,191,0.9950352
50,2,car,718,1192,491,680,474,189,0.9946807
51,2,car,720,1190,491,680,470,189,0.9939705
52,2,car,721,1189,490,680,468,190,0.99420947
53,2,car,721,1188,491,679,467,188,0.9941135
54,2,car,720,1190,491,680,470,189,0.99439865
55,2,car,721,1190,490,680,469,190,0.9935835
56,2,car,720,1190,490,680,470,190,0.99316007
57,2,car,720,1190,490,680,470,190,0.99366015
58,2,car,723,1188,491,680,465,189,0.9940172
59,2,car,723,1190,491,680,467,189,0.9925984
60,2,car,720,1189,491,679,469,188,0.99389535
61,2,car,720,1192,491,680,472,189,0.9947525
62,2,car,720,1189,490,681,469,191,0.99338204
63,2,car,723,1190,490,680,467,190,0.993658
64,2,car,722,1191,490,681,469,191,0.9944046
65,2,car,723,1189,491,680,466,189,0.9941147
66,2,car,592,912,482,651,320,169,0.9904916
67,2,car,593,912,482,651,319,169,0.99101853
68,2,car,591,911,482,650,320,168,0.99045604
0,2,car,721,1191,490,680,470,190,0.9937846
1,2,car,724,1189,489,681,465,192,0.99227536
2,2,car,721,1191,490,681,470,191,0.99170077
3,2,car,722,1189,492,678,467,186,0.99312747
4,2,car,722,1189,490,680,467,190,0.9928037
5,2,car,722,1191,491,680,469,189,0.9921203
6,2,car,722,1189,490,681,467,191,0.9922209
7,2,car,721,1192,490,681,471,191,0.9930029
8,2,car,721,1191,491,680,470,189,0.99370116
9,2,car,721,1192,491,679,471,188,0.99167436
10,2,car,720,1191,489,681,471,192,0.99269456
11,2,car,721,1190,491,680,469,189,0.993381
12,2,car,718,1190,490,681,472,191,0.99364763
13,2,car,722,1193,490,680,471,190,0.99402285
14,2,car,719,1192,490,680,473,190,0.99388003
15,2,car,723,1192,490,680,469,190,0.992976
16,2,car,721,1190,491,680,469,189,0.99315363
17,2,car,721,1190,491,680,469,189,0.9950945
18,2,car,719,1191,490,681,472,191,0.99357724
19,2,car,723,1191,491,680,468,189,0.99360245
20,2,car,721,1190,491,680,469,189,0.99408567
21,2,car,722,1191,490,680,469,190,0.99388546
22,2,car,719,1189,490,681,470,191,0.9933415
23,2,car,721,1189,490,681,468,191,0.99309224
24,2,car,720,1189,490,680,469,190,0.9933535
25,2,car,721,1189,490,680,468,190,0.99278355
26,2,car,722,1191,491,679,469,188,0.99334544
27,2,car,721,1189,491,679,468,188,0.9922223
28,2,car,721,1192,491,679,471,188,0.99353355
29,2,car,721,1190,491,680,469,189,0.9941834
30,2,car,721,1192,490,680,471,190,0.9927697
31,2,car,723,1187,491,680,464,189,0.9929273
32,2,car,720,1192,491,680,472,189,0.9943153
33,2,car,721,1190,490,680,469,190,0.9937749
34,2,car,721,1189,491,680,468,189,0.9938193
35,2,car,721,1193,490,681,472,191,0.9946054
36,2,car,721,1190,490,681,469,191,0.99308574
37,2,car,721,1191,490,680,470,190,0.99485815
38,2,car,719,1191,490,680,472,190,0.99378115
39,2,car,719,1192,490,681,473,191,0.994926
40,2,car,722,1192,490,680,470,190,0.9945114
41,2,car,722,1190,490,680,468,190,0.99356544
42,2,car,718,1192,490,680,474,190,0.99396724
43,2,car,720,1192,491,680,472,189,0.99402833
44,2,car,720,1188,490,681,468,191,0.9936452
45,2,car,722,1188,490,681,466,191,0.9941867
46,2,car,722,1189,490,681,467,191,0.99316216
47,2,car,721,1191,490,681,470,191,0.9934978
48,2,car,722,1192,491,679,470,188,0.9947086
49,2,car,719,1191,490,680,472,190,0.99448395
50,2,car,721,1190,490,681,469,191,0.9950352
51,2,car,718,1192,491,680,474,189,0.9946807
52,2,car,720,1190,491,680,470,189,0.9939705
53,2,car,721,1189,490,680,468,190,0.99420947
54,2,car,721,1188,491,679,467,188,0.9941135
55,2,car,720,1190,491,680,470,189,0.99439865
56,2,car,721,1190,490,680,469,190,0.9935835
57,2,car,720,1190,490,680,470,190,0.99316007
58,2,car,720,1190,490,680,470,190,0.99366015
59,2,car,723,1188,491,680,465,189,0.9940172
60,2,car,723,1190,491,680,467,189,0.9925984
61,2,car,720,1189,491,679,469,188,0.99389535
62,2,car,720,1192,491,680,472,189,0.9947525
63,2,car,720,1189,490,681,469,191,0.99338204
64,2,car,723,1190,490,680,467,190,0.993658
65,2,car,722,1191,490,681,469,191,0.9944046
66,2,car,723,1189,491,680,466,189,0.9941147
67,2,car,592,912,482,651,320,169,0.9904916
68,2,car,593,912,482,651,319,169,0.99101853
69,2,car,591,911,482,650,320,168,0.99045604
0,2,car,724,1188,491,679,464,188,0.9937347
1,2,car,721,1191,490,680,470,190,0.9937846
2,2,car,724,1189,489,681,465,192,0.99227536
3,2,car,721,1191,490,681,470,191,0.99170077
4,2,car,722,1189,492,678,467,186,0.99312747
5,2,car,722,1189,490,680,467,190,0.9928037
6,2,car,722,1191,491,680,469,189,0.9921203
7,2,car,722,1189,490,681,467,191,0.9922209
8,2,car,721,1192,490,681,471,191,0.9930029
9,2,car,721,1191,491,680,470,189,0.99370116
10,2,car,721,1192,491,679,471,188,0.99167436
11,2,car,720,1191,489,681,471,192,0.99269456
12,2,car,721,1190,491,680,469,189,0.993381
13,2,car,718,1190,490,681,472,191,0.99364763
14,2,car,722,1193,490,680,471,190,0.99402285
15,2,car,719,1192,490,680,473,190,0.99388003
16,2,car,723,1192,490,680,469,190,0.992976
17,2,car,721,1190,491,680,469,189,0.99315363
18,2,car,721,1190,491,680,469,189,0.9950945
19,2,car,719,1191,490,681,472,191,0.99357724
20,2,car,723,1191,491,680,468,189,0.99360245
21,2,car,721,1190,491,680,469,189,0.99408567
22,2,car,722,1191,490,680,469,190,0.99388546
23,2,car,719,1189,490,681,470,191,0.9933415
24,2,car,721,1189,490,681,468,191,0.99309224
25,2,car,720,1189,490,680,469,190,0.9933535
26,2,car,721,1189,490,680,468,190,0.99278355
27,2,car,722,1191,491,679,469,188,0.99334544
28,2,car,721,1189,491,679,468,188,0.9922223
29,2,car,721,1192,491,679,471,188,0.99353355
30,2,car,721,1190,491,680,469,189,0.9941834
31,2,car,721,1192,490,680,471,190,0.9927697
32,2,car,723,1187,491,680,464,189,0.9929273
33,2,car,720,1192,491,680,472,189,0.9943153
34,2,car,721,1190,490,680,469,190,0.9937749
35,2,car,721,1189,491,680,468,189,0.9938193
36,2,car,721,1193,490,681,472,191,0.9946054
37,2,car,721,1190,490,681,469,191,0.99308574
38,2,car,721,1191,490,680,470,190,0.99485815
39,2,car,719,1191,490,680,472,190,0.99378115
40,2,car,719,1192,490,681,473,191,0.994926
41,2,car,722,1192,490,680,470,190,0.9945114
42,2,car,722,1190,490,680,468,190,0.99356544
43,2,car,718,1192,490,680,474,190,0.99396724
44,2,car,720,1192,491,680,472,189,0.99402833
45,2,car,720,1188,490,681,468,191,0.9936452
46,2,car,722,1188,490,681,466,191,0.9941867
47,2,car,722,1189,490,681,467,191,0.99316216
48,2,car,721,1191,490,681,470,191,0.9934978
49,2,car,722,1192,491,679,470,188,0.9947086
50,2,car,719,1191,490,680,472,190,0.99448395
51,2,car,721,1190,490,681,469,191,0.9950352
52,2,car,718,1192,491,680,474,189,0.9946807
53,2,car,720,1190,491,680,470,189,0.9939705
54,2,car,721,1189,490,680,468,190,0.99420947
55,2,car,721,1188,491,679,467,188,0.9941135
56,2,car,720,1190,491,680,470,189,0.99439865
57,2,car,721,1190,490,680,469,190,0.9935835
58,2,car,720,1190,490,680,470,190,0.99316007
59,2,car,720,1190,490,680,470,190,0.99366015
60,2,car,723,1188,491,680,465,189,0.9940172
61,2,car,723,1190,491,680,467,189,0.9925984
62,2,car,720,1189,491,679,469,188,0.99389535
63,2,car,720,1192,491,680,472,189,0.9947525
64,2,car,720,1189,490,681,469,191,0.99338204
65,2,car,723,1190,490,680,467,190,0.993658
66,2,car,722,1191,490,681,469,191,0.9944046
67,2,car,723,1189,491,680,466,189,0.9941147
68,2,car,592,912,482,651,320,169,0.9904916
69,2,car,593,912,482,651,319,169,0.99101853
70,2,car,591,911,482,650,320,168,0.99045604
0,2,car,719,1192,491,680,473,189,0.99213934
1,2,car,724,1188,491,679,464,188,0.9937347
2,2,car,721,1191,490,680,470,190,0.9937846
3,2,car,724,1189,489,681,465,192,0.99227536
4,2,car,721,1191,490,681,470,191,0.99170077
5,2,car,722,1189,492,678,467,186,0.99312747
6,2,car,722,1189,490,680,467,190,0.9928037
7,2,car,722,1191,491,680,469,189,0.9921203
8,2,car,722,1189,490,681,467,191,0.9922209
9,2,car,721,1192,490,681,471,191,0.9930029
10,2,car,721,1191,491,680,470,189,0.99370116
11,2,car,721,1192,491,679,471,188,0.99167436
12,2,car,720,1191,489,681,471,192,0.99269456
13,2,car,721,1190,491,680,469,189,0.993381
14,2,car,718,1190,490,681,472,191,0.99364763
15,2,car,722,1193,490,680,471,190,0.99402285
16,2,car,719,1192,490,680,473,190,0.99388003
17,2,car,723,1192,490,680,469,190,0.992976
18,2,car,721,1190,491,680,469,189,0.99315363
19,2,car,721,1190,491,680,469,189,0.9950945
20,2,car,719,1191,490,681,472,191,0.99357724
21,2,car,723,1191,491,680,468,189,0.99360245
22,2,car,721,1190,491,680,469,189,0.99408567
23,2,car,722,1191,490,680,469,190,0.99388546
24,2,car,719,1189,490,681,470,191,0.9933415
25,2,car,721,1189,490,681,468,191,0.99309224
26,2,car,720,1189,490,680,469,190,0.9933535
27,2,car,721,1189,490,680,468,190,0.99278355
28,2,car,722,1191,491,679,469,188,0.99334544
29,2,car,721,1189,491,679,468,188,0.9922223
30,2,car,721,1192,491,679,471,188,0.99353355
31,2,car,721,1190,491,680,469,189,0.9941834
32,2,car,721,1192,490,680,471,190,0.9927697
33,2,car,723,1187,491,680,464,189,0.9929273
34,2,car,720,1192,491,680,472,189,0.9943153
35,2,car,721,1190,490,680,469,190,0.9937749
36,2,car,721,1189,491,680,468,189,0.9938193
37,2,car,721,1193,490,681,472,191,0.9946054
38,2,car,721,1190,490,681,469,191,0.99308574
39,2,car,721,1191,490,680,470,190,0.99485815
40,2,car,719,1191,490,680,472,190,0.99378115
41,2,car,719,1192,490,681,473,191,0.994926
42,2,car,722,1192,490,680,470,190,0.9945114
43,2,car,722,1190,490,680,468,190,0.99356544
44,2,car,718,1192,490,680,474,190,0.99396724
45,2,car,720,1192,491,680,472,189,0.99402833
46,2,car,720,1188,490,681,468,191,0.9936452
47,2,car,722,1188,490,681,466,191,0.9941867
48,2,car,722,1189,490,681,467,191,0.99316216
49,2,car,721,1191,490,681,470,191,0.9934978
50,2,car,722,1192,491,679,470,188,0.9947086
51,2,car,719,1191,490,680,472,190,0.99448395
52,2,car,721,1190,490,681,469,191,0.9950352
53,2,car,718,1192,491,680,474,189,0.9946807
54,2,car,720,1190,491,680,470,189,0.9939705
55,2,car,721,1189,490,680,468,190,0.99420947
56,2,car,721,1188,491,679,467,188,0.9941135
57,2,car,720,1190,491,680,470,189,0.99439865
58,2,car,721,1190,490,680,469,190,0.9935835
59,2,car,720,1190,490,680,470,190,0.99316007
60,2,car,720,1190,490,680,470,190,0.99366015
61,2,car,723,1188,491,680,465,189,0.9940172
62,2,car,723,1190,491,680,467,189,0.9925984
63,2,car,720,1189,491,679,469,188,0.99389535
64,2,car,720,1192,491,680,472,189,0.9947525
65,2,car,720,1189,490,681,469,191,0.99338204
66,2,car,723,1190,490,680,467,190,0.993658
67,2,car,722,1191,490,681,469,191,0.9944046
68,2,car,723,1189,491,680,466,189,0.9941147
69,2,car,592,912,482,651,320,169,0.9904916
70,2,car,593,912,482,651,319,169,0.99101853
71,2,car,591,911,482,650,320,168,0.99045604
0,2,car,720,1189,492,678,469,186,0.99275035
1,2,car,719,1192,491,680,473,189,0.99213934
2,2,car,724,1188,491,679,464,188,0.9937347
3,2,car,721,1191,490,680,470,190,0.9937846
4,2,car,724,1189,489,681,465,192,0.99227536
5,2,car,721,1191,490,681,470,191,0.99170077
6,2,car,722,1189,492,678,467,186,0.99312747
7,2,car,722,1189,490,680,467,190,0.9928037
8,2,car,722,1191,491,680,469,189,0.9921203
9,2,car,722,1189,490,681,467,191,0.9922209
10,2,car,721,1192,490,681,471,191,0.9930029
11,2,car,721,1191,491,680,470,189,0.99370116
12,2,car,721,1192,491,679,471,188,0.99167436
13,2,car,720,1191,489,681,471,192,0.99269456
14,2,car,721,1190,491,680,469,189,0.993381
15,2,car,718,1190,490,681,472,191,0.99364763
16,2,car,722,1193,490,680,471,190,0.99402285
17,2,car,719,1192,490,680,473,190,0.99388003
18,2,car,723,1192,490,680,469,190,0.992976
19,2,car,721,1190,491,680,469,189,0.99315363
20,2,car,721,1190,491,680,469,189,0.9950945
21,2,car,719,1191,490,681,472,191,0.99357724
22,2,car,723,1191,491,680,468,189,0.99360245
23,2,car,721,1190,491,680,469,189,0.99408567
24,2,car,722,1191,490,680,469,190,0.99388546
25,2,car,719,1189,490,681,470,191,0.9933415
26,2,car,721,1189,490,681,468,191,0.99309224
27,2,car,720,1189,490,680,469,190,0.9933535
28,2,car,721,1189,490,680,468,190,0.99278355
29,2,car,722,1191,491,679,469,188,0.99334544
30,2,car,721,1189,491,679,468,188,0.9922223
31,2,car,721,1192,491,679,471,188,0.99353355
32,2,car,721,1190,491,680,469,189,0.9941834
33,2,car,721,1192,490,680,471,190,0.9927697
34,2,car,723,1187,491,680,464,189,0.9929273
35,2,car,720,1192,491,680,472,189,0.9943153
36,2,car,721,1190,490,680,469,190,0.9937749
37,2,car,721,1189,491,680,468,189,0.9938193
38,2,car,721,1193,490,681,472,191,0.9946054
39,2,car,721,1190,490,681,469,191,0.99308574
40,2,car,721,1191,490,680,470,190,0.99485815
41,2,car,719,1191,490,680,472,190,0.99378115
42,2,car,719,1192,490,681,473,191,0.994926
43,2,car,722,1192,490,680,470,190,0.9945114
44,2,car,722,1190,490,680,468,190,0.99356544
45,2,car,718,1192,490,680,474,190,0.99396724
46,2,car,720,1192,491,680,472,189,0.99402833
47,2,car,720,1188,490,681,468,191,0.9936452
48,2,car,722,1188,490,681,466,191,0.9941867
49,2,car,722,1189,490,681,467,191,0.99316216
50,2,car,721,1191,490,681,470,191,0.9934978
51,2,car,722,1192,491,679,470,188,0.9947086
52,2,car,719,1191,490,680,472,190,0.99448395
53,2,car,721,1190,490,681,469,191,0.9950352
54,2,car,718,1192,491,680,474,189,0.9946807
55,2,car,720,1190,491,680,470,189,0.9939705
56,2,car,721,1189,490,680,468,190,0.99420947
57,2,car,721,1188,491,679,467,188,0.9941135
58,2,car,720,1190,491,680,470,189,0.99439865
59,2,car,721,1190,490,680,469,190,0.9935835
60,2,car,720,1190,490,680,470,190,0.99316007
61,2,car,720,1190,490,680,470,190,0.99366015
62,2,car,723,1188,491,680,465,189,0.9940172
63,2,car,723,1190,491,680,467,189,0.9925984
64,2,car,720,1189,491,679,469,188,0.99389535
65,2,car,720,1192,491,680,472,189,0.9947525
66,2,car,720,1189,490,681,469,191,0.99338204
67,2,car,723,1190,490,680,467,190,0.993658
68,2,car,722,1191,490,681,469,191,0.9944046
69,2,car,723,1189,491,680,466,189,0.9941147
70,2,car,592,912,482,651,320,169,0.9904916
71,2,car,593,912,482,651,319,169,0.99101853
72,2,car,591,911,482,650,320,168,0.99045604
0,2,car,719,1191,491,680,472,189,0.99077785
1,2,car,720,1189,492,678,469,186,0.99275035
2,2,car,719,1192,491,680,473,189,0.99213934
3,2,car,724,1188,491,679,464,188,0.9937347
4,2,car,721,1191,490,680,470,190,0.9937846
5,2,car,724,1189,489,681,465,192,0.99227536
6,2,car,721,1191,490,681,470,191,0.99170077
7,2,car,722,1189,492,678,467,186,0.99312747
8,2,car,722,1189,490,680,467,190,0.9928037
9,2,car,722,1191,491,680,469,189,0.9921203
10,2,car,722,1189,490,681,467,191,0.9922209
11,2,car,721,1192,490,681,471,191,0.9930029
12,2,car,721,1191,491,680,470,189,0.99370116
13,2,car,721,1192,491,679,471,188,0.99167436
14,2,car,720,1191,489,681,471,192,0.99269456
15,2,car,721,1190,491,680,469,189,0.993381
16,2,car,718,1190,490,681,472,191,0.99364763
17,2,car,722,1193,490,680,471,190,0.99402285
18,2,car,719,1192,490,680,473,190,0.99388003
19,2,car,723,1192,490,680,469,190,0.992976
20,2,car,721,1190,491,680,469,189,0.99315363
21,2,car,721,1190,491,680,469,189,0.9950945
22,2,car,719,1191,490,681,472,191,0.99357724
23,2,car,723,1191,491,680,468,189,0.99360245
24,2,car,721,1190,491,680,469,189,0.99408567
25,2,car,722,1191,490,680,469,190,0.99388546
26,2,car,719,1189,490,681,470,191,0.9933415
27,2,car,721,1189,490,681,468,191,0.99309224
28,2,car,720,1189,490,680,469,190,0.9933535
29,2,car,721,1189,490,680,468,190,0.99278355
30,2,car,722,1191,491,679,469,188,0.99334544
31,2,car,721,1189,491,679,468,188,0.9922223
32,2,car,721,1192,491,679,471,188,0.99353355
33,2,car,721,1190,491,680,469,189,0.9941834
34,2,car,721,1192,490,680,471,190,0.9927697
35,2,car,723,1187,491,680,464,189,0.9929273
36,2,car,720,1192,491,680,472,189,0.9943153
37,2,car,721,1190,490,680,469,190,0.9937749
38,2,car,721,1189,491,680,468,189,0.9938193
39,2,car,721,1193,490,681,472,191,0.9946054
40,2,car,721,1190,490,681,469,191,0.99308574
41,2,car,721,1191,490,680,470,190,0.99485815
42,2,car,719,1191,490,680,472,190,0.99378115
43,2,car,719,1192,490,681,473,191,0.994926
44,2,car,722,1192,490,680,470,190,0.9945114
45,2,car,722,1190,490,680,468,190,0.99356544
46,2,car,718,1192,490,680,474,190,0.99396724
47,2,car,720,1192,491,680,472,189,0.99402833
48,2,car,720,1188,490,681,468,191,0.9936452
49,2,car,722,1188,490,681,466,191,0.9941867
50,2,car,722,1189,490,681,467,191,0.99316216
51,2,car,721,1191,490,681,470,191,0.9934978
52,2,car,722,1192,491,679,470,188,0.9947086
53,2,car,719,1191,490,680,472,190,0.99448395
54,2,car,721,1190,490,681,469,191,0.9950352
55,2,car,718,1192,491,680,474,189,0.9946807
56,2,car,720,1190,491,680,470,189,0.9939705
57,2,car,721,1189,490,680,468,190,0.99420947
58,2,car,721,1188,491,679,467,188,0.9941135
59,2,car,720,1190,491,680,470,189,0.99439865
60,2,car,721,1190,490,680,469,190,0.9935835
61,2,car,720,1190,490,680,470,190,0.99316007
62,2,car,720,1190,490,680,470,190,0.99366015
63,2,car,723,1188,491,680,465,189,0.9940172
64,2,car,723,1190,491,680,467,189,0.9925984
65,2,car,720,1189,491,679,469,188,0.99389535
66,2,car,720,1192,491,680,472,189,0.9947525
67,2,car,720,1189,490,681,469,191,0.99338204
68,2,car,723,1190,490,680,467,190,0.993658
69,2,car,722,1191,490,681,469,191,0.9944046
70,2,car,723,1189,491,680,466,189,0.9941147
71,2,car,592,912,482,651,320,169,0.9904916
72,2,car,593,912,482,651,319,169,0.99101853
73,2,car,591,911,482,650,320,168,0.99045604
0,2,car,722,1189,492,679,467,187,0.9933555
1,2,car,719,1191,491,680,472,189,0.99077785
2,2,car,720,1189,492,678,469,186,0.99275035
3,2,car,719,1192,491,680,473,189,0.99213934
4,2,car,724,1188,491,679,464,188,0.9937347
5,2,car,721,1191,490,680,470,190,0.9937846
6,2,car,724,1189,489,681,465,192,0.99227536
7,2,car,721,1191,490,681,470,191,0.99170077
8,2,car,722,1189,492,678,467,186,0.99312747
9,2,car,722,1189,490,680,467,190,0.9928037
10,2,car,722,1191,491,680,469,189,0.9921203
11,2,car,722,1189,490,681,467,191,0.9922209
12,2,car,721,1192,490,681,471,191,0.9930029
13,2,car,721,1191,491,680,470,189,0.99370116
14,2,car,721,1192,491,679,471,188,0.99167436
15,2,car,720,1191,489,681,471,192,0.99269456
16,2,car,721,1190,491,680,469,189,0.993381
17,2,car,718,1190,490,681,472,191,0.99364763
18,2,car,722,1193,490,680,471,190,0.99402285
19,2,car,719,1192,490,680,473,190,0.99388003
20,2,car,723,1192,490,680,469,190,0.992976
21,2,car,721,1190,491,680,469,189,0.99315363
22,2,car,721,1190,491,680,469,189,0.9950945
23,2,car,719,1191,490,681,472,191,0.99357724
24,2,car,723,1191,491,680,468,189,0.99360245
25,2,car,721,1190,491,680,469,189,0.99408567
26,2,car,722,1191,490,680,469,190,0.99388546
27,2,car,719,1189,490,681,470,191,0.9933415
28,2,car,721,1189,490,681,468,191,0.99309224
29,2,car,720,1189,490,680,469,190,0.9933535
30,2,car,721,1189,490,680,468,190,0.99278355
31,2,car,722,1191,491,679,469,188,0.99334544
32,2,car,721,1189,491,679,468,188,0.9922223
33,2,car,721,1192,491,679,471,188,0.99353355
34,2,car,721,1190,491,680,469,189,0.9941834
35,2,car,721,1192,490,680,471,190,0.9927697
36,2,car,723,1187,491,680,464,189,0.9929273
37,2,car,720,1192,491,680,472,189,0.9943153
38,2,car,721,1190,490,680,469,190,0.9937749
39,2,car,721,1189,491,680,468,189,0.9938193
40,2,car,721,1193,490,681,472,191,0.9946054
41,2,car,721,1190,490,681,469,191,0.99308574
42,2,car,721,1191,490,680,470,190,0.99485815
43,2,car,719,1191,490,680,472,190,0.99378115
44,2,car,719,1192,490,681,473,191,0.994926
45,2,car,722,1192,490,680,470,190,0.9945114
46,2,car,722,1190,490,680,468,190,0.99356544
47,2,car,718,1192,490,680,474,190,0.99396724
48,2,car,720,1192,491,680,472,189,0.99402833
49,2,car,720,1188,490,681,468,191,0.9936452
50,2,car,722,1188,490,681,466,191,0.9941867
51,2,car,722,1189,490,681,467,191,0.99316216
52,2,car,721,1191,490,681,470,191,0.9934978
53,2,car,722,1192,491,679,470,188,0.9947086
54,2,car,719,1191,490,680,472,190,0.99448395
55,2,car,721,1190,490,681,469,191,0.9950352
56,2,car,718,1192,491,680,474,189,0.9946807
57,2,car,720,1190,491,680,470,189,0.9939705
58,2,car,721,1189,490,680,468,190,0.99420947
59,2,car,721,1188,491,679,467,188,0.9941135
60,2,car,720,1190,491,680,470,189,0.99439865
61,2,car,721,1190,490,680,469,190,0.9935835
62,2,car,720,1190,490,680,470,190,0.99316007
63,2,car,720,1190,490,680,470,190,0.99366015
64,2,car,723,1188,491,680,465,189,0.9940172
65,2,car,723,1190,491,680,467,189,0.9925984
66,2,car,720,1189,491,679,469,188,0.99389535
67,2,car,720,1192,491,680,472,189,0.9947525
68,2,car,720,1189,490,681,469,191,0.99338204
69,2,car,723,1190,490,680,467,190,0.993658
70,2,car,722,1191,490,681,469,191,0.9944046
71,2,car,723,1189,491,680,466,189,0.9941147
72,2,car,592,912,482,651,320,169,0.9904916
73,2,car,593,912,482,651,319,169,0.99101853
74,2,car,591,911,482,650,320,168,0.99045604
0,2,car,722,1190,491,680,468,189,0.9946975
1,2,car,722,1189,492,679,467,187,0.9933555
2,2,car,719,1191,491,680,472,189,0.99077785
3,2,car,720,1189,492,678,469,186,0.99275035
4,2,car,719,1192,491,680,473,189,0.99213934
5,2,car,724,1188,491,679,464,188,0.9937347
6,2,car,721,1191,490,680,470,190,0.9937846
7,2,car,724,1189,489,681,465,192,0.99227536
8,2,car,721,1191,490,681,470,191,0.99170077
9,2,car,722,1189,492,678,467,186,0.99312747
10,2,car,722,1189,490,680,467,190,0.9928037
11,2,car,722,1191,491,680,469,189,0.9921203
12,2,car,722,1189,490,681,467,191,0.9922209
13,2,car,721,1192,490,681,471,191,0.9930029
14,2,car,721,1191,491,680,470,189,0.99370116
15,2,car,721,1192,491,679,471,188,0.99167436
16,2,car,720,1191,489,681,471,192,0.99269456
17,2,car,721,1190,491,680,469,189,0.993381
18,2,car,718,1190,490,681,472,191,0.99364763
19,2,car,722,1193,490,680,471,190,0.99402285
20,2,car,719,1192,490,680,473,190,0.99388003
21,2,car,723,1192,490,680,469,190,0.992976
22,2,car,721,1190,491,680,469,189,0.99315363
23,2,car,721,1190,491,680,469,189,0.9950945
24,2,car,719,1191,490,681,472,191,0.99357724
25,2,car,723,1191,491,680,468,189,0.99360245
26,2,car,721,1190,491,680,469,189,0.99408567
27,2,car,722,1191,490,680,469,190,0.99388546
28,2,car,719,1189,490,681,470,191,0.9933415
29,2,car,721,1189,490,681,468,191,0.99309224
30,2,car,720,1189,490,680,469,190,0.9933535
31,2,car,721,1189,490,680,468,190,0.99278355
32,2,car,722,1191,491,679,469,188,0.99334544
33,2,car,721,1189,491,679,468,188,0.9922223
34,2,car,721,1192,491,679,471,188,0.99353355
35,2,car,721,1190,491,680,469,189,0.9941834
36,2,car,721,1192,490,680,471,190,0.9927697
37,2,car,723,1187,491,680,464,189,0.9929273
38,2,car,720,1192,491,680,472,189,0.9943153
39,2,car,721,1190,490,680,469,190,0.9937749
40,2,car,721,1189,491,680,468,189,0.9938193
41,2,car,721,1193,490,681,472,191,0.9946054
42,2,car,721,1190,490,681,469,191,0.99308574
43,2,car,721,1191,490,680,470,190,0.99485815
44,2,car,719,1191,490,680,472,190,0.99378115
45,2,car,719,1192,490,681,473,191,0.994926
46,2,car,722,1192,490,680,470,190,0.9945114
47,2,car,722,1190,490,680,468,190,0.99356544
48,2,car,718,1192,490,680,474,190,0.99396724
49,2,car,720,1192,491,680,472,189,0.99402833
50,2,car,720,1188,490,681,468,191,0.9936452
51,2,car,722,1188,490,681,466,191,0.9941867
52,2,car,722,1189,490,681,467,191,0.99316216
53,2,car,721,1191,490,681,470,191,0.9934978
54,2,car,722,1192,491,679,470,188,0.9947086
55,2,car,719,1191,490,680,472,190,0.99448395
56,2,car,721,1190,490,681,469,191,0.9950352
57,2,car,718,1192,491,680,474,189,0.9946807
58,2,car,720,1190,491,680,470,189,0.9939705
59,2,car,721,1189,490,680,468,190,0.99420947
60,2,car,721,1188,491,679,467,188,0.9941135
61,2,car,720,1190,491,680,470,189,0.99439865
62,2,car,721,1190,490,680,469,190,0.9935835
63,2,car,720,1190,490,680,470,190,0.99316007
64,2,car,720,1190,490,680,470,190,0.99366015
65,2,car,723,1188,491,680,465,189,0.9940172
66,2,car,723,1190,491,680,467,189,0.9925984
67,2,car,720,1189,491,679,469,188,0.99389535
68,2,car,720,1192,491,680,472,189,0.9947525
69,2,car,720,1189,490,681,469,191,0.99338204
70,2,car,723,1190,490,680,467,190,0.993658
71,2,car,722,1191,490,681,469,191,0.9944046
72,2,car,723,1189,491,680,466,189,0.9941147
73,2,car,592,912,482,651,320,169,0.9904916
74,2,car,593,912,482,651,319,169,0.99101853
75,2,car,591,911,482,650,320,168,0.99045604
0,2,car,720,1190,490,681,470,191,0.9942689
1,2,car,722,1190,491,680,468,189,0.9946975
2,2,car,722,1189,492,679,467,187,0.9933555
3,2,car,719,1191,491,680,472,189,0.99077785
4,2,car,720,1189,492,678,469,186,0.99275035
5,2,car,719,1192,491,680,473,189,0.99213934
6,2,car,724,1188,491,679,464,188,0.9937347
7,2,car,721,1191,490,680,470,190,0.9937846
8,2,car,724,1189,489,681,465,192,0.99227536
9,2,car,721,1191,490,681,470,191,0.99170077
10,2,car,722,1189,492,678,467,186,0.99312747
11,2,car,722,1189,490,680,467,190,0.9928037
12,2,car,722,1191,491,680,469,189,0.9921203
13,2,car,722,1189,490,681,467,191,0.9922209
14,2,car,721,1192,490,681,471,191,0.9930029
15,2,car,721,1191,491,680,470,189,0.99370116
16,2,car,721,1192,491,679,471,188,0.99167436
17,2,car,720,1191,489,681,471,192,0.99269456
18,2,car,721,1190,491,680,469,189,0.993381
19,2,car,718,1190,490,681,472,191,0.99364763
20,2,car,722,1193,490,680,471,190,0.99402285
21,2,car,719,1192,490,680,473,190,0.99388003
22,2,car,723,1192,490,680,469,190,0.992976
23,2,car,721,1190,491,680,469,189,0.99315363
24,2,car,721,1190,491,680,469,189,0.9950945
25,2,car,719,1191,490,681,472,191,0.99357724
26,2,car,723,1191,491,680,468,189,0.99360245
27,2,car,721,1190,491,680,469,189,0.99408567
28,2,car,722,1191,490,680,469,190,0.99388546
29,2,car,719,1189,490,681,470,191,0.9933415
30,2,car,721,1189,490,681,468,191,0.99309224
31,2,car,720,1189,490,680,469,190,0.9933535
32,2,car,721,1189,490,680,468,190,0.99278355
33,2,car,722,1191,491,679,469,188,0.99334544
34,2,car,721,1189,491,679,468,188,0.9922223
35,2,car,721,1192,491,679,471,188,0.99353355
36,2,car,721,1190,491,680,469,189,0.9941834
37,2,car,721,1192,490,680,471,190,0.9927697
38,2,car,723,1187,491,680,464,189,0.9929273
39,2,car,720,1192,491,680,472,189,0.9943153
40,2,car,721,1190,490,680,469,190,0.9937749
41,2,car,721,1189,491,680,468,189,0.9938193
42,2,car,721,1193,490,681,472,191,0.9946054
43,2,car,721,1190,490,681,469,191,0.99308574
44,2,car,721,1191,490,680,470,190,0.99485815
45,2,car,719,1191,490,680,472,190,0.99378115
46,2,car,719,1192,490,681,473,191,0.994926
47,2,car,722,1192,490,680,470,190,0.9945114
48,2,car,722,1190,490,680,468,190,0.99356544
49,2,car,718,1192,490,680,474,190,0.99396724
50,2,car,720,1192,491,680,472,189,0.99402833
51,2,car,720,1188,490,681,468,191,0.9936452
52,2,car,722,1188,490,681,466,191,0.9941867
53,2,car,722,1189,490,681,467,191,0.99316216
54,2,car,721,1191,490,681,470,191,0.9934978
55,2,car,722,1192,491,679,470,188,0.9947086
56,2,car,719,1191,490,680,472,190,0.99448395
57,2,car,721,1190,490,681,469,191,0.9950352
58,2,car,718,1192,491,680,474,189,0.9946807
59,2,car,720,1190,491,680,470,189,0.9939705
60,2,car,721,1189,490,680,468,190,0.99420947
61,2,car,721,1188,491,679,467,188,0.9941135
62,2,car,720,1190,491,680,470,189,0.99439865
63,2,car,721,1190,490,680,469,190,0.9935835
64,2,car,720,1190,490,680,470,190,0.99316007
65,2,car,720,1190,490,680,470,190,0.99366015
66,2,car,723,1188,491,680,465,189,0.9940172
67,2,car,723,1190,491,680,467,189,0.9925984
68,2,car,720,1189,491,679,469,188,0.99389535
69,2,car,720,1192,491,680,472,189,0.9947525
70,2,car,720,1189,490,681,469,191,0.99338204
71,2,car,723,1190,490,680,467,190,0.993658
72,2,car,722,1191,490,681,469,191,0.9944046
73,2,car,723,1189,491,680,466,189,0.9941147
74,2,car,592,912,482,651,320,169,0.9904916
75,2,car,593,912,482,651,319,169,0.99101853
76,2,car,591,911,482,650,320,168,0.99045604
0,2,car,721,1189,490,680,468,190,0.99229693
1,2,car,720,1190,490,681,470,191,0.9942689
2,2,car,722,1190,491,680,468,189,0.9946975
3,2,car,722,1189,492,679,467,187,0.9933555
4,2,car,719,1191,491,680,472,189,0.99077785
5,2,car,720,1189,492,678,469,186,0.99275035
6,2,car,719,1192,491,680,473,189,0.99213934
7,2,car,724,1188,491,679,464,188,0.9937347
8,2,car,721,1191,490,680,470,190,0.9937846
9,2,car,724,1189,489,681,465,192,0.99227536
10,2,car,721,1191,490,681,470,191,0.99170077
11,2,car,722,1189,492,678,467,186,0.99312747
12,2,car,722,1189,490,680,467,190,0.9928037
13,2,car,722,1191,491,680,469,189,0.9921203
14,2,car,722,1189,490,681,467,191,0.9922209
15,2,car,721,1192,490,681,471,191,0.9930029
16,2,car,721,1191,491,680,470,189,0.99370116
17,2,car,721,1192,491,679,471,188,0.99167436
18,2,car,720,1191,489,681,471,192,0.99269456
19,2,car,721,1190,491,680,469,189,0.993381
20,2,car,718,1190,490,681,472,191,0.99364763
21,2,car,722,1193,490,680,471,190,0.99402285
22,2,car,719,1192,490,680,473,190,0.99388003
23,2,car,723,1192,490,680,469,190,0.992976
24,2,car,721,1190,491,680,469,189,0.99315363
25,2,car,721,1190,491,680,469,189,0.9950945
26,2,car,719,1191,490,681,472,191,0.99357724
27,2,car,723,1191,491,680,468,189,0.99360245
28,2,car,721,1190,491,680,469,189,0.99408567
29,2,car,722,1191,490,680,469,190,0.99388546
30,2,car,719,1189,490,681,470,191,0.9933415
31,2,car,721,1189,490,681,468,191,0.99309224
32,2,car,720,1189,490,680,469,190,0.9933535
33,2,car,721,1189,490,680,468,190,0.99278355
34,2,car,722,1191,491,679,469,188,0.99334544
35,2,car,721,1189,491,679,468,188,0.9922223
36,2,car,721,1192,491,679,471,188,0.99353355
37,2,car,721,1190,491,680,469,189,0.9941834
38,2,car,721,1192,490,680,471,190,0.9927697
39,2,car,723,1187,491,680,464,189,0.9929273
40,2,car,720,1192,491,680,472,189,0.9943153
41,2,car,721,1190,490,680,469,190,0.9937749
42,2,car,721,1189,491,680,468,189,0.9938193
43,2,car,721,1193,490,681,472,191,0.9946054
44,2,car,721,1190,490,681,469,191,0.99308574
45,2,car,721,1191,490,680,470,190,0.99485815
46,2,car,719,1191,490,680,472,190,0.99378115
47,2,car,719,1192,490,681,473,191,0.994926
48,2,car,722,1192,490,680,470,190,0.9945114
49,2,car,722,1190,490,680,468,190,0.99356544
50,2,car,718,1192,490,680,474,190,0.99396724
51,2,car,720,1192,491,680,472,189,0.99402833
52,2,car,720,1188,490,681,468,191,0.9936452
53,2,car,722,1188,490,681,466,191,0.9941867
54,2,car,722,1189,490,681,467,191,0.99316216
55,2,car,721,1191,490,681,470,191,0.9934978
56,2,car,722,1192,491,679,470,188,0.9947086
57,2,car,719,1191,490,680,472,190,0.99448395
58,2,car,721,1190,490,681,469,191,0.9950352
59,2,car,718,1192,491,680,474,189,0.9946807
60,2,car,720,1190,491,680,470,189,0.9939705
61,2,car,721,1189,490,680,468,190,0.99420947
62,2,car,721,1188,491,679,467,188,0.9941135
63,2,car,720,1190,491,680,470,189,0.99439865
64,2,car,721,1190,490,680,469,190,0.9935835
65,2,car,720,1190,490,680,470,190,0.99316007
66,2,car,720,1190,490,680,470,190,0.99366015
67,2,car,723,1188,491,680,465,189,0.9940172
68,2,car,723,1190,491,680,467,189,0.9925984
69,2,car,720,1189,491,679,469,188,0.99389535
70,2,car,720,1192,491,680,472,189,0.9947525
71,2,car,720,1189,490,681,469,191,0.99338204
72,2,car,723,1190,490,680,467,190,0.993658
73,2,car,722,1191,490,681,469,191,0.9944046
74,2,car,723,1189,491,680,466,189,0.9941147
75,2,car,592,912,482,651,320,169,0.9904916
76,2,car,593,912,482,651,319,169,0.99101853
77,2,car,591,911,482,650,320,168,0.99045604
0,2,car,723,1190,492,679,467,187,0.99407345
1,2,car,721,1189,490,680,468,190,0.99229693
2,2,car,720,1190,490,681,470,191,0.9942689
3,2,car,722,1190,491,680,468,189,0.9946975
4,2,car,722,1189,492,679,467,187,0.9933555
5,2,car,719,1191,491,680,472,189,0.99077785
6,2,car,720,1189,492,678,469,186,0.99275035
7,2,car,719,1192,491,680,473,189,0.99213934
8,2,car,724,1188,491,679,464,188,0.9937347
9,2,car,721,1191,490,680,470,190,0.9937846
10,2,car,724,1189,489,681,465,192,0.99227536
11,2,car,721,1191,490,681,470,191,0.99170077
12,2,car,722,1189,492,678,467,186,0.99312747
13,2,car,722,1189,490,680,467,190,0.9928037
14,2,car,722,1191,491,680,469,189,0.9921203
15,2,car,722,1189,490,681,467,191,0.9922209
16,2,car,721,1192,490,681,471,191,0.9930029
17,2,car,721,1191,491,680,470,189,0.99370116
18,2,car,721,1192,491,679,471,188,0.99167436
19,2,car,720,1191,489,681,471,192,0.99269456
20,2,car,721,1190,491,680,469,189,0.993381
21,2,car,718,1190,490,681,472,191,0.99364763
22,2,car,722,1193,490,680,471,190,0.99402285
23,2,car,719,1192,490,680,473,190,0.99388003
24,2,car,723,1192,490,680,469,190,0.992976
25,2,car,721,1190,491,680,469,189,0.99315363
26,2,car,721,1190,491,680,469,189,0.9950945
27,2,car,719,1191,490,681,472,191,0.99357724
28,2,car,723,1191,491,680,468,189,0.99360245
29,2,car,721,1190,491,680,469,189,0.99408567
30,2,car,722,1191,490,680,469,190,0.99388546
31,2,car,719,1189,490,681,470,191,0.9933415
32,2,car,721,1189,490,681,468,191,0.99309224
33,2,car,720,1189,490,680,469,190,0.9933535
34,2,car,721,1189,490,680,468,190,0.99278355
35,2,car,722,1191,491,679,469,188,0.99334544
36,2,car,721,1189,491,679,468,188,0.9922223
37,2,car,721,1192,491,679,471,188,0.99353355
38,2,car,721,1190,491,680,469,189,0.9941834
39,2,car,721,1192,490,680,471,190,0.9927697
40,2,car,723,1187,491,680,464,189,0.9929273
41,2,car,720,1192,491,680,472,189,0.9943153
42,2,car,721,1190,490,680,469,190,0.9937749
43,2,car,721,1189,491,680,468,189,0.9938193
44,2,car,721,1193,490,681,472,191,0.9946054
45,2,car,721,1190,490,681,469,191,0.99308574
46,2,car,721,1191,490,680,470,190,0.99485815
47,2,car,719,1191,490,680,472,190,0.99378115
48,2,car,719,1192,490,681,473,191,0.994926
49,2,car,722,1192,490,680,470,190,0.9945114
50,2,car,722,1190,490,680,468,190,0.99356544
51,2,car,718,1192,490,680,474,190,0.99396724
52,2,car,720,1192,491,680,472,189,0.99402833
53,2,car,720,1188,490,681,468,191,0.9936452
54,2,car,722,1188,490,681,466,191,0.9941867
55,2,car,722,1189,490,681,467,191,0.99316216
56,2,car,721,1191,490,681,470,191,0.9934978
57,2,car,722,1192,491,679,470,188,0.9947086
58,2,car,719,1191,490,680,472,190,0.99448395
59,2,car,721,1190,490,681,469,191,0.9950352
60,2,car,718,1192,491,680,474,189,0.9946807
61,2,car,720,1190,491,680,470,189,0.9939705
62,2,car,721,1189,490,680,468,190,0.99420947
63,2,car,721,1188,491,679,467,188,0.9941135
64,2,car,720,1190,491,680,470,189,0.99439865
65,2,car,721,1190,490,680,469,190,0.9935835
66,2,car,720,1190,490,680,470,190,0.99316007
67,2,car,720,1190,490,680,470,190,0.99366015
68,2,car,723,1188,491,680,465,189,0.9940172
69,2,car,723,1190,491,680,467,189,0.9925984
70,2,car,720,1189,491,679,469,188,0.99389535
71,2,car,720,1192,491,680,472,189,0.9947525
72,2,car,720,1189,490,681,469,191,0.99338204
73,2,car,723,1190,490,680,467,190,0.993658
74,2,car,722,1191,490,681,469,191,0.9944046
75,2,car,723,1189,491,680,466,189,0.9941147
76,2,car,592,912,482,651,320,169,0.9904916
77,2,car,593,912,482,651,319,169,0.99101853
78,2,car,591,911,482,650,320,168,0.99045604
0,2,car,723,1190,490,680,467,190,0.9929821
1,2,car,723,1190,492,679,467,187,0.99407345
2,2,car,721,1189,490,680,468,190,0.99229693
3,2,car,720,1190,490,681,470,191,0.9942689
4,2,car,722,1190,491,680,468,189,0.9946975
5,2,car,722,1189,492,679,467,187,0.9933555
6,2,car,719,1191,491,680,472,189,0.99077785
7,2,car,720,1189,492,678,469,186,0.99275035
8,2,car,719,1192,491,680,473,189,0.99213934
9,2,car,724,1188,491,679,464,188,0.9937347
10,2,car,721,1191,490,680,470,190,0.9937846
11,2,car,724,1189,489,681,465,192,0.99227536
12,2,car,721,1191,490,681,470,191,0.99170077
13,2,car,722,1189,492,678,467,186,0.99312747
14,2,car,722,1189,490,680,467,190,0.9928037
15,2,car,722,1191,491,680,469,189,0.9921203
16,2,car,722,1189,490,681,467,191,0.9922209
17,2,car,721,1192,490,681,471,191,0.9930029
18,2,car,721,1191,491,680,470,189,0.99370116
19,2,car,721,1192,491,679,471,188,0.99167436
20,2,car,720,1191,489,681,471,192,0.99269456
21,2,car,721,1190,491,680,469,189,0.993381
22,2,car,718,1190,490,681,472,191,0.99364763
23,2,car,722,1193,490,680,471,190,0.99402285
24,2,car,719,1192,490,680,473,190,0.99388003
25,2,car,723,1192,490,680,469,190,0.992976
26,2,car,721,1190,491,680,469,189,0.99315363
27,2,car,721,1190,491,680,469,189,0.9950945
28,2,car,719,1191,490,681,472,191,0.99357724
29,2,car,723,1191,491,680,468,189,0.99360245
30,2,car,721,1190,491,680,469,189,0.99408567
31,2,car,722,1191,490,680,469,190,0.99388546
32,2,car,719,1189,490,681,470,191,0.9933415
33,2,car,721,1189,490,681,468,191,0.99309224
34,2,car,720,1189,490,680,469,190,0.9933535
35,2,car,721,1189,490,680,468,190,0.99278355
36,2,car,722,1191,491,679,469,188,0.99334544
37,2,car,721,1189,491,679,468,188,0.9922223
38,2,car,721,1192,491,679,471,188,0.99353355
39,2,car,721,1190,491,680,469,189,0.9941834
40,2,car,721,1192,490,680,471,190,0.9927697
41,2,car,723,1187,491,680,464,189,0.9929273
42,2,car,720,1192,491,680,472,189,0.9943153
43,2,car,721,1190,490,680,469,190,0.9937749
44,2,car,721,1189,491,680,468,189,0.9938193
45,2,car,721,1193,490,681,472,191,0.9946054
46,2,car,721,1190,490,681,469,191,0.99308574
47,2,car,721,1191,490,680,470,190,0.99485815
48,2,car,719,1191,490,680,472,190,0.99378115
49,2,car,719,1192,490,681,473,191,0.994926
50,2,car,722,1192,490,680,470,190,0.9945114
51,2,car,722,1190,490,680,468,190,0.99356544
52,2,car,718,1192,490,680,474,190,0.99396724
53,2,car,720,1192,491,680,472,189,0.99402833
54,2,car,720,1188,490,681,468,191,0.9936452
55,2,car,722,1188,490,681,466,191,0.9941867
56,2,car,722,1189,490,681,467,191,0.99316216
57,2,car,721,1191,490,681,470,191,0.9934978
58,2,car,722,1192,491,679,470,188,0.9947086
59,2,car,719,1191,490,680,472,190,0.99448395
60,2,car,721,1190,490,681,469,191,0.9950352
61,2,car,718,1192,491,680,474,189,0.9946807
62,2,car,720,1190,491,680,470,189,0.9939705
63,2,car,721,1189,490,680,468,190,0.99420947
64,2,car,721,1188,491,679,467,188,0.9941135
65,2,car,720,1190,491,680,470,189,0.99439865
66,2,car,721,1190,490,680,469,190,0.9935835
67,2,car,720,1190,490,680,470,190,0.99316007
68,2,car,720,1190,490,680,470,190,0.99366015
69,2,car,723,1188,491,680,465,189,0.9940172
70,2,car,723,1190,491,680,467,189,0.9925984
71,2,car,720,1189,491,679,469,188,0.99389535
72,2,car,720,1192,491,680,472,189,0.9947525
73,2,car,720,1189,490,681,469,191,0.99338204
74,2,car,723,1190,490,680,467,190,0.993658
75,2,car,722,1191,490,681,469,191,0.9944046
76,2,car,723,1189,491,680,466,189,0.9941147
77,2,car,592,912,482,651,320,169,0.9904916
78,2,car,593,912,482,651,319,169,0.99101853
79,2,car,591,911,482,650,320,168,0.99045604
0,2,car,721,1192,491,680,471,189,0.9921725
1,2,car,723,1190,490,680,467,190,0.9929821
2,2,car,723,1190,492,679,467,187,0.99407345
3,2,car,721,1189,490,680,468,190,0.99229693
4,2,car,720,1190,490,681,470,191,0.9942689
5,2,car,722,1190,491,680,468,189,0.9946975
6,2,car,722,1189,492,679,467,187,0.9933555
7,2,car,719,1191,491,680,472,189,0.99077785
8,2,car,720,1189,492,678,469,186,0.99275035
9,2,car,719,1192,491,680,473,189,0.99213934
10,2,car,724,1188,491,679,464,188,0.9937347
11,2,car,721,1191,490,680,470,190,0.9937846
12,2,car,724,1189,489,681,465,192,0.99227536
13,2,car,721,1191,490,681,470,191,0.99170077
14,2,car,722,1189,492,678,467,186,0.99312747
15,2,car,722,1189,490,680,467,190,0.9928037
16,2,car,722,1191,491,680,469,189,0.9921203
17,2,car,722,1189,490,681,467,191,0.9922209
18,2,car,721,1192,490,681,471,191,0.9930029
19,2,car,721,1191,491,680,470,189,0.99370116
20,2,car,721,1192,491,679,471,188,0.99167436
21,2,car,720,1191,489,681,471,192,0.99269456
22,2,car,721,1190,491,680,469,189,0.993381
23,2,car,718,1190,490,681,472,191,0.99364763
24,2,car,722,1193,490,680,471,190,0.99402285
25,2,car,719,1192,490,680,473,190,0.99388003
26,2,car,723,1192,490,680,469,190,0.992976
27,2,car,721,1190,491,680,469,189,0.99315363
28,2,car,721,1190,491,680,469,189,0.9950945
29,2,car,719,1191,490,681,472,191,0.99357724
30,2,car,723,1191,491,680,468,189,0.99360245
31,2,car,721,1190,491,680,469,189,0.99408567
32,2,car,722,1191,490,680,469,190,0.99388546
33,2,car,719,1189,490,681,470,191,0.9933415
34,2,car,721,1189,490,681,468,191,0.99309224
35,2,car,720,1189,490,680,469,190,0.9933535
36,2,car,721,1189,490,680,468,190,0.99278355
37,2,car,722,1191,491,679,469,188,0.99334544
38,2,car,721,1189,491,679,468,188,0.9922223
39,2,car,721,1192,491,679,471,188,0.99353355
40,2,car,721,1190,491,680,469,189,0.9941834
41,2,car,721,1192,490,680,471,190,0.9927697
42,2,car,723,1187,491,680,464,189,0.9929273
43,2,car,720,1192,491,680,472,189,0.9943153
44,2,car,721,1190,490,680,469,190,0.9937749
45,2,car,721,1189,491,680,468,189,0.9938193
46,2,car,721,1193,490,681,472,191,0.9946054
47,2,car,721,1190,490,681,469,191,0.99308574
48,2,car,721,1191,490,680,470,190,0.99485815
49,2,car,719,1191,490,680,472,190,0.99378115
50,2,car,719,1192,490,681,473,191,0.994926
51,2,car,722,1192,490,680,470,190,0.9945114
52,2,car,722,1190,490,680,468,190,0.99356544
53,2,car,718,1192,490,680,474,190,0.99396724
54,2,car,720,1192,491,680,472,189,0.99402833
55,2,car,720,1188,490,681,468,191,0.9936452
56,2,car,722,1188,490,681,466,191,0.9941867
57,2,car,722,1189,490,681,467,191,0.99316216
58,2,car,721,1191,490,681,470,191,0.9934978
59,2,car,722,1192,491,679,470,188,0.9947086
60,2,car,719,1191,490,680,472,190,0.99448395
61,2,car,721,1190,490,681,469,191,0.9950352
62,2,car,718,1192,491,680,474,189,0.9946807
63,2,car,720,1190,491,680,470,189,0.9939705
64,2,car,721,1189,490,680,468,190,0.99420947
65,2,car,721,1188,491,679,467,188,0.9941135
66,2,car,720,1190,491,680,470,189,0.99439865
67,2,car,721,1190,490,680,469,190,0.9935835
68,2,car,720,1190,490,680,470,190,0.99316007
69,2,car,720,1190,490,680,470,190,0.99366015
70,2,car,723,1188,491,680,465,189,0.9940172
71,2,car,723,1190,491,680,467,189,0.9925984
72,2,car,720,1189,491,679,469,188,0.99389535
73,2,car,720,1192,491,680,472,189,0.9947525
74,2,car,720,1189,490,681,469,191,0.99338204
75,2,car,723,1190,490,680,467,190,0.993658
76,2,car,722,1191,490,681,469,191,0.9944046
77,2,car,723,1189,491,680,466,189,0.9941147
78,2,car,592,912,482,651,320,169,0.9904916
79,2,car,593,912,482,651,319,169,0.99101853
80,2,car,591,911,482,650,320,168,0.99045604
0,2,car,722,1188,492,679,466,187,0.9910961
1,2,car,721,1192,491,680,471,189,0.9921725
2,2,car,723,1190,490,680,467,190,0.9929821
3,2,car,723,1190,492,679,467,187,0.99407345
4,2,car,721,1189,490,680,468,190,0.99229693
5,2,car,720,1190,490,681,470,191,0.9942689
6,2,car,722,1190,491,680,468,189,0.9946975
7,2,car,722,1189,492,679,467,187,0.9933555
8,2,car,719,1191,491,680,472,189,0.99077785
9,2,car,720,1189,492,678,469,186,0.99275035
10,2,car,719,1192,491,680,473,189,0.99213934
11,2,car,724,1188,491,679,464,188,0.9937347
12,2,car,721,1191,490,680,470,190,0.9937846
13,2,car,724,1189,489,681,465,192,0.99227536
14,2,car,721,1191,490,681,470,191,0.99170077
15,2,car,722,1189,492,678,467,186,0.99312747
16,2,car,722,1189,490,680,467,190,0.9928037
17,2,car,722,1191,491,680,469,189,0.9921203
18,2,car,722,1189,490,681,467,191,0.9922209
19,2,car,721,1192,490,681,471,191,0.9930029
20,2,car,721,1191,491,680,470,189,0.99370116
21,2,car,721,1192,491,679,471,188,0.99167436
22,2,car,720,1191,489,681,471,192,0.99269456
23,2,car,721,1190,491,680,469,189,0.993381
24,2,car,718,1190,490,681,472,191,0.99364763
25,2,car,722,1193,490,680,471,190,0.99402285
26,2,car,719,1192,490,680,473,190,0.99388003
27,2,car,723,1192,490,680,469,190,0.992976
28,2,car,721,1190,491,680,469,189,0.99315363
29,2,car,721,1190,491,680,469,189,0.9950945
30,2,car,719,1191,490,681,472,191,0.99357724
31,2,car,723,1191,491,680,468,189,0.99360245
32,2,car,721,1190,491,680,469,189,0.99408567
33,2,car,722,1191,490,680,469,190,0.99388546
34,2,car,719,1189,490,681,470,191,0.9933415
35,2,car,721,1189,490,681,468,191,0.99309224
36,2,car,720,1189,490,680,469,190,0.9933535
37,2,car,721,1189,490,680,468,190,0.99278355
38,2,car,722,1191,491,679,469,188,0.99334544
39,2,car,721,1189,491,679,468,188,0.9922223
40,2,car,721,1192,491,679,471,188,0.99353355
41,2,car,721,1190,491,680,469,189,0.9941834
42,2,car,721,1192,490,680,471,190,0.9927697
43,2,car,723,1187,491,680,464,189,0.9929273
44,2,car,720,1192,491,680,472,189,0.9943153
45,2,car,721,1190,490,680,469,190,0.9937749
46,2,car,721,1189,491,680,468,189,0.9938193
47,2,car,721,1193,490,681,472,191,0.9946054
48,2,car,721,1190,490,681,469,191,0.99308574
49,2,car,721,1191,490,680,470,190,0.99485815
50,2,car,719,1191,490,680,472,190,0.99378115
51,2,car,719,1192,490,681,473,191,0.994926
52,2,car,722,1192,490,680,470,190,0.9945114
53,2,car,722,1190,490,680,468,190,0.99356544
54,2,car,718,1192,490,680,474,190,0.99396724
55,2,car,720,1192,491,680,472,189,0.99402833
56,2,car,720,1188,490,681,468,191,0.9936452
57,2,car,722,1188,490,681,466,191,0.9941867
58,2,car,722,1189,490,681,467,191,0.99316216
59,2,car,721,1191,490,681,470,191,0.9934978
60,2,car,722,1192,491,679,470,188,0.9947086
61,2,car,719,1191,490,680,472,190,0.99448395
62,2,car,721,1190,490,681,469,191,0.9950352
63,2,car,718,1192,491,680,474,189,0.9946807
64,2,car,720,1190,491,680,470,189,0.9939705
65,2,car,721,1189,490,680,468,190,0.99420947
66,2,car,721,1188,491,679,467,188,0.9941135
67,2,car,720,1190,491,680,470,189,0.99439865
68,2,car,721,1190,490,680,469,190,0.9935835
69,2,car,720,1190,490,680,470,190,0.99316007
70,2,car,720,1190,490,680,470,190,0.99366015
71,2,car,723,1188,491,680,465,189,0.9940172
72,2,car,723,1190,491,680,467,189,0.9925984
73,2,car,720,1189,491,679,469,188,0.99389535
74,2,car,720,1192,491,680,472,189,0.9947525
75,2,car,720,1189,490,681,469,191,0.99338204
76,2,car,723,1190,490,680,467,190,0.993658
77,2,car,722,1191,490,681,469,191,0.9944046
78,2,car,723,1189,491,680,466,189,0.9941147
79,2,car,592,912,482,651,320,169,0.9904916
80,2,car,593,912,482,651,319,169,0.99101853
81,2,car,591,911,482,650,320,168,0.99045604
0,2,car,721,1190,491,680,469,189,0.9931046
1,2,car,722,1188,492,679,466,187,0.9910961
2,2,car,721,1192,491,680,471,189,0.9921725
3,2,car,723,1190,490,680,467,190,0.9929821
4,2,car,723,1190,492,679,467,187,0.99407345
5,2,car,721,1189,490,680,468,190,0.99229693
6,2,car,720,1190,490,681,470,191,0.9942689
7,2,car,722,1190,491,680,468,189,0.9946975
8,2,car,722,1189,492,679,467,187,0.9933555
9,2,car,719,1191,491,680,472,189,0.99077785
10,2,car,720,1189,492,678,469,186,0.99275035
11,2,car,719,1192,491,680,473,189,0.99213934
12,2,car,724,1188,491,679,464,188,0.9937347
13,2,car,721,1191,490,680,470,190,0.9937846
14,2,car,724,1189,489,681,465,192,0.99227536
15,2,car,721,1191,490,681,470,191,0.99170077
16,2,car,722,1189,492,678,467,186,0.99312747
17,2,car,722,1189,490,680,467,190,0.9928037
18,2,car,722,1191,491,680,469,189,0.9921203
19,2,car,722,1189,490,681,467,191,0.9922209
20,2,car,721,1192,490,681,471,191,0.9930029
21,2,car,721,1191,491,680,470,189,0.99370116
22,2,car,721,1192,491,679,471,188,0.99167436
23,2,car,720,1191,489,681,471,192,0.99269456
24,2,car,721,1190,491,680,469,189,0.993381
25,2,car,718,1190,490,681,472,191,0.99364763
26,2,car,722,1193,490,680,471,190,0.99402285
27,2,car,719,1192,490,680,473,190,0.99388003
28,2,car,723,1192,490,680,469,190,0.992976
29,2,car,721,1190,491,680,469,189,0.99315363
30,2,car,721,1190,491,680,469,189,0.9950945
31,2,car,719,1191,490,681,472,191,0.99357724
32,2,car,723,1191,491,680,468,189,0.99360245
33,2,car,721,1190,491,680,469,189,0.99408567
34,2,car,722,1191,490,680,469,190,0.99388546
35,2,car,719,1189,490,681,470,191,0.9933415
36,2,car,721,1189,490,681,468,191,0.99309224
37,2,car,720,1189,490,680,469,190,0.9933535
38,2,car,721,1189,490,680,468,190,0.99278355
39,2,car,722,1191,491,679,469,188,0.99334544
40,2,car,721,1189,491,679,468,188,0.9922223
41,2,car,721,1192,491,679,471,188,0.99353355
42,2,car,721,1190,491,680,469,189,0.9941834
43,2,car,721,1192,490,680,471,190,0.9927697
44,2,car,723,1187,491,680,464,189,0.9929273
45,2,car,720,1192,491,680,472,189,0.9943153
46,2,car,721,1190,490,680,469,190,0.9937749
47,2,car,721,1189,491,680,468,189,0.9938193
48,2,car,721,1193,490,681,472,191,0.9946054
49,2,car,721,1190,490,681,469,191,0.99308574
50,2,car,721,1191,490,680,470,190,0.99485815
51,2,car,719,1191,490,680,472,190,0.99378115
52,2,car,719,1192,490,681,473,191,0.994926
53,2,car,722,1192,490,680,470,190,0.9945114
54,2,car,722,1190,490,680,468,190,0.99356544
55,2,car,718,1192,490,680,474,190,0.99396724
56,2,car,720,1192,491,680,472,189,0.99402833
57,2,car,720,1188,490,681,468,191,0.9936452
58,2,car,722,1188,490,681,466,191,0.9941867
59,2,car,722,1189,490,681,467,191,0.99316216
60,2,car,721,1191,490,681,470,191,0.9934978
61,2,car,722,1192,491,679,470,188,0.9947086
62,2,car,719,1191,490,680,472,190,0.99448395
63,2,car,721,1190,490,681,469,191,0.9950352
64,2,car,718,1192,491,680,474,189,0.9946807
65,2,car,720,1190,491,680,470,189,0.9939705
66,2,car,721,1189,490,680,468,190,0.99420947
67,2,car,721,1188,491,679,467,188,0.9941135
68,2,car,720,1190,491,680,470,189,0.99439865
69,2,car,721,1190,490,680,469,190,0.9935835
70,2,car,720,1190,490,680,470,190,0.99316007
71,2,car,720,1190,490,680,470,190,0.99366015
72,2,car,723,1188,491,680,465,189,0.9940172
73,2,car,723,1190,491,680,467,189,0.9925984
74,2,car,720,1189,491,679,469,188,0.99389535
75,2,car,720,1192,491,680,472,189,0.9947525
76,2,car,720,1189,490,681,469,191,0.99338204
77,2,car,723,1190,490,680,467,190,0.993658
78,2,car,722,1191,490,681,469,191,0.9944046
79,2,car,723,1189,491,680,466,189,0.9941147
80,2,car,592,912,482,651,320,169,0.9904916
81,2,car,593,912,482,651,319,169,0.99101853
82,2,car,591,911,482,650,320,168,0.99045604
0,2,car,721,1187,492,679,466,187,0.99343777
1,2,car,721,1190,491,680,469,189,0.9931046
2,2,car,722,1188,492,679,466,187,0.9910961
3,2,car,721,1192,491,680,471,189,0.9921725
4,2,car,723,1190,490,680,467,190,0.9929821
5,2,car,723,1190,492,679,467,187,0.99407345
6,2,car,721,1189,490,680,468,190,0.99229693
7,2,car,720,1190,490,681,470,191,0.9942689
8,2,car,722,1190,491,680,468,189,0.9946975
9,2,car,722,1189,492,679,467,187,0.9933555
10,2,car,719,1191,491,680,472,189,0.99077785
11,2,car,720,1189,492,678,469,186,0.99275035
12,2,car,719,1192,491,680,473,189,0.99213934
13,2,car,724,1188,491,679,464,188,0.9937347
14,2,car,721,1191,490,680,470,190,0.9937846
15,2,car,724,1189,489,681,465,192,0.99227536
16,2,car,721,1191,490,681,470,191,0.99170077
17,2,car,722,1189,492,678,467,186,0.99312747
18,2,car,722,1189,490,680,467,190,0.9928037
19,2,car,722,1191,491,680,469,189,0.9921203
20,2,car,722,1189,490,681,467,191,0.9922209
21,2,car,721,1192,490,681,471,191,0.9930029
22,2,car,721,1191,491,680,470,189,0.99370116
23,2,car,721,1192,491,679,471,188,0.99167436
24,2,car,720,1191,489,681,471,192,0.99269456
25,2,car,721,1190,491,680,469,189,0.993381
26,2,car,718,1190,490,681,472,191,0.99364763
27,2,car,722,1193,490,680,471,190,0.99402285
28,2,car,719,1192,490,680,473,190,0.99388003
29,2,car,723,1192,490,680,469,190,0.992976
30,2,car,721,1190,491,680,469,189,0.99315363
31,2,car,721,1190,491,680,469,189,0.9950945
32,2,car,719,1191,490,681,472,191,0.99357724
33,2,car,723,1191,491,680,468,189,0.99360245
34,2,car,721,1190,491,680,469,189,0.99408567
35,2,car,722,1191,490,680,469,190,0.99388546
36,2,car,719,1189,490,681,470,191,0.9933415
37,2,car,721,1189,490,681,468,191,0.99309224
38,2,car,720,1189,490,680,469,190,0.9933535
39,2,car,721,1189,490,680,468,190,0.99278355
40,2,car,722,1191,491,679,469,188,0.99334544
41,2,car,721,1189,491,679,468,188,0.9922223
42,2,car,721,1192,491,679,471,188,0.99353355
43,2,car,721,1190,491,680,469,189,0.9941834
44,2,car,721,1192,490,680,471,190,0.9927697
45,2,car,723,1187,491,680,464,189,0.9929273
46,2,car,720,1192,491,680,472,189,0.9943153
47,2,car,721,1190,490,680,469,190,0.9937749
48,2,car,721,1189,491,680,468,189,0.9938193
49,2,car,721,1193,490,681,472,191,0.9946054
50,2,car,721,1190,490,681,469,191,0.99308574
51,2,car,721,1191,490,680,470,190,0.99485815
52,2,car,719,1191,490,680,472,190,0.99378115
53,2,car,719,1192,490,681,473,191,0.994926
54,2,car,722,1192,490,680,470,190,0.9945114
55,2,car,722,1190,490,680,468,190,0.99356544
56,2,car,718,1192,490,680,474,190,0.99396724
57,2,car,720,1192,491,680,472,189,0.99402833
58,2,car,720,1188,490,681,468,191,0.9936452
59,2,car,722,1188,490,681,466,191,0.9941867
60,2,car,722,1189,490,681,467,191,0.99316216
61,2,car,721,1191,490,681,470,191,0.9934978
62,2,car,722,1192,491,679,470,188,0.9947086
63,2,car,719,1191,490,680,472,190,0.99448395
64,2,car,721,1190,490,681,469,191,0.9950352
65,2,car,718,1192,491,680,474,189,0.9946807
66,2,car,720,1190,491,680,470,189,0.9939705
67,2,car,721,1189,490,680,468,190,0.99420947
68,2,car,721,1188,491,679,467,188,0.9941135
69,2,car,720,1190,491,680,470,189,0.99439865
70,2,car,721,1190,490,680,469,190,0.9935835
71,2,car,720,1190,490,680,470,190,0.99316007
72,2,car,720,1190,490,680,470,190,0.99366015
73,2,car,723,1188,491,680,465,189,0.9940172
74,2,car,723,1190,491,680,467,189,0.9925984
75,2,car,720,1189,491,679,469,188,0.99389535
76,2,car,720,1192,491,680,472,189,0.9947525
77,2,car,720,1189,490,681,469,191,0.99338204
78,2,car,723,1190,490,680,467,190,0.993658
79,2,car,722,1191,490,681,469,191,0.9944046
80,2,car,723,1189,491,680,466,189,0.9941147
81,2,car,592,912,482,651,320,169,0.9904916
82,2,car,593,912,482,651,319,169,0.99101853
83,2,car,591,911,482,650,320,168,0.99045604
0,2,car,721,1191,491,680,470,189,0.9923738
1,2,car,721,1187,492,679,466,187,0.99343777
2,2,car,721,1190,491,680,469,189,0.9931046
3,2,car,722,1188,492,679,466,187,0.9910961
4,2,car,721,1192,491,680,471,189,0.9921725
5,2,car,723,1190,490,680,467,190,0.9929821
6,2,car,723,1190,492,679,467,187,0.99407345
7,2,car,721,1189,490,680,468,190,0.99229693
8,2,car,720,1190,490,681,470,191,0.9942689
9,2,car,722,1190,491,680,468,189,0.9946975
10,2,car,722,1189,492,679,467,187,0.9933555
11,2,car,719,1191,491,680,472,189,0.99077785
12,2,car,720,1189,492,678,469,186,0.99275035
13,2,car,719,1192,491,680,473,189,0.99213934
14,2,car,724,1188,491,679,464,188,0.9937347
15,2,car,721,1191,490,680,470,190,0.9937846
16,2,car,724,1189,489,681,465,192,0.99227536
17,2,car,721,1191,490,681,470,191,0.99170077
18,2,car,722,1189,492,678,467,186,0.99312747
19,2,car,722,1189,490,680,467,190,0.9928037
20,2,car,722,1191,491,680,469,189,0.9921203
21,2,car,722,1189,490,681,467,191,0.9922209
22,2,car,721,1192,490,681,471,191,0.9930029
23,2,car,721,1191,491,680,470,189,0.99370116
24,2,car,721,1192,491,679,471,188,0.99167436
25,2,car,720,1191,489,681,471,192,0.99269456
26,2,car,721,1190,491,680,469,189,0.993381
27,2,car,718,1190,490,681,472,191,0.99364763
28,2,car,722,1193,490,680,471,190,0.99402285
29,2,car,719,1192,490,680,473,190,0.99388003
30,2,car,723,1192,490,680,469,190,0.992976
31,2,car,721,1190,491,680,469,189,0.99315363
32,2,car,721,1190,491,680,469,189,0.9950945
33,2,car,719,1191,490,681,472,191,0.99357724
34,2,car,723,1191,491,680,468,189,0.99360245
35,2,car,721,1190,491,680,469,189,0.99408567
36,2,car,722,1191,490,680,469,190,0.99388546
37,2,car,719,1189,490,681,470,191,0.9933415
38,2,car,721,1189,490,681,468,191,0.99309224
39,2,car,720,1189,490,680,469,190,0.9933535
40,2,car,721,1189,490,680,468,190,0.99278355
41,2,car,722,1191,491,679,469,188,0.99334544
42,2,car,721,1189,491,679,468,188,0.9922223
43,2,car,721,1192,491,679,471,188,0.99353355
44,2,car,721,1190,491,680,469,189,0.9941834
45,2,car,721,1192,490,680,471,190,0.9927697
46,2,car,723,1187,491,680,464,189,0.9929273
47,2,car,720,1192,491,680,472,189,0.9943153
48,2,car,721,1190,490,680,469,190,0.9937749
49,2,car,721,1189,491,680,468,189,0.9938193
50,2,car,721,1193,490,681,472,191,0.9946054
51,2,car,721,1190,490,681,469,191,0.99308574
52,2,car,721,1191,490,680,470,190,0.99485815
53,2,car,719,1191,490,680,472,190,0.99378115
54,2,car,719,1192,490,681,473,191,0.994926
55,2,car,722,1192,490,680,470,190,0.9945114
56,2,car,722,1190,490,680,468,190,0.99356544
57,2,car,718,1192,490,680,474,190,0.99396724
58,2,car,720,1192,491,680,472,189,0.99402833
59,2,car,720,1188,490,681,468,191,0.9936452
60,2,car,722,1188,490,681,466,191,0.9941867
61,2,car,722,1189,490,681,467,191,0.99316216
62,2,car,721,1191,490,681,470,191,0.9934978
63,2,car,722,1192,491,679,470,188,0.9947086
64,2,car,719,1191,490,680,472,190,0.99448395
65,2,car,721,1190,490,681,469,191,0.9950352
66,2,car,718,1192,491,680,474,189,0.9946807
67,2,car,720,1190,491,680,470,189,0.9939705
68,2,car,721,1189,490,680,468,190,0.99420947
69,2,car,721,1188,491,679,467,188,0.9941135
70,2,car,720,1190,491,680,470,189,0.99439865
71,2,car,721,1190,490,680,469,190,0.9935835
72,2,car,720,1190,490,680,470,190,0.99316007
73,2,car,720,1190,490,680,470,190,0.99366015
74,2,car,723,1188,491,680,465,189,0.9940172
75,2,car,723,1190,491,680,467,189,0.9925984
76,2,car,720,1189,491,679,469,188,0.99389535
77,2,car,720,1192,491,680,472,189,0.9947525
78,2,car,720,1189,490,681,469,191,0.99338204
79,2,car,723,1190,490,680,467,190,0.993658
80,2,car,722,1191,490,681,469,191,0.9944046
81,2,car,723,1189,491,680,466,189,0.9941147
82,2,car,592,912,482,651,320,169,0.9904916
83,2,car,593,912,482,651,319,169,0.99101853
84,2,car,591,911,482,650,320,168,0.99045604
0,2,car,720,1191,490,681,471,191,0.9926691
1,2,car,721,1191,491,680,470,189,0.9923738
2,2,car,721,1187,492,679,466,187,0.99343777
3,2,car,721,1190,491,680,469,189,0.9931046
4,2,car,722,1188,492,679,466,187,0.9910961
5,2,car,721,1192,491,680,471,189,0.9921725
6,2,car,723,1190,490,680,467,190,0.9929821
7,2,car,723,1190,492,679,467,187,0.99407345
8,2,car,721,1189,490,680,468,190,0.99229693
9,2,car,720,1190,490,681,470,191,0.9942689
10,2,car,722,1190,491,680,468,189,0.9946975
11,2,car,722,1189,492,679,467,187,0.9933555
12,2,car,719,1191,491,680,472,189,0.99077785
13,2,car,720,1189,492,678,469,186,0.99275035
14,2,car,719,1192,491,680,473,189,0.99213934
15,2,car,724,1188,491,679,464,188,0.9937347
16,2,car,721,1191,490,680,470,190,0.9937846
17,2,car,724,1189,489,681,465,192,0.99227536
18,2,car,721,1191,490,681,470,191,0.99170077
19,2,car,722,1189,492,678,467,186,0.99312747
20,2,car,722,1189,490,680,467,190,0.9928037
21,2,car,722,1191,491,680,469,189,0.9921203
22,2,car,722,1189,490,681,467,191,0.9922209
23,2,car,721,1192,490,681,471,191,0.9930029
24,2,car,721,1191,491,680,470,189,0.99370116
25,2,car,721,1192,491,679,471,188,0.99167436
26,2,car,720,1191,489,681,471,192,0.99269456
27,2,car,721,1190,491,680,469,189,0.993381
28,2,car,718,1190,490,681,472,191,0.99364763
29,2,car,722,1193,490,680,471,190,0.99402285
30,2,car,719,1192,490,680,473,190,0.99388003
31,2,car,723,1192,490,680,469,190,0.992976
32,2,car,721,1190,491,680,469,189,0.99315363
33,2,car,721,1190,491,680,469,189,0.9950945
34,2,car,719,1191,490,681,472,191,0.99357724
35,2,car,723,1191,491,680,468,189,0.99360245
36,2,car,721,1190,491,680,469,189,0.99408567
37,2,car,722,1191,490,680,469,190,0.99388546
38,2,car,719,1189,490,681,470,191,0.9933415
39,2,car,721,1189,490,681,468,191,0.99309224
40,2,car,720,1189,490,680,469,190,0.9933535
41,2,car,721,1189,490,680,468,190,0.99278355
42,2,car,722,1191,491,679,469,188,0.99334544
43,2,car,721,1189,491,679,468,188,0.9922223
44,2,car,721,1192,491,679,471,188,0.99353355
45,2,car,721,1190,491,680,469,189,0.9941834
46,2,car,721,1192,490,680,471,190,0.9927697
47,2,car,723,1187,491,680,464,189,0.9929273
48,2,car,720,1192,491,680,472,189,0.9943153
49,2,car,721,1190,490,680,469,190,0.9937749
50,2,car,721,1189,491,680,468,189,0.9938193
51,2,car,721,1193,490,681,472,191,0.9946054
52,2,car,721,1190,490,681,469,191,0.99308574
53,2,car,721,1191,490,680,470,190,0.99485815
54,2,car,719,1191,490,680,472,190,0.99378115
55,2,car,719,1192,490,681,473,191,0.994926
56,2,car,722,1192,490,680,470,190,0.9945114
57,2,car,722,1190,490,680,468,190,0.99356544
58,2,car,718,1192,490,680,474,190,0.99396724
59,2,car,720,1192,491,680,472,189,0.99402833
60,2,car,720,1188,490,681,468,191,0.9936452
61,2,car,722,1188,490,681,466,191,0.9941867
62,2,car,722,1189,490,681,467,191,0.99316216
63,2,car,721,1191,490,681,470,191,0.9934978
64,2,car,722,1192,491,679,470,188,0.9947086
65,2,car,719,1191,490,680,472,190,0.99448395
66,2,car,721,1190,490,681,469,191,0.9950352
67,2,car,718,1192,491,680,474,189,0.9946807
68,2,car,720,1190,491,680,470,189,0.9939705
69,2,car,721,1189,490,680,468,190,0.99420947
70,2,car,721,1188,491,679,467,188,0.9941135
71,2,car,720,1190,491,680,470,189,0.99439865
72,2,car,721,1190,490,680,469,190,0.9935835
73,2,car,720,1190,490,680,470,190,0.99316007
74,2,car,720,1190,490,680,470,190,0.99366015
75,2,car,723,1188,491,680,465,189,0.9940172
76,2,car,723,1190,491,680,467,189,0.9925984
77,2,car,720,1189,491,679,469,188,0.99389535
78,2,car,720,1192,491,680,472,189,0.9947525
79,2,car,720,1189,490,681,469,191,0.99338204
80,2,car,723,1190,490,680,467,190,0.993658
81,2,car,722,1191,490,681,469,191,0.9944046
82,2,car,723,1189,491,680,466,189,0.9941147
83,2,car,592,912,482,651,320,169,0.9904916
84,2,car,593,912,482,651,319,169,0.99101853
85,2,car,591,911,482,650,320,168,0.99045604
0,2,car,723,1189,491,680,466,189,0.9942534
1,2,car,720,1191,490,681,471,191,0.9926691
2,2,car,721,1191,491,680,470,189,0.9923738
3,2,car,721,1187,492,679,466,187,0.99343777
4,2,car,721,1190,491,680,469,189,0.9931046
5,2,car,722,1188,492,679,466,187,0.9910961
6,2,car,721,1192,491,680,471,189,0.9921725
7,2,car,723,1190,490,680,467,190,0.9929821
8,2,car,723,1190,492,679,467,187,0.99407345
9,2,car,721,1189,490,680,468,190,0.99229693
10,2,car,720,1190,490,681,470,191,0.9942689
11,2,car,722,1190,491,680,468,189,0.9946975
12,2,car,722,1189,492,679,467,187,0.9933555
13,2,car,719,1191,491,680,472,189,0.99077785
14,2,car,720,1189,492,678,469,186,0.99275035
15,2,car,719,1192,491,680,473,189,0.99213934
16,2,car,724,1188,491,679,464,188,0.9937347
17,2,car,721,1191,490,680,470,190,0.9937846
18,2,car,724,1189,489,681,465,192,0.99227536
19,2,car,721,1191,490,681,470,191,0.99170077
20,2,car,722,1189,492,678,467,186,0.99312747
21,2,car,722,1189,490,680,467,190,0.9928037
22,2,car,722,1191,491,680,469,189,0.9921203
23,2,car,722,1189,490,681,467,191,0.9922209
24,2,car,721,1192,490,681,471,191,0.9930029
25,2,car,721,1191,491,680,470,189,0.99370116
26,2,car,721,1192,491,679,471,188,0.99167436
27,2,car,720,1191,489,681,471,192,0.99269456
28,2,car,721,1190,491,680,469,189,0.993381
29,2,car,718,1190,490,681,472,191,0.99364763
30,2,car,722,1193,490,680,471,190,0.99402285
31,2,car,719,1192,490,680,473,190,0.99388003
32,2,car,723,1192,490,680,469,190,0.992976
33,2,car,721,1190,491,680,469,189,0.99315363
34,2,car,721,1190,491,680,469,189,0.9950945
35,2,car,719,1191,490,681,472,191,0.99357724
36,2,car,723,1191,491,680,468,189,0.99360245
37,2,car,721,1190,491,680,469,189,0.99408567
38,2,car,722,1191,490,680,469,190,0.99388546
39,2,car,719,1189,490,681,470,191,0.9933415
40,2,car,721,1189,490,681,468,191,0.99309224
41,2,car,720,1189,490,680,469,190,0.9933535
42,2,car,721,1189,490,680,468,190,0.99278355
43,2,car,722,1191,491,679,469,188,0.99334544
44,2,car,721,1189,491,679,468,188,0.9922223
45,2,car,721,1192,491,679,471,188,0.99353355
46,2,car,721,1190,491,680,469,189,0.9941834
47,2,car,721,1192,490,680,471,190,0.9927697
48,2,car,723,1187,491,680,464,189,0.9929273
49,2,car,720,1192,491,680,472,189,0.9943153
50,2,car,721,1190,490,680,469,190,0.9937749
51,2,car,721,1189,491,680,468,189,0.9938193
52,2,car,721,1193,490,681,472,191,0.9946054
53,2,car,721,1190,490,681,469,191,0.99308574
54,2,car,721,1191,490,680,470,190,0.99485815
55,2,car,719,1191,490,680,472,190,0.99378115
56,2,car,719,1192,490,681,473,191,0.994926
57,2,car,722,1192,490,680,470,190,0.9945114
58,2,car,722,1190,490,680,468,190,0.99356544
59,2,car,718,1192,490,680,474,190,0.99396724
60,2,car,720,1192,491,680,472,189,0.99402833
61,2,car,720,1188,490,681,468,191,0.9936452
62,2,car,722,1188,490,681,466,191,0.9941867
63,2,car,722,1189,490,681,467,191,0.99316216
64,2,car,721,1191,490,681,470,191,0.9934978
65,2,car,722,1192,491,679,470,188,0.9947086
66,2,car,719,1191,490,680,472,190,0.99448395
67,2,car,721,1190,490,681,469,191,0.9950352
68,2,car,718,1192,491,680,474,189,0.9946807
69,2,car,720,1190,491,680,470,189,0.9939705
70,2,car,721,1189,490,680,468,190,0.99420947
71,2,car,721,1188,491,679,467,188,0.9941135
72,2,car,720,1190,491,680,470,189,0.99439865
73,2,car,721,1190,490,680,469,190,0.9935835
74,2,car,720,1190,490,680,470,190,0.99316007
75,2,car,720,1190,490,680,470,190,0.99366015
76,2,car,723,1188,491,680,465,189,0.9940172
77,2,car,723,1190,491,680,467,189,0.9925984
78,2,car,720,1189,491,679,469,188,0.99389535
79,2,car,720,1192,491,680,472,189,0.9947525
80,2,car,720,1189,490,681,469,191,0.99338204
81,2,car,723,1190,490,680,467,190,0.993658
82,2,car,722,1191,490,681,469,191,0.9944046
83,2,car,723,1189,491,680,466,189,0.9941147
84,2,car,592,912,482,651,320,169,0.9904916
85,2,car,593,912,482,651,319,169,0.99101853
86,2,car,591,911,482,650,320,168,0.99045604
0,2,car,721,1191,491,680,470,189,0.9943646
1,2,car,723,1189,491,680,466,189,0.9942534
2,2,car,720,1191,490,681,471,191,0.9926691
3,2,car,721,1191,491,680,470,189,0.9923738
4,2,car,721,1187,492,679,466,187,0.99343777
5,2,car,721,1190,491,680,469,189,0.9931046
6,2,car,722,1188,492,679,466,187,0.9910961
7,2,car,721,1192,491,680,471,189,0.9921725
8,2,car,723,1190,490,680,467,190,0.9929821
9,2,car,723,1190,492,679,467,187,0.99407345
10,2,car,721,1189,490,680,468,190,0.99229693
11,2,car,720,1190,490,681,470,191,0.9942689
12,2,car,722,1190,491,680,468,189,0.9946975
13,2,car,722,1189,492,679,467,187,0.9933555
14,2,car,719,1191,491,680,472,189,0.99077785
15,2,car,720,1189,492,678,469,186,0.99275035
16,2,car,719,1192,491,680,473,189,0.99213934
17,2,car,724,1188,491,679,464,188,0.9937347
18,2,car,721,1191,490,680,470,190,0.9937846
19,2,car,724,1189,489,681,465,192,0.99227536
20,2,car,721,1191,490,681,470,191,0.99170077
21,2,car,722,1189,492,678,467,186,0.99312747
22,2,car,722,1189,490,680,467,190,0.9928037
23,2,car,722,1191,491,680,469,189,0.9921203
24,2,car,722,1189,490,681,467,191,0.9922209
25,2,car,721,1192,490,681,471,191,0.9930029
26,2,car,721,1191,491,680,470,189,0.99370116
27,2,car,721,1192,491,679,471,188,0.99167436
28,2,car,720,1191,489,681,471,192,0.99269456
29,2,car,721,1190,491,680,469,189,0.993381
30,2,car,718,1190,490,681,472,191,0.99364763
31,2,car,722,1193,490,680,471,190,0.99402285
32,2,car,719,1192,490,680,473,190,0.99388003
33,2,car,723,1192,490,680,469,190,0.992976
34,2,car,721,1190,491,680,469,189,0.99315363
35,2,car,721,1190,491,680,469,189,0.9950945
36,2,car,719,1191,490,681,472,191,0.99357724
37,2,car,723,1191,491,680,468,189,0.99360245
38,2,car,721,1190,491,680,469,189,0.99408567
39,2,car,722,1191,490,680,469,190,0.99388546
40,2,car,719,1189,490,681,470,191,0.9933415
41,2,car,721,1189,490,681,468,191,0.99309224
42,2,car,720,1189,490,680,469,190,0.9933535
43,2,car,721,1189,490,680,468,190,0.99278355
44,2,car,722,1191,491,679,469,188,0.99334544
45,2,car,721,1189,491,679,468,188,0.9922223
46,2,car,721,1192,491,679,471,188,0.99353355
47,2,car,721,1190,491,680,469,189,0.9941834
48,2,car,721,1192,490,680,471,190,0.9927697
49,2,car,723,1187,491,680,464,189,0.9929273
50,2,car,720,1192,491,680,472,189,0.9943153
51,2,car,721,1190,490,680,469,190,0.9937749
52,2,car,721,1189,491,680,468,189,0.9938193
53,2,car,721,1193,490,681,472,191,0.9946054
54,2,car,721,1190,490,681,469,191,0.99308574
55,2,car,721,1191,490,680,470,190,0.99485815
56,2,car,719,1191,490,680,472,190,0.99378115
57,2,car,719,1192,490,681,473,191,0.994926
58,2,car,722,1192,490,680,470,190,0.9945114
59,2,car,722,1190,490,680,468,190,0.99356544
60,2,car,718,1192,490,680,474,190,0.99396724
61,2,car,720,1192,491,680,472,189,0.99402833
62,2,car,720,1188,490,681,468,191,0.9936452
63,2,car,722,1188,490,681,466,191,0.9941867
64,2,car,722,1189,490,681,467,191,0.99316216
65,2,car,721,1191,490,681,470,191,0.9934978
66,2,car,722,1192,491,679,470,188,0.9947086
67,2,car,719,1191,490,680,472,190,0.99448395
68,2,car,721,1190,490,681,469,191,0.9950352
69,2,car,718,1192,491,680,474,189,0.9946807
70,2,car,720,1190,491,680,470,189,0.9939705
71,2,car,721,1189,490,680,468,190,0.99420947
72,2,car,721,1188,491,679,467,188,0.9941135
73,2,car,720,1190,491,680,470,189,0.99439865
74,2,car,721,1190,490,680,469,190,0.9935835
75,2,car,720,1190,490,680,470,190,0.99316007
76,2,car,720,1190,490,680,470,190,0.99366015
77,2,car,723,1188,491,680,465,189,0.9940172
78,2,car,723,1190,491,680,467,189,0.9925984
79,2,car,720,1189,491,679,469,188,0.99389535
80,2,car,720,1192,491,680,472,189,0.9947525
81,2,car,720,1189,490,681,469,191,0.99338204
82,2,car,723,1190,490,680,467,190,0.993658
83,2,car,722,1191,490,681,469,191,0.9944046
84,2,car,723,1189,491,680,466,189,0.9941147
85,2,car,592,912,482,651,320,169,0.9904916
86,2,car,593,912,482,651,319,169,0.99101853
87,2,car,591,911,482,650,320,168,0.99045604
0,2,car,721,1190,491,680,469,189,0.9928404
1,2,car,721,1191,491,680,470,189,0.9943646
2,2,car,723,1189,491,680,466,189,0.9942534
3,2,car,720,1191,490,681,471,191,0.9926691
4,2,car,721,1191,491,680,470,189,0.9923738
5,2,car,721,1187,492,679,466,187,0.99343777
6,2,car,721,1190,491,680,469,189,0.9931046
7,2,car,722,1188,492,679,466,187,0.9910961
8,2,car,721,1192,491,680,471,189,0.9921725
9,2,car,723,1190,490,680,467,190,0.9929821
10,2,car,723,1190,492,679,467,187,0.99407345
11,2,car,721,1189,490,680,468,190,0.99229693
12,2,car,720,1190,490,681,470,191,0.9942689
13,2,car,722,1190,491,680,468,189,0.9946975
14,2,car,722,1189,492,679,467,187,0.9933555
15,2,car,719,1191,491,680,472,189,0.99077785
16,2,car,720,1189,492,678,469,186,0.99275035
17,2,car,719,1192,491,680,473,189,0.99213934
18,2,car,724,1188,491,679,464,188,0.9937347
19,2,car,721,1191,490,680,470,190,0.9937846
20,2,car,724,1189,489,681,465,192,0.99227536
21,2,car,721,1191,490,681,470,191,0.99170077
22,2,car,722,1189,492,678,467,186,0.99312747
23,2,car,722,1189,490,680,467,190,0.9928037
24,2,car,722,1191,491,680,469,189,0.9921203
25,2,car,722,1189,490,681,467,191,0.9922209
26,2,car,721,1192,490,681,471,191,0.9930029
27,2,car,721,1191,491,680,470,189,0.99370116
28,2,car,721,1192,491,679,471,188,0.99167436
29,2,car,720,1191,489,681,471,192,0.99269456
30,2,car,721,1190,491,680,469,189,0.993381
31,2,car,718,1190,490,681,472,191,0.99364763
32,2,car,722,1193,490,680,471,190,0.99402285
33,2,car,719,1192,490,680,473,190,0.99388003
34,2,car,723,1192,490,680,469,190,0.992976
35,2,car,721,1190,491,680,469,189,0.99315363
36,2,car,721,1190,491,680,469,189,0.9950945
37,2,car,719,1191,490,681,472,191,0.99357724
38,2,car,723,1191,491,680,468,189,0.99360245
39,2,car,721,1190,491,680,469,189,0.99408567
40,2,car,722,1191,490,680,469,190,0.99388546
41,2,car,719,1189,490,681,470,191,0.9933415
42,2,car,721,1189,490,681,468,191,0.99309224
43,2,car,720,1189,490,680,469,190,0.9933535
44,2,car,721,1189,490,680,468,190,0.99278355
45,2,car,722,1191,491,679,469,188,0.99334544
46,2,car,721,1189,491,679,468,188,0.9922223
47,2,car,721,1192,491,679,471,188,0.99353355
48,2,car,721,1190,491,680,469,189,0.9941834
49,2,car,721,1192,490,680,471,190,0.9927697
50,2,car,723,1187,491,680,464,189,0.9929273
51,2,car,720,1192,491,680,472,189,0.9943153
52,2,car,721,1190,490,680,469,190,0.9937749
53,2,car,721,1189,491,680,468,189,0.9938193
54,2,car,721,1193,490,681,472,191,0.9946054
55,2,car,721,1190,490,681,469,191,0.99308574
56,2,car,721,1191,490,680,470,190,0.99485815
57,2,car,719,1191,490,680,472,190,0.99378115
58,2,car,719,1192,490,681,473,191,0.994926
59,2,car,722,1192,490,680,470,190,0.9945114
60,2,car,722,1190,490,680,468,190,0.99356544
61,2,car,718,1192,490,680,474,190,0.99396724
62,2,car,720,1192,491,680,472,189,0.99402833
63,2,car,720,1188,490,681,468,191,0.9936452
64,2,car,722,1188,490,681,466,191,0.9941867
65,2,car,722,1189,490,681,467,191,0.99316216
66,2,car,721,1191,490,681,470,191,0.9934978
67,2,car,722,1192,491,679,470,188,0.9947086
68,2,car,719,1191,490,680,472,190,0.99448395
69,2,car,721,1190,490,681,469,191,0.9950352
70,2,car,718,1192,491,680,474,189,0.9946807
71,2,car,720,1190,491,680,470,189,0.9939705
72,2,car,721,1189,490,680,468,190,0.99420947
73,2,car,721,1188,491,679,467,188,0.9941135
74,2,car,720,1190,491,680,470,189,0.99439865
75,2,car,721,1190,490,680,469,190,0.9935835
76,2,car,720,1190,490,680,470,190,0.99316007
77,2,car,720,1190,490,680,470,190,0.99366015
78,2,car,723,1188,491,680,465,189,0.9940172
79,2,car,723,1190,491,680,467,189,0.9925984
80,2,car,720,1189,491,679,469,188,0.99389535
81,2,car,720,1192,491,680,472,189,0.9947525
82,2,car,720,1189,490,681,469,191,0.99338204
83,2,car,723,1190,490,680,467,190,0.993658
84,2,car,722,1191,490,681,469,191,0.9944046
85,2,car,723,1189,491,680,466,189,0.9941147
86,2,car,592,912,482,651,320,169,0.9904916
87,2,car,593,912,482,651,319,169,0.99101853
88,2,car,591,911,482,650,320,168,0.99045604
0,2,car,721,1190,490,681,469,191,0.9932829
1,2,car,721,1190,491,680,469,189,0.9928404
2,2,car,721,1191,491,680,470,189,0.9943646
3,2,car,723,1189,491,680,466,189,0.9942534
4,2,car,720,1191,490,681,471,191,0.9926691
5,2,car,721,1191,491,680,470,189,0.9923738
6,2,car,721,1187,492,679,466,187,0.99343777
7,2,car,721,1190,491,680,469,189,0.9931046
8,2,car,722,1188,492,679,466,187,0.9910961
9,2,car,721,1192,491,680,471,189,0.9921725
10,2,car,723,1190,490,680,467,190,0.9929821
11,2,car,723,1190,492,679,467,187,0.99407345
12,2,car,721,1189,490,680,468,190,0.99229693
13,2,car,720,1190,490,681,470,191,0.9942689
14,2,car,722,1190,491,680,468,189,0.9946975
15,2,car,722,1189,492,679,467,187,0.9933555
16,2,car,719,1191,491,680,472,189,0.99077785
17,2,car,720,1189,492,678,469,186,0.99275035
18,2,car,719,1192,491,680,473,189,0.99213934
19,2,car,724,1188,491,679,464,188,0.9937347
20,2,car,721,1191,490,680,470,190,0.9937846
21,2,car,724,1189,489,681,465,192,0.99227536
22,2,car,721,1191,490,681,470,191,0.99170077
23,2,car,722,1189,492,678,467,186,0.99312747
24,2,car,722,1189,490,680,467,190,0.9928037
25,2,car,722,1191,491,680,469,189,0.9921203
26,2,car,722,1189,490,681,467,191,0.9922209
27,2,car,721,1192,490,681,471,191,0.9930029
28,2,car,721,1191,491,680,470,189,0.99370116
29,2,car,721,1192,491,679,471,188,0.99167436
30,2,car,720,1191,489,681,471,192,0.99269456
31,2,car,721,1190,491,680,469,189,0.993381
32,2,car,718,1190,490,681,472,191,0.99364763
33,2,car,722,1193,490,680,471,190,0.99402285
34,2,car,719,1192,490,680,473,190,0.99388003
35,2,car,723,1192,490,680,469,190,0.992976
36,2,car,721,1190,491,680,469,189,0.99315363
37,2,car,721,1190,491,680,469,189,0.9950945
38,2,car,719,1191,490,681,472,191,0.99357724
39,2,car,723,1191,491,680,468,189,0.99360245
40,2,car,721,1190,491,680,469,189,0.99408567
41,2,car,722,1191,490,680,469,190,0.99388546
42,2,car,719,1189,490,681,470,191,0.9933415
43,2,car,721,1189,490,681,468,191,0.99309224
44,2,car,720,1189,490,680,469,190,0.9933535
45,2,car,721,1189,490,680,468,190,0.99278355
46,2,car,722,1191,491,679,469,188,0.99334544
47,2,car,721,1189,491,679,468,188,0.9922223
48,2,car,721,1192,491,679,471,188,0.99353355
49,2,car,721,1190,491,680,469,189,0.9941834
50,2,car,721,1192,490,680,471,190,0.9927697
51,2,car,723,1187,491,680,464,189,0.9929273
52,2,car,720,1192,491,680,472,189,0.9943153
53,2,car,721,1190,490,680,469,190,0.9937749
54,2,car,721,1189,491,680,468,189,0.9938193
55,2,car,721,1193,490,681,472,191,0.9946054
56,2,car,721,1190,490,681,469,191,0.99308574
57,2,car,721,1191,490,680,470,190,0.99485815
58,2,car,719,1191,490,680,472,190,0.99378115
59,2,car,719,1192,490,681,473,191,0.994926
60,2,car,722,1192,490,680,470,190,0.9945114
61,2,car,722,1190,490,680,468,190,0.99356544
62,2,car,718,1192,490,680,474,190,0.99396724
63,2,car,720,1192,491,680,472,189,0.99402833
64,2,car,720,1188,490,681,468,191,0.9936452
65,2,car,722,1188,490,681,466,191,0.9941867
66,2,car,722,1189,490,681,467,191,0.99316216
67,2,car,721,1191,490,681,470,191,0.9934978
68,2,car,722,1192,491,679,470,188,0.9947086
69,2,car,719,1191,490,680,472,190,0.99448395
70,2,car,721,1190,490,681,469,191,0.9950352
71,2,car,718,1192,491,680,474,189,0.9946807
72,2,car,720,1190,491,680,470,189,0.9939705
73,2,car,721,1189,490,680,468,190,0.99420947
74,2,car,721,1188,491,679,467,188,0.9941135
75,2,car,720,1190,491,680,470,189,0.99439865
76,2,car,721,1190,490,680,469,190,0.9935835
77,2,car,720,1190,490,680,470,190,0.99316007
78,2,car,720,1190,490,680,470,190,0.99366015
79,2,car,723,1188,491,680,465,189,0.9940172
80,2,car,723,1190,491,680,467,189,0.9925984
81,2,car,720,1189,491,679,469,188,0.99389535
82,2,car,720,1192,491,680,472,189,0.9947525
83,2,car,720,1189,490,681,469,191,0.99338204
84,2,car,723,1190,490,680,467,190,0.993658
85,2,car,722,1191,490,681,469,191,0.9944046
86,2,car,723,1189,491,680,466,189,0.9941147
87,2,car,592,912,482,651,320,169,0.9904916
88,2,car,593,912,482,651,319,169,0.99101853
89,2,car,591,911,482,650,320,168,0.99045604
0,2,car,721,1188,491,679,467,188,0.9926908
1,2,car,721,1190,490,681,469,191,0.9932829
2,2,car,721,1190,491,680,469,189,0.9928404
3,2,car,721,1191,491,680,470,189,0.9943646
4,2,car,723,1189,491,680,466,189,0.9942534
5,2,car,720,1191,490,681,471,191,0.9926691
6,2,car,721,1191,491,680,470,189,0.9923738
7,2,car,721,1187,492,679,466,187,0.99343777
8,2,car,721,1190,491,680,469,189,0.9931046
9,2,car,722,1188,492,679,466,187,0.9910961
10,2,car,721,1192,491,680,471,189,0.9921725
11,2,car,723,1190,490,680,467,190,0.9929821
12,2,car,723,1190,492,679,467,187,0.99407345
13,2,car,721,1189,490,680,468,190,0.99229693
14,2,car,720,1190,490,681,470,191,0.9942689
15,2,car,722,1190,491,680,468,189,0.9946975
16,2,car,722,1189,492,679,467,187,0.9933555
17,2,car,719,1191,491,680,472,189,0.99077785
18,2,car,720,1189,492,678,469,186,0.99275035
19,2,car,719,1192,491,680,473,189,0.99213934
20,2,car,724,1188,491,679,464,188,0.9937347
21,2,car,721,1191,490,680,470,190,0.9937846
22,2,car,724,1189,489,681,465,192,0.99227536
23,2,car,721,1191,490,681,470,191,0.99170077
24,2,car,722,1189,492,678,467,186,0.99312747
25,2,car,722,1189,490,680,467,190,0.9928037
26,2,car,722,1191,491,680,469,189,0.9921203
27,2,car,722,1189,490,681,467,191,0.9922209
28,2,car,721,1192,490,681,471,191,0.9930029
29,2,car,721,1191,491,680,470,189,0.99370116
30,2,car,721,1192,491,679,471,188,0.99167436
31,2,car,720,1191,489,681,471,192,0.99269456
32,2,car,721,1190,491,680,469,189,0.993381
33,2,car,718,1190,490,681,472,191,0.99364763
34,2,car,722,1193,490,680,471,190,0.99402285
35,2,car,719,1192,490,680,473,190,0.99388003
36,2,car,723,1192,490,680,469,190,0.992976
37,2,car,721,1190,491,680,469,189,0.99315363
38,2,car,721,1190,491,680,469,189,0.9950945
39,2,car,719,1191,490,681,472,191,0.99357724
40,2,car,723,1191,491,680,468,189,0.99360245
41,2,car,721,1190,491,680,469,189,0.99408567
42,2,car,722,1191,490,680,469,190,0.99388546
43,2,car,719,1189,490,681,470,191,0.9933415
44,2,car,721,1189,490,681,468,191,0.99309224
45,2,car,720,1189,490,680,469,190,0.9933535
46,2,car,721,1189,490,680,468,190,0.99278355
47,2,car,722,1191,491,679,469,188,0.99334544
48,2,car,721,1189,491,679,468,188,0.9922223
49,2,car,721,1192,491,679,471,188,0.99353355
50,2,car,721,1190,491,680,469,189,0.9941834
51,2,car,721,1192,490,680,471,190,0.9927697
52,2,car,723,1187,491,680,464,189,0.9929273
53,2,car,720,1192,491,680,472,189,0.9943153
54,2,car,721,1190,490,680,469,190,0.9937749
55,2,car,721,1189,491,680,468,189,0.9938193
56,2,car,721,1193,490,681,472,191,0.9946054
57,2,car,721,1190,490,681,469,191,0.99308574
58,2,car,721,1191,490,680,470,190,0.99485815
59,2,car,719,1191,490,680,472,190,0.99378115
60,2,car,719,1192,490,681,473,191,0.994926
61,2,car,722,1192,490,680,470,190,0.9945114
62,2,car,722,1190,490,680,468,190,0.99356544
63,2,car,718,1192,490,680,474,190,0.99396724
64,2,car,720,1192,491,680,472,189,0.99402833
65,2,car,720,1188,490,681,468,191,0.9936452
66,2,car,722,1188,490,681,466,191,0.9941867
67,2,car,722,1189,490,681,467,191,0.99316216
68,2,car,721,1191,490,681,470,191,0.9934978
69,2,car,722,1192,491,679,470,188,0.9947086
70,2,car,719,1191,490,680,472,190,0.99448395
71,2,car,721,1190,490,681,469,191,0.9950352
72,2,car,718,1192,491,680,474,189,0.9946807
73,2,car,720,1190,491,680,470,189,0.9939705
74,2,car,721,1189,490,680,468,190,0.99420947
75,2,car,721,1188,491,679,467,188,0.9941135
76,2,car,720,1190,491,680,470,189,0.99439865
77,2,car,721,1190,490,680,469,190,0.9935835
78,2,car,720,1190,490,680,470,190,0.99316007
79,2,car,720,1190,490,680,470,190,0.99366015
80,2,car,723,1188,491,680,465,189,0.9940172
81,2,car,723,1190,491,680,467,189,0.9925984
82,2,car,720,1189,491,679,469,188,0.99389535
83,2,car,720,1192,491,680,472,189,0.9947525
84,2,car,720,1189,490,681,469,191,0.99338204
85,2,car,723,1190,490,680,467,190,0.993658
86,2,car,722,1191,490,681,469,191,0.9944046
87,2,car,723,1189,491,680,466,189,0.9941147
88,2,car,592,912,482,651,320,169,0.9904916
89,2,car,593,912,482,651,319,169,0.99101853
90,2,car,591,911,482,650,320,168,0.99045604
0,2,car,722,1190,490,681,468,191,0.9937917
1,2,car,721,1188,491,679,467,188,0.9926908
2,2,car,721,1190,490,681,469,191,0.9932829
3,2,car,721,1190,491,680,469,189,0.9928404
4,2,car,721,1191,491,680,470,189,0.9943646
5,2,car,723,1189,491,680,466,189,0.9942534
6,2,car,720,1191,490,681,471,191,0.9926691
7,2,car,721,1191,491,680,470,189,0.9923738
8,2,car,721,1187,492,679,466,187,0.99343777
9,2,car,721,1190,491,680,469,189,0.9931046
10,2,car,722,1188,492,679,466,187,0.9910961
11,2,car,721,1192,491,680,471,189,0.9921725
12,2,car,723,1190,490,680,467,190,0.9929821
13,2,car,723,1190,492,679,467,187,0.99407345
14,2,car,721,1189,490,680,468,190,0.99229693
15,2,car,720,1190,490,681,470,191,0.9942689
16,2,car,722,1190,491,680,468,189,0.9946975
17,2,car,722,1189,492,679,467,187,0.9933555
18,2,car,719,1191,491,680,472,189,0.99077785
19,2,car,720,1189,492,678,469,186,0.99275035
20,2,car,719,1192,491,680,473,189,0.99213934
21,2,car,724,1188,491,679,464,188,0.9937347
22,2,car,721,1191,490,680,470,190,0.9937846
23,2,car,724,1189,489,681,465,192,0.99227536
24,2,car,721,1191,490,681,470,191,0.99170077
25,2,car,722,1189,492,678,467,186,0.99312747
26,2,car,722,1189,490,680,467,190,0.9928037
27,2,car,722,1191,491,680,469,189,0.9921203
28,2,car,722,1189,490,681,467,191,0.9922209
29,2,car,721,1192,490,681,471,191,0.9930029
30,2,car,721,1191,491,680,470,189,0.99370116
31,2,car,721,1192,491,679,471,188,0.99167436
32,2,car,720,1191,489,681,471,192,0.99269456
33,2,car,721,1190,491,680,469,189,0.993381
34,2,car,718,1190,490,681,472,191,0.99364763
35,2,car,722,1193,490,680,471,190,0.99402285
36,2,car,719,1192,490,680,473,190,0.99388003
37,2,car,723,1192,490,680,469,190,0.992976
38,2,car,721,1190,491,680,469,189,0.99315363
39,2,car,721,1190,491,680,469,189,0.9950945
40,2,car,719,1191,490,681,472,191,0.99357724
41,2,car,723,1191,491,680,468,189,0.99360245
42,2,car,721,1190,491,680,469,189,0.99408567
43,2,car,722,1191,490,680,469,190,0.99388546
44,2,car,719,1189,490,681,470,191,0.9933415
45,2,car,721,1189,490,681,468,191,0.99309224
46,2,car,720,1189,490,680,469,190,0.9933535
47,2,car,721,1189,490,680,468,190,0.99278355
48,2,car,722,1191,491,679,469,188,0.99334544
49,2,car,721,1189,491,679,468,188,0.9922223
50,2,car,721,1192,491,679,471,188,0.99353355
51,2,car,721,1190,491,680,469,189,0.9941834
52,2,car,721,1192,490,680,471,190,0.9927697
53,2,car,723,1187,491,680,464,189,0.9929273
54,2,car,720,1192,491,680,472,189,0.9943153
55,2,car,721,1190,490,680,469,190,0.9937749
56,2,car,721,1189,491,680,468,189,0.9938193
57,2,car,721,1193,490,681,472,191,0.9946054
58,2,car,721,1190,490,681,469,191,0.99308574
59,2,car,721,1191,490,680,470,190,0.99485815
60,2,car,719,1191,490,680,472,190,0.99378115
61,2,car,719,1192,490,681,473,191,0.994926
62,2,car,722,1192,490,680,470,190,0.9945114
63,2,car,722,1190,490,680,468,190,0.99356544
64,2,car,718,1192,490,680,474,190,0.99396724
65,2,car,720,1192,491,680,472,189,0.99402833
66,2,car,720,1188,490,681,468,191,0.9936452
67,2,car,722,1188,490,681,466,191,0.9941867
68,2,car,722,1189,490,681,467,191,0.99316216
69,2,car,721,1191,490,681,470,191,0.9934978
70,2,car,722,1192,491,679,470,188,0.9947086
71,2,car,719,1191,490,680,472,190,0.99448395
72,2,car,721,1190,490,681,469,191,0.9950352
73,2,car,718,1192,491,680,474,189,0.9946807
74,2,car,720,1190,491,680,470,189,0.9939705
75,2,car,721,1189,490,680,468,190,0.99420947
76,2,car,721,1188,491,679,467,188,0.9941135
77,2,car,720,1190,491,680,470,189,0.99439865
78,2,car,721,1190,490,680,469,190,0.9935835
79,2,car,720,1190,490,680,470,190,0.99316007
80,2,car,720,1190,490,680,470,190,0.99366015
81,2,car,723,1188,491,680,465,189,0.9940172
82,2,car,723,1190,491,680,467,189,0.9925984
83,2,car,720,1189,491,679,469,188,0.99389535
84,2,car,720,1192,491,680,472,189,0.9947525
85,2,car,720,1189,490,681,469,191,0.99338204
86,2,car,723,1190,490,680,467,190,0.993658
87,2,car,722,1191,490,681,469,191,0.9944046
88,2,car,723,1189,491,680,466,189,0.9941147
89,2,car,592,912,482,651,320,169,0.9904916
90,2,car,593,912,482,651,319,169,0.99101853
91,2,car,591,911,482,650,320,168,0.99045604
0,2,car,722,1189,490,680,467,190,0.99385345
1,2,car,722,1190,490,681,468,191,0.9937917
2,2,car,721,1188,491,679,467,188,0.9926908
3,2,car,721,1190,490,681,469,191,0.9932829
4,2,car,721,1190,491,680,469,189,0.9928404
5,2,car,721,1191,491,680,470,189,0.9943646
6,2,car,723,1189,491,680,466,189,0.9942534
7,2,car,720,1191,490,681,471,191,0.9926691
8,2,car,721,1191,491,680,470,189,0.9923738
9,2,car,721,1187,492,679,466,187,0.99343777
10,2,car,721,1190,491,680,469,189,0.9931046
11,2,car,722,1188,492,679,466,187,0.9910961
12,2,car,721,1192,491,680,471,189,0.9921725
13,2,car,723,1190,490,680,467,190,0.9929821
14,2,car,723,1190,492,679,467,187,0.99407345
15,2,car,721,1189,490,680,468,190,0.99229693
16,2,car,720,1190,490,681,470,191,0.9942689
17,2,car,722,1190,491,680,468,189,0.9946975
18,2,car,722,1189,492,679,467,187,0.9933555
19,2,car,719,1191,491,680,472,189,0.99077785
20,2,car,720,1189,492,678,469,186,0.99275035
21,2,car,719,1192,491,680,473,189,0.99213934
22,2,car,724,1188,491,679,464,188,0.9937347
23,2,car,721,1191,490,680,470,190,0.9937846
24,2,car,724,1189,489,681,465,192,0.99227536
25,2,car,721,1191,490,681,470,191,0.99170077
26,2,car,722,1189,492,678,467,186,0.99312747
27,2,car,722,1189,490,680,467,190,0.9928037
28,2,car,722,1191,491,680,469,189,0.9921203
29,2,car,722,1189,490,681,467,191,0.9922209
30,2,car,721,1192,490,681,471,191,0.9930029
31,2,car,721,1191,491,680,470,189,0.99370116
32,2,car,721,1192,491,679,471,188,0.99167436
33,2,car,720,1191,489,681,471,192,0.99269456
34,2,car,721,1190,491,680,469,189,0.993381
35,2,car,718,1190,490,681,472,191,0.99364763
36,2,car,722,1193,490,680,471,190,0.99402285
37,2,car,719,1192,490,680,473,190,0.99388003
38,2,car,723,1192,490,680,469,190,0.992976
39,2,car,721,1190,491,680,469,189,0.99315363
40,2,car,721,1190,491,680,469,189,0.9950945
41,2,car,719,1191,490,681,472,191,0.99357724
42,2,car,723,1191,491,680,468,189,0.99360245
43,2,car,721,1190,491,680,469,189,0.99408567
44,2,car,722,1191,490,680,469,190,0.99388546
45,2,car,719,1189,490,681,470,191,0.9933415
46,2,car,721,1189,490,681,468,191,0.99309224
47,2,car,720,1189,490,680,469,190,0.9933535
48,2,car,721,1189,490,680,468,190,0.99278355
49,2,car,722,1191,491,679,469,188,0.99334544
50,2,car,721,1189,491,679,468,188,0.9922223
51,2,car,721,1192,491,679,471,188,0.99353355
52,2,car,721,1190,491,680,469,189,0.9941834
53,2,car,721,1192,490,680,471,190,0.9927697
54,2,car,723,1187,491,680,464,189,0.9929273
55,2,car,720,1192,491,680,472,189,0.9943153
56,2,car,721,1190,490,680,469,190,0.9937749
57,2,car,721,1189,491,680,468,189,0.9938193
58,2,car,721,1193,490,681,472,191,0.9946054
59,2,car,721,1190,490,681,469,191,0.99308574
60,2,car,721,1191,490,680,470,190,0.99485815
61,2,car,719,1191,490,680,472,190,0.99378115
62,2,car,719,1192,490,681,473,191,0.994926
63,2,car,722,1192,490,680,470,190,0.9945114
64,2,car,722,1190,490,680,468,190,0.99356544
65,2,car,718,1192,490,680,474,190,0.99396724
66,2,car,720,1192,491,680,472,189,0.99402833
67,2,car,720,1188,490,681,468,191,0.9936452
68,2,car,722,1188,490,681,466,191,0.9941867
69,2,car,722,1189,490,681,467,191,0.99316216
70,2,car,721,1191,490,681,470,191,0.9934978
71,2,car,722,1192,491,679,470,188,0.9947086
72,2,car,719,1191,490,680,472,190,0.99448395
73,2,car,721,1190,490,681,469,191,0.9950352
74,2,car,718,1192,491,680,474,189,0.9946807
75,2,car,720,1190,491,680,470,189,0.9939705
76,2,car,721,1189,490,680,468,190,0.99420947
77,2,car,721,1188,491,679,467,188,0.9941135
78,2,car,720,1190,491,680,470,189,0.99439865
79,2,car,721,1190,490,680,469,190,0.9935835
80,2,car,720,1190,490,680,470,190,0.99316007
81,2,car,720,1190,490,680,470,190,0.99366015
82,2,car,723,1188,491,680,465,189,0.9940172
83,2,car,723,1190,491,680,467,189,0.9925984
84,2,car,720,1189,491,679,469,188,0.99389535
85,2,car,720,1192,491,680,472,189,0.9947525
86,2,car,720,1189,490,681,469,191,0.99338204
87,2,car,723,1190,490,680,467,190,0.993658
88,2,car,722,1191,490,681,469,191,0.9944046
89,2,car,723,1189,491,680,466,189,0.9941147
90,2,car,592,912,482,651,320,169,0.9904916
91,2,car,593,912,482,651,319,169,0.99101853
92,2,car,591,911,482,650,320,168,0.99045604
0,2,car,722,1189,490,680,467,190,0.9929243
1,2,car,722,1189,490,680,467,190,0.99385345
2,2,car,722,1190,490,681,468,191,0.9937917
3,2,car,721,1188,491,679,467,188,0.9926908
4,2,car,721,1190,490,681,469,191,0.9932829
5,2,car,721,1190,491,680,469,189,0.9928404
6,2,car,721,1191,491,680,470,189,0.9943646
7,2,car,723,1189,491,680,466,189,0.9942534
8,2,car,720,1191,490,681,471,191,0.9926691
9,2,car,721,1191,491,680,470,189,0.9923738
10,2,car,721,1187,492,679,466,187,0.99343777
11,2,car,721,1190,491,680,469,189,0.9931046
12,2,car,722,1188,492,679,466,187,0.9910961
13,2,car,721,1192,491,680,471,189,0.9921725
14,2,car,723,1190,490,680,467,190,0.9929821
15,2,car,723,1190,492,679,467,187,0.99407345
16,2,car,721,1189,490,680,468,190,0.99229693
17,2,car,720,1190,490,681,470,191,0.9942689
18,2,car,722,1190,491,680,468,189,0.9946975
19,2,car,722,1189,492,679,467,187,0.9933555
20,2,car,719,1191,491,680,472,189,0.99077785
21,2,car,720,1189,492,678,469,186,0.99275035
22,2,car,719,1192,491,680,473,189,0.99213934
23,2,car,724,1188,491,679,464,188,0.9937347
24,2,car,721,1191,490,680,470,190,0.9937846
25,2,car,724,1189,489,681,465,192,0.99227536
26,2,car,721,1191,490,681,470,191,0.99170077
27,2,car,722,1189,492,678,467,186,0.99312747
28,2,car,722,1189,490,680,467,190,0.9928037
29,2,car,722,1191,491,680,469,189,0.9921203
30,2,car,722,1189,490,681,467,191,0.9922209
31,2,car,721,1192,490,681,471,191,0.9930029
32,2,car,721,1191,491,680,470,189,0.99370116
33,2,car,721,1192,491,679,471,188,0.99167436
34,2,car,720,1191,489,681,471,192,0.99269456
35,2,car,721,1190,491,680,469,189,0.993381
36,2,car,718,1190,490,681,472,191,0.99364763
37,2,car,722,1193,490,680,471,190,0.99402285
38,2,car,719,1192,490,680,473,190,0.99388003
39,2,car,723,1192,490,680,469,190,0.992976
40,2,car,721,1190,491,680,469,189,0.99315363
41,2,car,721,1190,491,680,469,189,0.9950945
42,2,car,719,1191,490,681,472,191,0.99357724
43,2,car,723,1191,491,680,468,189,0.99360245
44,2,car,721,1190,491,680,469,189,0.99408567
45,2,car,722,1191,490,680,469,190,0.99388546
46,2,car,719,1189,490,681,470,191,0.9933415
47,2,car,721,1189,490,681,468,191,0.99309224
48,2,car,720,1189,490,680,469,190,0.9933535
49,2,car,721,1189,490,680,468,190,0.99278355
50,2,car,722,1191,491,679,469,188,0.99334544
51,2,car,721,1189,491,679,468,188,0.9922223
52,2,car,721,1192,491,679,471,188,0.99353355
53,2,car,721,1190,491,680,469,189,0.9941834
54,2,car,721,1192,490,680,471,190,0.9927697
55,2,car,723,1187,491,680,464,189,0.9929273
56,2,car,720,1192,491,680,472,189,0.9943153
57,2,car,721,1190,490,680,469,190,0.9937749
58,2,car,721,1189,491,680,468,189,0.9938193
59,2,car,721,1193,490,681,472,191,0.9946054
60,2,car,721,1190,490,681,469,191,0.99308574
61,2,car,721,1191,490,680,470,190,0.99485815
62,2,car,719,1191,490,680,472,190,0.99378115
63,2,car,719,1192,490,681,473,191,0.994926
64,2,car,722,1192,490,680,470,190,0.9945114
65,2,car,722,1190,490,680,468,190,0.99356544
66,2,car,718,1192,490,680,474,190,0.99396724
67,2,car,720,1192,491,680,472,189,0.99402833
68,2,car,720,1188,490,681,468,191,0.9936452
69,2,car,722,1188,490,681,466,191,0.9941867
70,2,car,722,1189,490,681,467,191,0.99316216
71,2,car,721,1191,490,681,470,191,0.9934978
72,2,car,722,1192,491,679,470,188,0.9947086
73,2,car,719,1191,490,680,472,190,0.99448395
74,2,car,721,1190,490,681,469,191,0.9950352
75,2,car,718,1192,491,680,474,189,0.9946807
76,2,car,720,1190,491,680,470,189,0.9939705
77,2,car,721,1189,490,680,468,190,0.99420947
78,2,car,721,1188,491,679,467,188,0.9941135
79,2,car,720,1190,491,680,470,189,0.99439865
80,2,car,721,1190,490,680,469,190,0.9935835
81,2,car,720,1190,490,680,470,190,0.99316007
82,2,car,720,1190,490,680,470,190,0.99366015
83,2,car,723,1188,491,680,465,189,0.9940172
84,2,car,723,1190,491,680,467,189,0.9925984
85,2,car,720,1189,491,679,469,188,0.99389535
86,2,car,720,1192,491,680,472,189,0.9947525
87,2,car,720,1189,490,681,469,191,0.99338204
88,2,car,723,1190,490,680,467,190,0.993658
89,2,car,722,1191,490,681,469,191,0.9944046
90,2,car,723,1189,491,680,466,189,0.9941147
91,2,car,592,912,482,651,320,169,0.9904916
92,2,car,593,912,482,651,319,169,0.99101853
93,2,car,591,911,482,650,320,168,0.99045604
0,2,car,720,1188,491,680,468,189,0.9942964
1,2,car,722,1189,490,680,467,190,0.9929243
2,2,car,722,1189,490,680,467,190,0.99385345
3,2,car,722,1190,490,681,468,191,0.9937917
4,2,car,721,1188,491,679,467,188,0.9926908
5,2,car,721,1190,490,681,469,191,0.9932829
6,2,car,721,1190,491,680,469,189,0.9928404
7,2,car,721,1191,491,680,470,189,0.9943646
8,2,car,723,1189,491,680,466,189,0.9942534
9,2,car,720,1191,490,681,471,191,0.9926691
10,2,car,721,1191,491,680,470,189,0.9923738
11,2,car,721,1187,492,679,466,187,0.99343777
12,2,car,721,1190,491,680,469,189,0.9931046
13,2,car,722,1188,492,679,466,187,0.9910961
14,2,car,721,1192,491,680,471,189,0.9921725
15,2,car,723,1190,490,680,467,190,0.9929821
16,2,car,723,1190,492,679,467,187,0.99407345
17,2,car,721,1189,490,680,468,190,0.99229693
18,2,car,720,1190,490,681,470,191,0.9942689
19,2,car,722,1190,491,680,468,189,0.9946975
20,2,car,722,1189,492,679,467,187,0.9933555
21,2,car,719,1191,491,680,472,189,0.99077785
22,2,car,720,1189,492,678,469,186,0.99275035
23,2,car,719,1192,491,680,473,189,0.99213934
24,2,car,724,1188,491,679,464,188,0.9937347
25,2,car,721,1191,490,680,470,190,0.9937846
26,2,car,724,1189,489,681,465,192,0.99227536
27,2,car,721,1191,490,681,470,191,0.99170077
28,2,car,722,1189,492,678,467,186,0.99312747
29,2,car,722,1189,490,680,467,190,0.9928037
30,2,car,722,1191,491,680,469,189,0.9921203
31,2,car,722,1189,490,681,467,191,0.9922209
32,2,car,721,1192,490,681,471,191,0.9930029
33,2,car,721,1191,491,680,470,189,0.99370116
34,2,car,721,1192,491,679,471,188,0.99167436
35,2,car,720,1191,489,681,471,192,0.99269456
36,2,car,721,1190,491,680,469,189,0.993381
37,2,car,718,1190,490,681,472,191,0.99364763
38,2,car,722,1193,490,680,471,190,0.99402285
39,2,car,719,1192,490,680,473,190,0.99388003
40,2,car,723,1192,490,680,469,190,0.992976
41,2,car,721,1190,491,680,469,189,0.99315363
42,2,car,721,1190,491,680,469,189,0.9950945
43,2,car,719,1191,490,681,472,191,0.99357724
44,2,car,723,1191,491,680,468,189,0.99360245
45,2,car,721,1190,491,680,469,189,0.99408567
46,2,car,722,1191,490,680,469,190,0.99388546
47,2,car,719,1189,490,681,470,191,0.9933415
48,2,car,721,1189,490,681,468,191,0.99309224
49,2,car,720,1189,490,680,469,190,0.9933535
50,2,car,721,1189,490,680,468,190,0.99278355
51,2,car,722,1191,491,679,469,188,0.99334544
52,2,car,721,1189,491,679,468,188,0.9922223
53,2,car,721,1192,491,679,471,188,0.99353355
54,2,car,721,1190,491,680,469,189,0.9941834
55,2,car,721,1192,490,680,471,190,0.9927697
56,2,car,723,1187,491,680,464,189,0.9929273
57,2,car,720,1192,491,680,472,189,0.9943153
58,2,car,721,1190,490,680,469,190,0.9937749
59,2,car,721,1189,491,680,468,189,0.9938193
60,2,car,721,1193,490,681,472,191,0.9946054
61,2,car,721,1190,490,681,469,191,0.99308574
62,2,car,721,1191,490,680,470,190,0.99485815
63,2,car,719,1191,490,680,472,190,0.99378115
64,2,car,719,1192,490,681,473,191,0.994926
65,2,car,722,1192,490,680,470,190,0.9945114
66,2,car,722,1190,490,680,468,190,0.99356544
67,2,car,718,1192,490,680,474,190,0.99396724
68,2,car,720,1192,491,680,472,189,0.99402833
69,2,car,720,1188,490,681,468,191,0.9936452
70,2,car,722,1188,490,681,466,191,0.9941867
71,2,car,722,1189,490,681,467,191,0.99316216
72,2,car,721,1191,490,681,470,191,0.9934978
73,2,car,722,1192,491,679,470,188,0.9947086
74,2,car,719,1191,490,680,472,190,0.99448395
75,2,car,721,1190,490,681,469,191,0.9950352
76,2,car,718,1192,491,680,474,189,0.9946807
77,2,car,720,1190,491,680,470,189,0.9939705
78,2,car,721,1189,490,680,468,190,0.99420947
79,2,car,721,1188,491,679,467,188,0.9941135
80,2,car,720,1190,491,680,470,189,0.99439865
81,2,car,721,1190,490,680,469,190,0.9935835
82,2,car,720,1190,490,680,470,190,0.99316007
83,2,car,720,1190,490,680,470,190,0.99366015
84,2,car,723,1188,491,680,465,189,0.9940172
85,2,car,723,1190,491,680,467,189,0.9925984
86,2,car,720,1189,491,679,469,188,0.99389535
87,2,car,720,1192,491,680,472,189,0.9947525
88,2,car,720,1189,490,681,469,191,0.99338204
89,2,car,723,1190,490,680,467,190,0.993658
90,2,car,722,1191,490,681,469,191,0.9944046
91,2,car,723,1189,491,680,466,189,0.9941147
92,2,car,592,912,482,651,320,169,0.9904916
93,2,car,593,912,482,651,319,169,0.99101853
94,2,car,591,911,482,650,320,168,0.99045604
0,2,car,722,1189,491,679,467,188,0.99210006
1,2,car,720,1188,491,680,468,189,0.9942964
2,2,car,722,1189,490,680,467,190,0.9929243
3,2,car,722,1189,490,680,467,190,0.99385345
4,2,car,722,1190,490,681,468,191,0.9937917
5,2,car,721,1188,491,679,467,188,0.9926908
6,2,car,721,1190,490,681,469,191,0.9932829
7,2,car,721,1190,491,680,469,189,0.9928404
8,2,car,721,1191,491,680,470,189,0.9943646
9,2,car,723,1189,491,680,466,189,0.9942534
10,2,car,720,1191,490,681,471,191,0.9926691
11,2,car,721,1191,491,680,470,189,0.9923738
12,2,car,721,1187,492,679,466,187,0.99343777
13,2,car,721,1190,491,680,469,189,0.9931046
14,2,car,722,1188,492,679,466,187,0.9910961
15,2,car,721,1192,491,680,471,189,0.9921725
16,2,car,723,1190,490,680,467,190,0.9929821
17,2,car,723,1190,492,679,467,187,0.99407345
18,2,car,721,1189,490,680,468,190,0.99229693
19,2,car,720,1190,490,681,470,191,0.9942689
20,2,car,722,1190,491,680,468,189,0.9946975
21,2,car,722,1189,492,679,467,187,0.9933555
22,2,car,719,1191,491,680,472,189,0.99077785
23,2,car,720,1189,492,678,469,186,0.99275035
24,2,car,719,1192,491,680,473,189,0.99213934
25,2,car,724,1188,491,679,464,188,0.9937347
26,2,car,721,1191,490,680,470,190,0.9937846
27,2,car,724,1189,489,681,465,192,0.99227536
28,2,car,721,1191,490,681,470,191,0.99170077
29,2,car,722,1189,492,678,467,186,0.99312747
30,2,car,722,1189,490,680,467,190,0.9928037
31,2,car,722,1191,491,680,469,189,0.9921203
32,2,car,722,1189,490,681,467,191,0.9922209
33,2,car,721,1192,490,681,471,191,0.9930029
34,2,car,721,1191,491,680,470,189,0.99370116
35,2,car,721,1192,491,679,471,188,0.99167436
36,2,car,720,1191,489,681,471,192,0.99269456
37,2,car,721,1190,491,680,469,189,0.993381
38,2,car,718,1190,490,681,472,191,0.99364763
39,2,car,722,1193,490,680,471,190,0.99402285
40,2,car,719,1192,490,680,473,190,0.99388003
41,2,car,723,1192,490,680,469,190,0.992976
42,2,car,721,1190,491,680,469,189,0.99315363
43,2,car,721,1190,491,680,469,189,0.9950945
44,2,car,719,1191,490,681,472,191,0.99357724
45,2,car,723,1191,491,680,468,189,0.99360245
46,2,car,721,1190,491,680,469,189,0.99408567
47,2,car,722,1191,490,680,469,190,0.99388546
48,2,car,719,1189,490,681,470,191,0.9933415
49,2,car,721,1189,490,681,468,191,0.99309224
50,2,car,720,1189,490,680,469,190,0.9933535
51,2,car,721,1189,490,680,468,190,0.99278355
52,2,car,722,1191,491,679,469,188,0.99334544
53,2,car,721,1189,491,679,468,188,0.9922223
54,2,car,721,1192,491,679,471,188,0.99353355
55,2,car,721,1190,491,680,469,189,0.9941834
56,2,car,721,1192,490,680,471,190,0.9927697
57,2,car,723,1187,491,680,464,189,0.9929273
58,2,car,720,1192,491,680,472,189,0.9943153
59,2,car,721,1190,490,680,469,190,0.9937749
60,2,car,721,1189,491,680,468,189,0.9938193
61,2,car,721,1193,490,681,472,191,0.9946054
62,2,car,721,1190,490,681,469,191,0.99308574
63,2,car,721,1191,490,680,470,190,0.99485815
64,2,car,719,1191,490,680,472,190,0.99378115
65,2,car,719,1192,490,681,473,191,0.994926
66,2,car,722,1192,490,680,470,190,0.9945114
67,2,car,722,1190,490,680,468,190,0.99356544
68,2,car,718,1192,490,680,474,190,0.99396724
69,2,car,720,1192,491,680,472,189,0.99402833
70,2,car,720,1188,490,681,468,191,0.9936452
71,2,car,722,1188,490,681,466,191,0.9941867
72,2,car,722,1189,490,681,467,191,0.99316216
73,2,car,721,1191,490,681,470,191,0.9934978
74,2,car,722,1192,491,679,470,188,0.9947086
75,2,car,719,1191,490,680,472,190,0.99448395
76,2,car,721,1190,490,681,469,191,0.9950352
77,2,car,718,1192,491,680,474,189,0.9946807
78,2,car,720,1190,491,680,470,189,0.9939705
79,2,car,721,1189,490,680,468,190,0.99420947
80,2,car,721,1188,491,679,467,188,0.9941135
81,2,car,720,1190,491,680,470,189,0.99439865
82,2,car,721,1190,490,680,469,190,0.9935835
83,2,car,720,1190,490,680,470,190,0.99316007
84,2,car,720,1190,490,680,470,190,0.99366015
85,2,car,723,1188,491,680,465,189,0.9940172
86,2,car,723,1190,491,680,467,189,0.9925984
87,2,car,720,1189,491,679,469,188,0.99389535
88,2,car,720,1192,491,680,472,189,0.9947525
89,2,car,720,1189,490,681,469,191,0.99338204
90,2,car,723,1190,490,680,467,190,0.993658
91,2,car,722,1191,490,681,469,191,0.9944046
92,2,car,723,1189,491,680,466,189,0.9941147
93,2,car,592,912,482,651,320,169,0.9904916
94,2,car,593,912,482,651,319,169,0.99101853
95,2,car,591,911,482,650,320,168,0.99045604
0,2,car,720,1188,490,680,468,190,0.99254847
1,2,car,722,1189,491,679,467,188,0.99210006
2,2,car,720,1188,491,680,468,189,0.9942964
3,2,car,722,1189,490,680,467,190,0.9929243
4,2,car,722,1189,490,680,467,190,0.99385345
5,2,car,722,1190,490,681,468,191,0.9937917
6,2,car,721,1188,491,679,467,188,0.9926908
7,2,car,721,1190,490,681,469,191,0.9932829
8,2,car,721,1190,491,680,469,189,0.9928404
9,2,car,721,1191,491,680,470,189,0.9943646
10,2,car,723,1189,491,680,466,189,0.9942534
11,2,car,720,1191,490,681,471,191,0.9926691
12,2,car,721,1191,491,680,470,189,0.9923738
13,2,car,721,1187,492,679,466,187,0.99343777
14,2,car,721,1190,491,680,469,189,0.9931046
15,2,car,722,1188,492,679,466,187,0.9910961
16,2,car,721,1192,491,680,471,189,0.9921725
17,2,car,723,1190,490,680,467,190,0.9929821
18,2,car,723,1190,492,679,467,187,0.99407345
19,2,car,721,1189,490,680,468,190,0.99229693
20,2,car,720,1190,490,681,470,191,0.9942689
21,2,car,722,1190,491,680,468,189,0.9946975
22,2,car,722,1189,492,679,467,187,0.9933555
23,2,car,719,1191,491,680,472,189,0.99077785
24,2,car,720,1189,492,678,469,186,0.99275035
25,2,car,719,1192,491,680,473,189,0.99213934
26,2,car,724,1188,491,679,464,188,0.9937347
27,2,car,721,1191,490,680,470,190,0.9937846
28,2,car,724,1189,489,681,465,192,0.99227536
29,2,car,721,1191,490,681,470,191,0.99170077
30,2,car,722,1189,492,678,467,186,0.99312747
31,2,car,722,1189,490,680,467,190,0.9928037
32,2,car,722,1191,491,680,469,189,0.9921203
33,2,car,722,1189,490,681,467,191,0.9922209
34,2,car,721,1192,490,681,471,191,0.9930029
35,2,car,721,1191,491,680,470,189,0.99370116
36,2,car,721,1192,491,679,471,188,0.99167436
37,2,car,720,1191,489,681,471,192,0.99269456
38,2,car,721,1190,491,680,469,189,0.993381
39,2,car,718,1190,490,681,472,191,0.99364763
40,2,car,722,1193,490,680,471,190,0.99402285
41,2,car,719,1192,490,680,473,190,0.99388003
42,2,car,723,1192,490,680,469,190,0.992976
43,2,car,721,1190,491,680,469,189,0.99315363
44,2,car,721,1190,491,680,469,189,0.9950945
45,2,car,719,1191,490,681,472,191,0.99357724
46,2,car,723,1191,491,680,468,189,0.99360245
47,2,car,721,1190,491,680,469,189,0.99408567
48,2,car,722,1191,490,680,469,190,0.99388546
49,2,car,719,1189,490,681,470,191,0.9933415
50,2,car,721,1189,490,681,468,191,0.99309224
51,2,car,720,1189,490,680,469,190,0.9933535
52,2,car,721,1189,490,680,468,190,0.99278355
53,2,car,722,1191,491,679,469,188,0.99334544
54,2,car,721,1189,491,679,468,188,0.9922223
55,2,car,721,1192,491,679,471,188,0.99353355
56,2,car,721,1190,491,680,469,189,0.9941834
57,2,car,721,1192,490,680,471,190,0.9927697
58,2,car,723,1187,491,680,464,189,0.9929273
59,2,car,720,1192,491,680,472,189,0.9943153
60,2,car,721,1190,490,680,469,190,0.9937749
61,2,car,721,1189,491,680,468,189,0.9938193
62,2,car,721,1193,490,681,472,191,0.9946054
63,2,car,721,1190,490,681,469,191,0.99308574
64,2,car,721,1191,490,680,470,190,0.99485815
65,2,car,719,1191,490,680,472,190,0.99378115
66,2,car,719,1192,490,681,473,191,0.994926
67,2,car,722,1192,490,680,470,190,0.9945114
68,2,car,722,1190,490,680,468,190,0.99356544
69,2,car,718,1192,490,680,474,190,0.99396724
70,2,car,720,1192,491,680,472,189,0.99402833
71,2,car,720,1188,490,681,468,191,0.9936452
72,2,car,722,1188,490,681,466,191,0.9941867
73,2,car,722,1189,490,681,467,191,0.99316216
74,2,car,721,1191,490,681,470,191,0.9934978
75,2,car,722,1192,491,679,470,188,0.9947086
76,2,car,719,1191,490,680,472,190,0.99448395
77,2,car,721,1190,490,681,469,191,0.9950352
78,2,car,718,1192,491,680,474,189,0.9946807
79,2,car,720,1190,491,680,470,189,0.9939705
80,2,car,721,1189,490,680,468,190,0.99420947
81,2,car,721,1188,491,679,467,188,0.9941135
82,2,car,720,1190,491,680,470,189,0.99439865
83,2,car,721,1190,490,680,469,190,0.9935835
84,2,car,720,1190,490,680,470,190,0.99316007
85,2,car,720,1190,490,680,470,190,0.99366015
86,2,car,723,1188,491,680,465,189,0.9940172
87,2,car,723,1190,491,680,467,189,0.9925984
88,2,car,720,1189,491,679,469,188,0.99389535
89,2,car,720,1192,491,680,472,189,0.9947525
90,2,car,720,1189,490,681,469,191,0.99338204
91,2,car,723,1190,490,680,467,190,0.993658
92,2,car,722,1191,490,681,469,191,0.9944046
93,2,car,723,1189,491,680,466,189,0.9941147
94,2,car,592,912,482,651,320,169,0.9904916
95,2,car,593,912,482,651,319,169,0.99101853
96,2,car,591,911,482,650,320,168,0.99045604
0,2,car,718,1191,490,681,473,191,0.9933079
1,2,car,720,1188,490,680,468,190,0.99254847
2,2,car,722,1189,491,679,467,188,0.99210006
3,2,car,720,1188,491,680,468,189,0.9942964
4,2,car,722,1189,490,680,467,190,0.9929243
5,2,car,722,1189,490,680,467,190,0.99385345
6,2,car,722,1190,490,681,468,191,0.9937917
7,2,car,721,1188,491,679,467,188,0.9926908
8,2,car,721,1190,490,681,469,191,0.9932829
9,2,car,721,1190,491,680,469,189,0.9928404
10,2,car,721,1191,491,680,470,189,0.9943646
11,2,car,723,1189,491,680,466,189,0.9942534
12,2,car,720,1191,490,681,471,191,0.9926691
13,2,car,721,1191,491,680,470,189,0.9923738
14,2,car,721,1187,492,679,466,187,0.99343777
15,2,car,721,1190,491,680,469,189,0.9931046
16,2,car,722,1188,492,679,466,187,0.9910961
17,2,car,721,1192,491,680,471,189,0.9921725
18,2,car,723,1190,490,680,467,190,0.9929821
19,2,car,723,1190,492,679,467,187,0.99407345
20,2,car,721,1189,490,680,468,190,0.99229693
21,2,car,720,1190,490,681,470,191,0.9942689
22,2,car,722,1190,491,680,468,189,0.9946975
23,2,car,722,1189,492,679,467,187,0.9933555
24,2,car,719,1191,491,680,472,189,0.99077785
25,2,car,720,1189,492,678,469,186,0.99275035
26,2,car,719,1192,491,680,473,189,0.99213934
27,2,car,724,1188,491,679,464,188,0.9937347
28,2,car,721,1191,490,680,470,190,0.9937846
29,2,car,724,1189,489,681,465,192,0.99227536
30,2,car,721,1191,490,681,470,191,0.99170077
31,2,car,722,1189,492,678,467,186,0.99312747
32,2,car,722,1189,490,680,467,190,0.9928037
33,2,car,722,1191,491,680,469,189,0.9921203
34,2,car,722,1189,490,681,467,191,0.9922209
35,2,car,721,1192,490,681,471,191,0.9930029
36,2,car,721,1191,491,680,470,189,0.99370116
37,2,car,721,1192,491,679,471,188,0.99167436
38,2,car,720,1191,489,681,471,192,0.99269456
39,2,car,721,1190,491,680,469,189,0.993381
40,2,car,718,1190,490,681,472,191,0.99364763
41,2,car,722,1193,490,680,471,190,0.99402285
42,2,car,719,1192,490,680,473,190,0.99388003
43,2,car,723,1192,490,680,469,190,0.992976
44,2,car,721,1190,491,680,469,189,0.99315363
45,2,car,721,1190,491,680,469,189,0.9950945
46,2,car,719,1191,490,681,472,191,0.99357724
47,2,car,723,1191,491,680,468,189,0.99360245
48,2,car,721,1190,491,680,469,189,0.99408567
49,2,car,722,1191,490,680,469,190,0.99388546
50,2,car,719,1189,490,681,470,191,0.9933415
51,2,car,721,1189,490,681,468,191,0.99309224
52,2,car,720,1189,490,680,469,190,0.9933535
53,2,car,721,1189,490,680,468,190,0.99278355
54,2,car,722,1191,491,679,469,188,0.99334544
55,2,car,721,1189,491,679,468,188,0.9922223
56,2,car,721,1192,491,679,471,188,0.99353355
57,2,car,721,1190,491,680,469,189,0.9941834
58,2,car,721,1192,490,680,471,190,0.9927697
59,2,car,723,1187,491,680,464,189,0.9929273
60,2,car,720,1192,491,680,472,189,0.9943153
61,2,car,721,1190,490,680,469,190,0.9937749
62,2,car,721,1189,491,680,468,189,0.9938193
63,2,car,721,1193,490,681,472,191,0.9946054
64,2,car,721,1190,490,681,469,191,0.99308574
65,2,car,721,1191,490,680,470,190,0.99485815
66,2,car,719,1191,490,680,472,190,0.99378115
67,2,car,719,1192,490,681,473,191,0.994926
68,2,car,722,1192,490,680,470,190,0.9945114
69,2,car,722,1190,490,680,468,190,0.99356544
70,2,car,718,1192,490,680,474,190,0.99396724
71,2,car,720,1192,491,680,472,189,0.99402833
72,2,car,720,1188,490,681,468,191,0.9936452
73,2,car,722,1188,490,681,466,191,0.9941867
74,2,car,722,1189,490,681,467,191,0.99316216
75,2,car,721,1191,490,681,470,191,0.9934978
76,2,car,722,1192,491,679,470,188,0.9947086
77,2,car,719,1191,490,680,472,190,0.99448395
78,2,car,721,1190,490,681,469,191,0.9950352
79,2,car,718,1192,491,680,474,189,0.9946807
80,2,car,720,1190,491,680,470,189,0.9939705
81,2,car,721,1189,490,680,468,190,0.99420947
82,2,car,721,1188,491,679,467,188,0.9941135
83,2,car,720,1190,491,680,470,189,0.99439865
84,2,car,721,1190,490,680,469,190,0.9935835
85,2,car,720,1190,490,680,470,190,0.99316007
86,2,car,720,1190,490,680,470,190,0.99366015
87,2,car,723,1188,491,680,465,189,0.9940172
88,2,car,723,1190,491,680,467,189,0.9925984
89,2,car,720,1189,491,679,469,188,0.99389535
90,2,car,720,1192,491,680,472,189,0.9947525
91,2,car,720,1189,490,681,469,191,0.99338204
92,2,car,723,1190,490,680,467,190,0.993658
93,2,car,722,1191,490,681,469,191,0.9944046
94,2,car,723,1189,491,680,466,189,0.9941147
95,2,car,592,912,482,651,320,169,0.9904916
96,2,car,593,912,482,651,319,169,0.99101853
97,2,car,591,911,482,650,320,168,0.99045604
0,2,car,719,1191,491,679,472,188,0.99300593
1,2,car,718,1191,490,681,473,191,0.9933079
2,2,car,720,1188,490,680,468,190,0.99254847
3,2,car,722,1189,491,679,467,188,0.99210006
4,2,car,720,1188,491,680,468,189,0.9942964
5,2,car,722,1189,490,680,467,190,0.9929243
6,2,car,722,1189,490,680,467,190,0.99385345
7,2,car,722,1190,490,681,468,191,0.9937917
8,2,car,721,1188,491,679,467,188,0.9926908
9,2,car,721,1190,490,681,469,191,0.9932829
10,2,car,721,1190,491,680,469,189,0.9928404
11,2,car,721,1191,491,680,470,189,0.9943646
12,2,car,723,1189,491,680,466,189,0.9942534
13,2,car,720,1191,490,681,471,191,0.9926691
14,2,car,721,1191,491,680,470,189,0.9923738
15,2,car,721,1187,492,679,466,187,0.99343777
16,2,car,721,1190,491,680,469,189,0.9931046
17,2,car,722,1188,492,679,466,187,0.9910961
18,2,car,721,1192,491,680,471,189,0.9921725
19,2,car,723,1190,490,680,467,190,0.9929821
20,2,car,723,1190,492,679,467,187,0.99407345
21,2,car,721,1189,490,680,468,190,0.99229693
22,2,car,720,1190,490,681,470,191,0.9942689
23,2,car,722,1190,491,680,468,189,0.9946975
24,2,car,722,1189,492,679,467,187,0.9933555
25,2,car,719,1191,491,680,472,189,0.99077785
26,2,car,720,1189,492,678,469,186,0.99275035
27,2,car,719,1192,491,680,473,189,0.99213934
28,2,car,724,1188,491,679,464,188,0.9937347
29,2,car,721,1191,490,680,470,190,0.9937846
30,2,car,724,1189,489,681,465,192,0.99227536
31,2,car,721,1191,490,681,470,191,0.99170077
32,2,car,722,1189,492,678,467,186,0.99312747
33,2,car,722,1189,490,680,467,190,0.9928037
34,2,car,722,1191,491,680,469,189,0.9921203
35,2,car,722,1189,490,681,467,191,0.9922209
36,2,car,721,1192,490,681,471,191,0.9930029
37,2,car,721,1191,491,680,470,189,0.99370116
38,2,car,721,1192,491,679,471,188,0.99167436
39,2,car,720,1191,489,681,471,192,0.99269456
40,2,car,721,1190,491,680,469,189,0.993381
41,2,car,718,1190,490,681,472,191,0.99364763
42,2,car,722,1193,490,680,471,190,0.99402285
43,2,car,719,1192,490,680,473,190,0.99388003
44,2,car,723,1192,490,680,469,190,0.992976
45,2,car,721,1190,491,680,469,189,0.99315363
46,2,car,721,1190,491,680,469,189,0.9950945
47,2,car,719,1191,490,681,472,191,0.99357724
48,2,car,723,1191,491,680,468,189,0.99360245
49,2,car,721,1190,491,680,469,189,0.99408567
50,2,car,722,1191,490,680,469,190,0.99388546
51,2,car,719,1189,490,681,470,191,0.9933415
52,2,car,721,1189,490,681,468,191,0.99309224
53,2,car,720,1189,490,680,469,190,0.9933535
54,2,car,721,1189,490,680,468,190,0.99278355
55,2,car,722,1191,491,679,469,188,0.99334544
56,2,car,721,1189,491,679,468,188,0.9922223
57,2,car,721,1192,491,679,471,188,0.99353355
58,2,car,721,1190,491,680,469,189,0.9941834
59,2,car,721,1192,490,680,471,190,0.9927697
60,2,car,723,1187,491,680,464,189,0.9929273
61,2,car,720,1192,491,680,472,189,0.9943153
62,2,car,721,1190,490,680,469,190,0.9937749
63,2,car,721,1189,491,680,468,189,0.9938193
64,2,car,721,1193,490,681,472,191,0.9946054
65,2,car,721,1190,490,681,469,191,0.99308574
66,2,car,721,1191,490,680,470,190,0.99485815
67,2,car,719,1191,490,680,472,190,0.99378115
68,2,car,719,1192,490,681,473,191,0.994926
69,2,car,722,1192,490,680,470,190,0.9945114
70,2,car,722,1190,490,680,468,190,0.99356544
71,2,car,718,1192,490,680,474,190,0.99396724
72,2,car,720,1192,491,680,472,189,0.99402833
73,2,car,720,1188,490,681,468,191,0.9936452
74,2,car,722,1188,490,681,466,191,0.9941867
75,2,car,722,1189,490,681,467,191,0.99316216
76,2,car,721,1191,490,681,470,191,0.9934978
77,2,car,722,1192,491,679,470,188,0.9947086
78,2,car,719,1191,490,680,472,190,0.99448395
79,2,car,721,1190,490,681,469,191,0.9950352
80,2,car,718,1192,491,680,474,189,0.9946807
81,2,car,720,1190,491,680,470,189,0.9939705
82,2,car,721,1189,490,680,468,190,0.99420947
83,2,car,721,1188,491,679,467,188,0.9941135
84,2,car,720,1190,491,680,470,189,0.99439865
85,2,car,721,1190,490,680,469,190,0.9935835
86,2,car,720,1190,490,680,470,190,0.99316007
87,2,car,720,1190,490,680,470,190,0.99366015
88,2,car,723,1188,491,680,465,189,0.9940172
89,2,car,723,1190,491,680,467,189,0.9925984
90,2,car,720,1189,491,679,469,188,0.99389535
91,2,car,720,1192,491,680,472,189,0.9947525
92,2,car,720,1189,490,681,469,191,0.99338204
93,2,car,723,1190,490,680,467,190,0.993658
94,2,car,722,1191,490,681,469,191,0.9944046
95,2,car,723,1189,491,680,466,189,0.9941147
96,2,car,592,912,482,651,320,169,0.9904916
97,2,car,593,912,482,651,319,169,0.99101853
98,2,car,591,911,482,650,320,168,0.99045604
0,2,car,723,1189,490,680,466,190,0.9946215
1,2,car,719,1191,491,679,472,188,0.99300593
2,2,car,718,1191,490,681,473,191,0.9933079
3,2,car,720,1188,490,680,468,190,0.99254847
4,2,car,722,1189,491,679,467,188,0.99210006
5,2,car,720,1188,491,680,468,189,0.9942964
6,2,car,722,1189,490,680,467,190,0.9929243
7,2,car,722,1189,490,680,467,190,0.99385345
8,2,car,722,1190,490,681,468,191,0.9937917
9,2,car,721,1188,491,679,467,188,0.9926908
10,2,car,721,1190,490,681,469,191,0.9932829
11,2,car,721,1190,491,680,469,189,0.9928404
12,2,car,721,1191,491,680,470,189,0.9943646
13,2,car,723,1189,491,680,466,189,0.9942534
14,2,car,720,1191,490,681,471,191,0.9926691
15,2,car,721,1191,491,680,470,189,0.9923738
16,2,car,721,1187,492,679,466,187,0.99343777
17,2,car,721,1190,491,680,469,189,0.9931046
18,2,car,722,1188,492,679,466,187,0.9910961
19,2,car,721,1192,491,680,471,189,0.9921725
20,2,car,723,1190,490,680,467,190,0.9929821
21,2,car,723,1190,492,679,467,187,0.99407345
22,2,car,721,1189,490,680,468,190,0.99229693
23,2,car,720,1190,490,681,470,191,0.9942689
24,2,car,722,1190,491,680,468,189,0.9946975
25,2,car,722,1189,492,679,467,187,0.9933555
26,2,car,719,1191,491,680,472,189,0.99077785
27,2,car,720,1189,492,678,469,186,0.99275035
28,2,car,719,1192,491,680,473,189,0.99213934
29,2,car,724,1188,491,679,464,188,0.9937347
30,2,car,721,1191,490,680,470,190,0.9937846
31,2,car,724,1189,489,681,465,192,0.99227536
32,2,car,721,1191,490,681,470,191,0.99170077
33,2,car,722,1189,492,678,467,186,0.99312747
34,2,car,722,1189,490,680,467,190,0.9928037
35,2,car,722,1191,491,680,469,189,0.9921203
36,2,car,722,1189,490,681,467,191,0.9922209
37,2,car,721,1192,490,681,471,191,0.9930029
38,2,car,721,1191,491,680,470,189,0.99370116
39,2,car,721,1192,491,679,471,188,0.99167436
40,2,car,720,1191,489,681,471,192,0.99269456
41,2,car,721,1190,491,680,469,189,0.993381
42,2,car,718,1190,490,681,472,191,0.99364763
43,2,car,722,1193,490,680,471,190,0.99402285
44,2,car,719,1192,490,680,473,190,0.99388003
45,2,car,723,1192,490,680,469,190,0.992976
46,2,car,721,1190,491,680,469,189,0.99315363
47,2,car,721,1190,491,680,469,189,0.9950945
48,2,car,719,1191,490,681,472,191,0.99357724
49,2,car,723,1191,491,680,468,189,0.99360245
50,2,car,721,1190,491,680,469,189,0.99408567
51,2,car,722,1191,490,680,469,190,0.99388546
52,2,car,719,1189,490,681,470,191,0.9933415
53,2,car,721,1189,490,681,468,191,0.99309224
54,2,car,720,1189,490,680,469,190,0.9933535
55,2,car,721,1189,490,680,468,190,0.99278355
56,2,car,722,1191,491,679,469,188,0.99334544
57,2,car,721,1189,491,679,468,188,0.9922223
58,2,car,721,1192,491,679,471,188,0.99353355
59,2,car,721,1190,491,680,469,189,0.9941834
60,2,car,721,1192,490,680,471,190,0.9927697
61,2,car,723,1187,491,680,464,189,0.9929273
62,2,car,720,1192,491,680,472,189,0.9943153
63,2,car,721,1190,490,680,469,190,0.9937749
64,2,car,721,1189,491,680,468,189,0.9938193
65,2,car,721,1193,490,681,472,191,0.9946054
66,2,car,721,1190,490,681,469,191,0.99308574
67,2,car,721,1191,490,680,470,190,0.99485815
68,2,car,719,1191,490,680,472,190,0.99378115
69,2,car,719,1192,490,681,473,191,0.994926
70,2,car,722,1192,490,680,470,190,0.9945114
71,2,car,722,1190,490,680,468,190,0.99356544
72,2,car,718,1192,490,680,474,190,0.99396724
73,2,car,720,1192,491,680,472,189,0.99402833
74,2,car,720,1188,490,681,468,191,0.9936452
75,2,car,722,1188,490,681,466,191,0.9941867
76,2,car,722,1189,490,681,467,191,0.99316216
77,2,car,721,1191,490,681,470,191,0.9934978
78,2,car,722,1192,491,679,470,188,0.9947086
79,2,car,719,1191,490,680,472,190,0.99448395
80,2,car,721,1190,490,681,469,191,0.9950352
81,2,car,718,1192,491,680,474,189,0.9946807
82,2,car,720,1190,491,680,470,189,0.9939705
83,2,car,721,1189,490,680,468,190,0.99420947
84,2,car,721,1188,491,679,467,188,0.9941135
85,2,car,720,1190,491,680,470,189,0.99439865
86,2,car,721,1190,490,680,469,190,0.9935835
87,2,car,720,1190,490,680,470,190,0.99316007
88,2,car,720,1190,490,680,470,190,0.99366015
89,2,car,723,1188,491,680,465,189,0.9940172
90,2,car,723,1190,491,680,467,189,0.9925984
91,2,car,720,1189,491,679,469,188,0.99389535
92,2,car,720,1192,491,680,472,189,0.9947525
93,2,car,720,1189,490,681,469,191,0.99338204
94,2,car,723,1190,490,680,467,190,0.993658
95,2,car,722,1191,490,681,469,191,0.9944046
96,2,car,723,1189,491,680,466,189,0.9941147
97,2,car,592,912,482,651,320,169,0.9904916
98,2,car,593,912,482,651,319,169,0.99101853
99,2,car,591,911,482,650,320,168,0.99045604
0,2,car,721,1188,490,680,467,190,0.99227583
1,2,car,723,1189,490,680,466,190,0.9946215
2,2,car,719,1191,491,679,472,188,0.99300593
3,2,car,718,1191,490,681,473,191,0.9933079
4,2,car,720,1188,490,680,468,190,0.99254847
5,2,car,722,1189,491,679,467,188,0.99210006
6,2,car,720,1188,491,680,468,189,0.9942964
7,2,car,722,1189,490,680,467,190,0.9929243
8,2,car,722,1189,490,680,467,190,0.99385345
9,2,car,722,1190,490,681,468,191,0.9937917
10,2,car,721,1188,491,679,467,188,0.9926908
11,2,car,721,1190,490,681,469,191,0.9932829
12,2,car,721,1190,491,680,469,189,0.9928404
13,2,car,721,1191,491,680,470,189,0.9943646
14,2,car,723,1189,491,680,466,189,0.9942534
15,2,car,720,1191,490,681,471,191,0.9926691
16,2,car,721,1191,491,680,470,189,0.9923738
17,2,car,721,1187,492,679,466,187,0.99343777
18,2,car,721,1190,491,680,469,189,0.9931046
19,2,car,722,1188,492,679,466,187,0.9910961
20,2,car,721,1192,491,680,471,189,0.9921725
21,2,car,723,1190,490,680,467,190,0.9929821
22,2,car,723,1190,492,679,467,187,0.99407345
23,2,car,721,1189,490,680,468,190,0.99229693
24,2,car,720,1190,490,681,470,191,0.9942689
25,2,car,722,1190,491,680,468,189,0.9946975
26,2,car,722,1189,492,679,467,187,0.9933555
27,2,car,719,1191,491,680,472,189,0.99077785
28,2,car,720,1189,492,678,469,186,0.99275035
29,2,car,719,1192,491,680,473,189,0.99213934
30,2,car,724,1188,491,679,464,188,0.9937347
31,2,car,721,1191,490,680,470,190,0.9937846
32,2,car,724,1189,489,681,465,192,0.99227536
33,2,car,721,1191,490,681,470,191,0.99170077
34,2,car,722,1189,492,678,467,186,0.99312747
35,2,car,722,1189,490,680,467,190,0.9928037
36,2,car,722,1191,491,680,469,189,0.9921203
37,2,car,722,1189,490,681,467,191,0.9922209
38,2,car,721,1192,490,681,471,191,0.9930029
39,2,car,721,1191,491,680,470,189,0.99370116
40,2,car,721,1192,491,679,471,188,0.99167436
41,2,car,720,1191,489,681,471,192,0.99269456
42,2,car,721,1190,491,680,469,189,0.993381
43,2,car,718,1190,490,681,472,191,0.99364763
44,2,car,722,1193,490,680,471,190,0.99402285
45,2,car,719,1192,490,680,473,190,0.99388003
46,2,car,723,1192,490,680,469,190,0.992976
47,2,car,721,1190,491,680,469,189,0.99315363
48,2,car,721,1190,491,680,469,189,0.9950945
49,2,car,719,1191,490,681,472,191,0.99357724
50,2,car,723,1191,491,680,468,189,0.99360245
51,2,car,721,1190,491,680,469,189,0.99408567
52,2,car,722,1191,490,680,469,190,0.99388546
53,2,car,719,1189,490,681,470,191,0.9933415
54,2,car,721,1189,490,681,468,191,0.99309224
55,2,car,720,1189,490,680,469,190,0.9933535
56,2,car,721,1189,490,680,468,190,0.99278355
57,2,car,722,1191,491,679,469,188,0.99334544
58,2,car,721,1189,491,679,468,188,0.9922223
59,2,car,721,1192,491,679,471,188,0.99353355
60,2,car,721,1190,491,680,469,189,0.9941834
61,2,car,721,1192,490,680,471,190,0.9927697
62,2,car,723,1187,491,680,464,189,0.9929273
63,2,car,720,1192,491,680,472,189,0.9943153
64,2,car,721,1190,490,680,469,190,0.9937749
65,2,car,721,1189,491,680,468,189,0.9938193
66,2,car,721,1193,490,681,472,191,0.9946054
67,2,car,721,1190,490,681,469,191,0.99308574
68,2,car,721,1191,490,680,470,190,0.99485815
69,2,car,719,1191,490,680,472,190,0.99378115
70,2,car,719,1192,490,681,473,191,0.994926
71,2,car,722,1192,490,680,470,190,0.9945114
72,2,car,722,1190,490,680,468,190,0.99356544
73,2,car,718,1192,490,680,474,190,0.99396724
74,2,car,720,1192,491,680,472,189,0.99402833
75,2,car,720,1188,490,681,468,191,0.9936452
76,2,car,722,1188,490,681,466,191,0.9941867
77,2,car,722,1189,490,681,467,191,0.99316216
78,2,car,721,1191,490,681,470,191,0.9934978
79,2,car,722,1192,491,679,470,188,0.9947086
80,2,car,719,1191,490,680,472,190,0.99448395
81,2,car,721,1190,490,681,469,191,0.9950352
82,2,car,718,1192,491,680,474,189,0.9946807
83,2,car,720,1190,491,680,470,189,0.9939705
84,2,car,721,1189,490,680,468,190,0.99420947
85,2,car,721,1188,491,679,467,188,0.9941135
86,2,car,720,1190,491,680,470,189,0.99439865
87,2,car,721,1190,490,680,469,190,0.9935835
88,2,car,720,1190,490,680,470,190,0.99316007
89,2,car,720,1190,490,680,470,190,0.99366015
90,2,car,723,1188,491,680,465,189,0.9940172
91,2,car,723,1190,491,680,467,189,0.9925984
92,2,car,720,1189,491,679,469,188,0.99389535
93,2,car,720,1192,491,680,472,189,0.9947525
94,2,car,720,1189,490,681,469,191,0.99338204
95,2,car,723,1190,490,680,467,190,0.993658
96,2,car,722,1191,490,681,469,191,0.9944046
97,2,car,723,1189,491,680,466,189,0.9941147
98,2,car,592,912,482,651,320,169,0.9904916
99,2,car,593,912,482,651,319,169,0.99101853
100,2,car,591,911,482,650,320,168,0.99045604
0,2,car,720,1188,490,681,468,191,0.9936275
1,2,car,721,1188,490,680,467,190,0.99227583
2,2,car,723,1189,490,680,466,190,0.9946215
3,2,car,719,1191,491,679,472,188,0.99300593
4,2,car,718,1191,490,681,473,191,0.9933079
5,2,car,720,1188,490,680,468,190,0.99254847
6,2,car,722,1189,491,679,467,188,0.99210006
7,2,car,720,1188,491,680,468,189,0.9942964
8,2,car,722,1189,490,680,467,190,0.9929243
9,2,car,722,1189,490,680,467,190,0.99385345
10,2,car,722,1190,490,681,468,191,0.9937917
11,2,car,721,1188,491,679,467,188,0.9926908
12,2,car,721,1190,490,681,469,191,0.9932829
13,2,car,721,1190,491,680,469,189,0.9928404
14,2,car,721,1191,491,680,470,189,0.9943646
15,2,car,723,1189,491,680,466,189,0.9942534
16,2,car,720,1191,490,681,471,191,0.9926691
17,2,car,721,1191,491,680,470,189,0.9923738
18,2,car,721,1187,492,679,466,187,0.99343777
19,2,car,721,1190,491,680,469,189,0.9931046
20,2,car,722,1188,492,679,466,187,0.9910961
21,2,car,721,1192,491,680,471,189,0.9921725
22,2,car,723,1190,490,680,467,190,0.9929821
23,2,car,723,1190,492,679,467,187,0.99407345
24,2,car,721,1189,490,680,468,190,0.99229693
25,2,car,720,1190,490,681,470,191,0.9942689
26,2,car,722,1190,491,680,468,189,0.9946975
27,2,car,722,1189,492,679,467,187,0.9933555
28,2,car,719,1191,491,680,472,189,0.99077785
29,2,car,720,1189,492,678,469,186,0.99275035
30,2,car,719,1192,491,680,473,189,0.99213934
31,2,car,724,1188,491,679,464,188,0.9937347
32,2,car,721,1191,490,680,470,190,0.9937846
33,2,car,724,1189,489,681,465,192,0.99227536
34,2,car,721,1191,490,681,470,191,0.99170077
35,2,car,722,1189,492,678,467,186,0.99312747
36,2,car,722,1189,490,680,467,190,0.9928037
37,2,car,722,1191,491,680,469,189,0.9921203
38,2,car,722,1189,490,681,467,191,0.9922209
39,2,car,721,1192,490,681,471,191,0.9930029
40,2,car,721,1191,491,680,470,189,0.99370116
41,2,car,721,1192,491,679,471,188,0.99167436
42,2,car,720,1191,489,681,471,192,0.99269456
43,2,car,721,1190,491,680,469,189,0.993381
44,2,car,718,1190,490,681,472,191,0.99364763
45,2,car,722,1193,490,680,471,190,0.99402285
46,2,car,719,1192,490,680,473,190,0.99388003
47,2,car,723,1192,490,680,469,190,0.992976
48,2,car,721,1190,491,680,469,189,0.99315363
49,2,car,721,1190,491,680,469,189,0.9950945
50,2,car,719,1191,490,681,472,191,0.99357724
51,2,car,723,1191,491,680,468,189,0.99360245
52,2,car,721,1190,491,680,469,189,0.99408567
53,2,car,722,1191,490,680,469,190,0.99388546
54,2,car,719,1189,490,681,470,191,0.9933415
55,2,car,721,1189,490,681,468,191,0.99309224
56,2,car,720,1189,490,680,469,190,0.9933535
57,2,car,721,1189,490,680,468,190,0.99278355
58,2,car,722,1191,491,679,469,188,0.99334544
59,2,car,721,1189,491,679,468,188,0.9922223
60,2,car,721,1192,491,679,471,188,0.99353355
61,2,car,721,1190,491,680,469,189,0.9941834
62,2,car,721,1192,490,680,471,190,0.9927697
63,2,car,723,1187,491,680,464,189,0.9929273
64,2,car,720,1192,491,680,472,189,0.9943153
65,2,car,721,1190,490,680,469,190,0.9937749
66,2,car,721,1189,491,680,468,189,0.9938193
67,2,car,721,1193,490,681,472,191,0.9946054
68,2,car,721,1190,490,681,469,191,0.99308574
69,2,car,721,1191,490,680,470,190,0.99485815
70,2,car,719,1191,490,680,472,190,0.99378115
71,2,car,719,1192,490,681,473,191,0.994926
72,2,car,722,1192,490,680,470,190,0.9945114
73,2,car,722,1190,490,680,468,190,0.99356544
74,2,car,718,1192,490,680,474,190,0.99396724
75,2,car,720,1192,491,680,472,189,0.99402833
76,2,car,720,1188,490,681,468,191,0.9936452
77,2,car,722,1188,490,681,466,191,0.9941867
78,2,car,722,1189,490,681,467,191,0.99316216
79,2,car,721,1191,490,681,470,191,0.9934978
80,2,car,722,1192,491,679,470,188,0.9947086
81,2,car,719,1191,490,680,472,190,0.99448395
82,2,car,721,1190,490,681,469,191,0.9950352
83,2,car,718,1192,491,680,474,189,0.9946807
84,2,car,720,1190,491,680,470,189,0.9939705
85,2,car,721,1189,490,680,468,190,0.99420947
86,2,car,721,1188,491,679,467,188,0.9941135
87,2,car,720,1190,491,680,470,189,0.99439865
88,2,car,721,1190,490,680,469,190,0.9935835
89,2,car,720,1190,490,680,470,190,0.99316007
90,2,car,720,1190,490,680,470,190,0.99366015
91,2,car,723,1188,491,680,465,189,0.9940172
92,2,car,723,1190,491,680,467,189,0.9925984
93,2,car,720,1189,491,679,469,188,0.99389535
94,2,car,720,1192,491,680,472,189,0.9947525
95,2,car,720,1189,490,681,469,191,0.99338204
96,2,car,723,1190,490,680,467,190,0.993658
97,2,car,722,1191,490,681,469,191,0.9944046
98,2,car,723,1189,491,680,466,189,0.9941147
99,2,car,592,912,482,651,320,169,0.9904916
100,2,car,593,912,482,651,319,169,0.99101853
101,2,car,591,911,482,650,320,168,0.99045604
0,2,car,720,1189,491,680,469,189,0.99289626
1,2,car,720,1188,490,681,468,191,0.9936275
2,2,car,721,1188,490,680,467,190,0.99227583
3,2,car,723,1189,490,680,466,190,0.9946215
4,2,car,719,1191,491,679,472,188,0.99300593
5,2,car,718,1191,490,681,473,191,0.9933079
6,2,car,720,1188,490,680,468,190,0.99254847
7,2,car,722,1189,491,679,467,188,0.99210006
8,2,car,720,1188,491,680,468,189,0.9942964
9,2,car,722,1189,490,680,467,190,0.9929243
10,2,car,722,1189,490,680,467,190,0.99385345
11,2,car,722,1190,490,681,468,191,0.9937917
12,2,car,721,1188,491,679,467,188,0.9926908
13,2,car,721,1190,490,681,469,191,0.9932829
14,2,car,721,1190,491,680,469,189,0.9928404
15,2,car,721,1191,491,680,470,189,0.9943646
16,2,car,723,1189,491,680,466,189,0.9942534
17,2,car,720,1191,490,681,471,191,0.9926691
18,2,car,721,1191,491,680,470,189,0.9923738
19,2,car,721,1187,492,679,466,187,0.99343777
20,2,car,721,1190,491,680,469,189,0.9931046
21,2,car,722,1188,492,679,466,187,0.9910961
22,2,car,721,1192,491,680,471,189,0.9921725
23,2,car,723,1190,490,680,467,190,0.9929821
24,2,car,723,1190,492,679,467,187,0.99407345
25,2,car,721,1189,490,680,468,190,0.99229693
26,2,car,720,1190,490,681,470,191,0.9942689
27,2,car,722,1190,491,680,468,189,0.9946975
28,2,car,722,1189,492,679,467,187,0.9933555
29,2,car,719,1191,491,680,472,189,0.99077785
30,2,car,720,1189,492,678,469,186,0.99275035
31,2,car,719,1192,491,680,473,189,0.99213934
32,2,car,724,1188,491,679,464,188,0.9937347
33,2,car,721,1191,490,680,470,190,0.9937846
34,2,car,724,1189,489,681,465,192,0.99227536
35,2,car,721,1191,490,681,470,191,0.99170077
36,2,car,722,1189,492,678,467,186,0.99312747
37,2,car,722,1189,490,680,467,190,0.9928037
38,2,car,722,1191,491,680,469,189,0.9921203
39,2,car,722,1189,490,681,467,191,0.9922209
40,2,car,721,1192,490,681,471,191,0.9930029
41,2,car,721,1191,491,680,470,189,0.99370116
42,2,car,721,1192,491,679,471,188,0.99167436
43,2,car,720,1191,489,681,471,192,0.99269456
44,2,car,721,1190,491,680,469,189,0.993381
45,2,car,718,1190,490,681,472,191,0.99364763
46,2,car,722,1193,490,680,471,190,0.99402285
47,2,car,719,1192,490,680,473,190,0.99388003
48,2,car,723,1192,490,680,469,190,0.992976
49,2,car,721,1190,491,680,469,189,0.99315363
50,2,car,721,1190,491,680,469,189,0.9950945
51,2,car,719,1191,490,681,472,191,0.99357724
52,2,car,723,1191,491,680,468,189,0.99360245
53,2,car,721,1190,491,680,469,189,0.99408567
54,2,car,722,1191,490,680,469,190,0.99388546
55,2,car,719,1189,490,681,470,191,0.9933415
56,2,car,721,1189,490,681,468,191,0.99309224
57,2,car,720,1189,490,680,469,190,0.9933535
58,2,car,721,1189,490,680,468,190,0.99278355
59,2,car,722,1191,491,679,469,188,0.99334544
60,2,car,721,1189,491,679,468,188,0.9922223
61,2,car,721,1192,491,679,471,188,0.99353355
62,2,car,721,1190,491,680,469,189,0.9941834
63,2,car,721,1192,490,680,471,190,0.9927697
64,2,car,723,1187,491,680,464,189,0.9929273
65,2,car,720,1192,491,680,472,189,0.9943153
66,2,car,721,1190,490,680,469,190,0.9937749
67,2,car,721,1189,491,680,468,189,0.9938193
68,2,car,721,1193,490,681,472,191,0.9946054
69,2,car,721,1190,490,681,469,191,0.99308574
70,2,car,721,1191,490,680,470,190,0.99485815
71,2,car,719,1191,490,680,472,190,0.99378115
72,2,car,719,1192,490,681,473,191,0.994926
73,2,car,722,1192,490,680,470,190,0.9945114
74,2,car,722,1190,490,680,468,190,0.99356544
75,2,car,718,1192,490,680,474,190,0.99396724
76,2,car,720,1192,491,680,472,189,0.99402833
77,2,car,720,1188,490,681,468,191,0.9936452
78,2,car,722,1188,490,681,466,191,0.9941867
79,2,car,722,1189,490,681,467,191,0.99316216
80,2,car,721,1191,490,681,470,191,0.9934978
81,2,car,722,1192,491,679,470,188,0.9947086
82,2,car,719,1191,490,680,472,190,0.99448395
83,2,car,721,1190,490,681,469,191,0.9950352
84,2,car,718,1192,491,680,474,189,0.9946807
85,2,car,720,1190,491,680,470,189,0.9939705
86,2,car,721,1189,490,680,468,190,0.99420947
87,2,car,721,1188,491,679,467,188,0.9941135
88,2,car,720,1190,491,680,470,189,0.99439865
89,2,car,721,1190,490,680,469,190,0.9935835
90,2,car,720,1190,490,680,470,190,0.99316007
91,2,car,720,1190,490,680,470,190,0.99366015
92,2,car,723,1188,491,680,465,189,0.9940172
93,2,car,723,1190,491,680,467,189,0.9925984
94,2,car,720,1189,491,679,469,188,0.99389535
95,2,car,720,1192,491,680,472,189,0.9947525
96,2,car,720,1189,490,681,469,191,0.99338204
97,2,car,723,1190,490,680,467,190,0.993658
98,2,car,722,1191,490,681,469,191,0.9944046
99,2,car,723,1189,491,680,466,189,0.9941147
100,2,car,592,912,482,651,320,169,0.9904916
101,2,car,593,912,482,651,319,169,0.99101853
102,2,car,591,911,482,650,320,168,0.99045604
0,2,car,720,1192,490,680,472,190,0.9943143
1,2,car,720,1189,491,680,469,189,0.99289626
2,2,car,720,1188,490,681,468,191,0.9936275
3,2,car,721,1188,490,680,467,190,0.99227583
4,2,car,723,1189,490,680,466,190,0.9946215
5,2,car,719,1191,491,679,472,188,0.99300593
6,2,car,718,1191,490,681,473,191,0.9933079
7,2,car,720,1188,490,680,468,190,0.99254847
8,2,car,722,1189,491,679,467,188,0.99210006
9,2,car,720,1188,491,680,468,189,0.9942964
10,2,car,722,1189,490,680,467,190,0.9929243
11,2,car,722,1189,490,680,467,190,0.99385345
12,2,car,722,1190,490,681,468,191,0.9937917
13,2,car,721,1188,491,679,467,188,0.9926908
14,2,car,721,1190,490,681,469,191,0.9932829
15,2,car,721,1190,491,680,469,189,0.9928404
16,2,car,721,1191,491,680,470,189,0.9943646
17,2,car,723,1189,491,680,466,189,0.9942534
18,2,car,720,1191,490,681,471,191,0.9926691
19,2,car,721,1191,491,680,470,189,0.9923738
20,2,car,721,1187,492,679,466,187,0.99343777
21,2,car,721,1190,491,680,469,189,0.9931046
22,2,car,722,1188,492,679,466,187,0.9910961
23,2,car,721,1192,491,680,471,189,0.9921725
24,2,car,723,1190,490,680,467,190,0.9929821
25,2,car,723,1190,492,679,467,187,0.99407345
26,2,car,721,1189,490,680,468,190,0.99229693
27,2,car,720,1190,490,681,470,191,0.9942689
28,2,car,722,1190,491,680,468,189,0.9946975
29,2,car,722,1189,492,679,467,187,0.9933555
30,2,car,719,1191,491,680,472,189,0.99077785
31,2,car,720,1189,492,678,469,186,0.99275035
32,2,car,719,1192,491,680,473,189,0.99213934
33,2,car,724,1188,491,679,464,188,0.9937347
34,2,car,721,1191,490,680,470,190,0.9937846
35,2,car,724,1189,489,681,465,192,0.99227536
36,2,car,721,1191,490,681,470,191,0.99170077
37,2,car,722,1189,492,678,467,186,0.99312747
38,2,car,722,1189,490,680,467,190,0.9928037
39,2,car,722,1191,491,680,469,189,0.9921203
40,2,car,722,1189,490,681,467,191,0.9922209
41,2,car,721,1192,490,681,471,191,0.9930029
42,2,car,721,1191,491,680,470,189,0.99370116
43,2,car,721,1192,491,679,471,188,0.99167436
44,2,car,720,1191,489,681,471,192,0.99269456
45,2,car,721,1190,491,680,469,189,0.993381
46,2,car,718,1190,490,681,472,191,0.99364763
47,2,car,722,1193,490,680,471,190,0.99402285
48,2,car,719,1192,490,680,473,190,0.99388003
49,2,car,723,1192,490,680,469,190,0.992976
50,2,car,721,1190,491,680,469,189,0.99315363
51,2,car,721,1190,491,680,469,189,0.9950945
52,2,car,719,1191,490,681,472,191,0.99357724
53,2,car,723,1191,491,680,468,189,0.99360245
54,2,car,721,1190,491,680,469,189,0.99408567
55,2,car,722,1191,490,680,469,190,0.99388546
56,2,car,719,1189,490,681,470,191,0.9933415
57,2,car,721,1189,490,681,468,191,0.99309224
58,2,car,720,1189,490,680,469,190,0.9933535
59,2,car,721,1189,490,680,468,190,0.99278355
60,2,car,722,1191,491,679,469,188,0.99334544
61,2,car,721,1189,491,679,468,188,0.9922223
62,2,car,721,1192,491,679,471,188,0.99353355
63,2,car,721,1190,491,680,469,189,0.9941834
64,2,car,721,1192,490,680,471,190,0.9927697
65,2,car,723,1187,491,680,464,189,0.9929273
66,2,car,720,1192,491,680,472,189,0.9943153
67,2,car,721,1190,490,680,469,190,0.9937749
68,2,car,721,1189,491,680,468,189,0.9938193
69,2,car,721,1193,490,681,472,191,0.9946054
70,2,car,721,1190,490,681,469,191,0.99308574
71,2,car,721,1191,490,680,470,190,0.99485815
72,2,car,719,1191,490,680,472,190,0.99378115
73,2,car,719,1192,490,681,473,191,0.994926
74,2,car,722,1192,490,680,470,190,0.9945114
75,2,car,722,1190,490,680,468,190,0.99356544
76,2,car,718,1192,490,680,474,190,0.99396724
77,2,car,720,1192,491,680,472,189,0.99402833
78,2,car,720,1188,490,681,468,191,0.9936452
79,2,car,722,1188,490,681,466,191,0.9941867
80,2,car,722,1189,490,681,467,191,0.99316216
81,2,car,721,1191,490,681,470,191,0.9934978
82,2,car,722,1192,491,679,470,188,0.9947086
83,2,car,719,1191,490,680,472,190,0.99448395
84,2,car,721,1190,490,681,469,191,0.9950352
85,2,car,718,1192,491,680,474,189,0.9946807
86,2,car,720,1190,491,680,470,189,0.9939705
87,2,car,721,1189,490,680,468,190,0.99420947
88,2,car,721,1188,491,679,467,188,0.9941135
89,2,car,720,1190,491,680,470,189,0.99439865
90,2,car,721,1190,490,680,469,190,0.9935835
91,2,car,720,1190,490,680,470,190,0.99316007
92,2,car,720,1190,490,680,470,190,0.99366015
93,2,car,723,1188,491,680,465,189,0.9940172
94,2,car,723,1190,491,680,467,189,0.9925984
95,2,car,720,1189,491,679,469,188,0.99389535
96,2,car,720,1192,491,680,472,189,0.9947525
97,2,car,720,1189,490,681,469,191,0.99338204
98,2,car,723,1190,490,680,467,190,0.993658
99,2,car,722,1191,490,681,469,191,0.9944046
100,2,car,723,1189,491,680,466,189,0.9941147
101,2,car,592,912,482,651,320,169,0.9904916
102,2,car,593,912,482,651,319,169,0.99101853
103,2,car,591,911,482,650,320,168,0.99045604
0,2,car,721,1189,489,681,468,192,0.9942035
1,2,car,720,1192,490,680,472,190,0.9943143
2,2,car,720,1189,491,680,469,189,0.99289626
3,2,car,720,1188,490,681,468,191,0.9936275
4,2,car,721,1188,490,680,467,190,0.99227583
5,2,car,723,1189,490,680,466,190,0.9946215
6,2,car,719,1191,491,679,472,188,0.99300593
7,2,car,718,1191,490,681,473,191,0.9933079
8,2,car,720,1188,490,680,468,190,0.99254847
9,2,car,722,1189,491,679,467,188,0.99210006
10,2,car,720,1188,491,680,468,189,0.9942964
11,2,car,722,1189,490,680,467,190,0.9929243
12,2,car,722,1189,490,680,467,190,0.99385345
13,2,car,722,1190,490,681,468,191,0.9937917
14,2,car,721,1188,491,679,467,188,0.9926908
15,2,car,721,1190,490,681,469,191,0.9932829
16,2,car,721,1190,491,680,469,189,0.9928404
17,2,car,721,1191,491,680,470,189,0.9943646
18,2,car,723,1189,491,680,466,189,0.9942534
19,2,car,720,1191,490,681,471,191,0.9926691
20,2,car,721,1191,491,680,470,189,0.9923738
21,2,car,721,1187,492,679,466,187,0.99343777
22,2,car,721,1190,491,680,469,189,0.9931046
23,2,car,722,1188,492,679,466,187,0.9910961
24,2,car,721,1192,491,680,471,189,0.9921725
25,2,car,723,1190,490,680,467,190,0.9929821
26,2,car,723,1190,492,679,467,187,0.99407345
27,2,car,721,1189,490,680,468,190,0.99229693
28,2,car,720,1190,490,681,470,191,0.9942689
29,2,car,722,1190,491,680,468,189,0.9946975
30,2,car,722,1189,492,679,467,187,0.9933555
31,2,car,719,1191,491,680,472,189,0.99077785
32,2,car,720,1189,492,678,469,186,0.99275035
33,2,car,719,1192,491,680,473,189,0.99213934
34,2,car,724,1188,491,679,464,188,0.9937347
35,2,car,721,1191,490,680,470,190,0.9937846
36,2,car,724,1189,489,681,465,192,0.99227536
37,2,car,721,1191,490,681,470,191,0.99170077
38,2,car,722,1189,492,678,467,186,0.99312747
39,2,car,722,1189,490,680,467,190,0.9928037
40,2,car,722,1191,491,680,469,189,0.9921203
41,2,car,722,1189,490,681,467,191,0.9922209
42,2,car,721,1192,490,681,471,191,0.9930029
43,2,car,721,1191,491,680,470,189,0.99370116
44,2,car,721,1192,491,679,471,188,0.99167436
45,2,car,720,1191,489,681,471,192,0.99269456
46,2,car,721,1190,491,680,469,189,0.993381
47,2,car,718,1190,490,681,472,191,0.99364763
48,2,car,722,1193,490,680,471,190,0.99402285
49,2,car,719,1192,490,680,473,190,0.99388003
50,2,car,723,1192,490,680,469,190,0.992976
51,2,car,721,1190,491,680,469,189,0.99315363
52,2,car,721,1190,491,680,469,189,0.9950945
53,2,car,719,1191,490,681,472,191,0.99357724
54,2,car,723,1191,491,680,468,189,0.99360245
55,2,car,721,1190,491,680,469,189,0.99408567
56,2,car,722,1191,490,680,469,190,0.99388546
57,2,car,719,1189,490,681,470,191,0.9933415
58,2,car,721,1189,490,681,468,191,0.99309224
59,2,car,720,1189,490,680,469,190,0.9933535
60,2,car,721,1189,490,680,468,190,0.99278355
61,2,car,722,1191,491,679,469,188,0.99334544
62,2,car,721,1189,491,679,468,188,0.9922223
63,2,car,721,1192,491,679,471,188,0.99353355
64,2,car,721,1190,491,680,469,189,0.9941834
65,2,car,721,1192,490,680,471,190,0.9927697
66,2,car,723,1187,491,680,464,189,0.9929273
67,2,car,720,1192,491,680,472,189,0.9943153
68,2,car,721,1190,490,680,469,190,0.9937749
69,2,car,721,1189,491,680,468,189,0.9938193
70,2,car,721,1193,490,681,472,191,0.9946054
71,2,car,721,1190,490,681,469,191,0.99308574
72,2,car,721,1191,490,680,470,190,0.99485815
73,2,car,719,1191,490,680,472,190,0.99378115
74,2,car,719,1192,490,681,473,191,0.994926
75,2,car,722,1192,490,680,470,190,0.9945114
76,2,car,722,1190,490,680,468,190,0.99356544
77,2,car,718,1192,490,680,474,190,0.99396724
78,2,car,720,1192,491,680,472,189,0.99402833
79,2,car,720,1188,490,681,468,191,0.9936452
80,2,car,722,1188,490,681,466,191,0.9941867
81,2,car,722,1189,490,681,467,191,0.99316216
82,2,car,721,1191,490,681,470,191,0.9934978
83,2,car,722,1192,491,679,470,188,0.9947086
84,2,car,719,1191,490,680,472,190,0.99448395
85,2,car,721,1190,490,681,469,191,0.9950352
86,2,car,718,1192,491,680,474,189,0.9946807
87,2,car,720,1190,491,680,470,189,0.9939705
88,2,car,721,1189,490,680,468,190,0.99420947
89,2,car,721,1188,491,679,467,188,0.9941135
90,2,car,720,1190,491,680,470,189,0.99439865
91,2,car,721,1190,490,680,469,190,0.9935835
92,2,car,720,1190,490,680,470,190,0.99316007
93,2,car,720,1190,490,680,470,190,0.99366015
94,2,car,723,1188,491,680,465,189,0.9940172
95,2,car,723,1190,491,680,467,189,0.9925984
96,2,car,720,1189,491,679,469,188,0.99389535
97,2,car,720,1192,491,680,472,189,0.9947525
98,2,car,720,1189,490,681,469,191,0.99338204
99,2,car,723,1190,490,680,467,190,0.993658
100,2,car,722,1191,490,681,469,191,0.9944046
101,2,car,723,1189,491,680,466,189,0.9941147
102,2,car,592,912,482,651,320,169,0.9904916
103,2,car,593,912,482,651,319,169,0.99101853
104,2,car,591,911,482,650,320,168,0.99045604
0,2,car,721,1192,491,679,471,188,0.99110234
1,2,car,721,1189,489,681,468,192,0.9942035
2,2,car,720,1192,490,680,472,190,0.9943143
3,2,car,720,1189,491,680,469,189,0.99289626
4,2,car,720,1188,490,681,468,191,0.9936275
5,2,car,721,1188,490,680,467,190,0.99227583
6,2,car,723,1189,490,680,466,190,0.9946215
7,2,car,719,1191,491,679,472,188,0.99300593
8,2,car,718,1191,490,681,473,191,0.9933079
9,2,car,720,1188,490,680,468,190,0.99254847
10,2,car,722,1189,491,679,467,188,0.99210006
11,2,car,720,1188,491,680,468,189,0.9942964
12,2,car,722,1189,490,680,467,190,0.9929243
13,2,car,722,1189,490,680,467,190,0.99385345
14,2,car,722,1190,490,681,468,191,0.9937917
15,2,car,721,1188,491,679,467,188,0.9926908
16,2,car,721,1190,490,681,469,191,0.9932829
17,2,car,721,1190,491,680,469,189,0.9928404
18,2,car,721,1191,491,680,470,189,0.9943646
19,2,car,723,1189,491,680,466,189,0.9942534
20,2,car,720,1191,490,681,471,191,0.9926691
21,2,car,721,1191,491,680,470,189,0.9923738
22,2,car,721,1187,492,679,466,187,0.99343777
23,2,car,721,1190,491,680,469,189,0.9931046
24,2,car,722,1188,492,679,466,187,0.9910961
25,2,car,721,1192,491,680,471,189,0.9921725
26,2,car,723,1190,490,680,467,190,0.9929821
27,2,car,723,1190,492,679,467,187,0.99407345
28,2,car,721,1189,490,680,468,190,0.99229693
29,2,car,720,1190,490,681,470,191,0.9942689
30,2,car,722,1190,491,680,468,189,0.9946975
31,2,car,722,1189,492,679,467,187,0.9933555
32,2,car,719,1191,491,680,472,189,0.99077785
33,2,car,720,1189,492,678,469,186,0.99275035
34,2,car,719,1192,491,680,473,189,0.99213934
35,2,car,724,1188,491,679,464,188,0.9937347
36,2,car,721,1191,490,680,470,190,0.9937846
37,2,car,724,1189,489,681,465,192,0.99227536
38,2,car,721,1191,490,681,470,191,0.99170077
39,2,car,722,1189,492,678,467,186,0.99312747
40,2,car,722,1189,490,680,467,190,0.9928037
41,2,car,722,1191,491,680,469,189,0.9921203
42,2,car,722,1189,490,681,467,191,0.9922209
43,2,car,721,1192,490,681,471,191,0.9930029
44,2,car,721,1191,491,680,470,189,0.99370116
45,2,car,721,1192,491,679,471,188,0.99167436
46,2,car,720,1191,489,681,471,192,0.99269456
47,2,car,721,1190,491,680,469,189,0.993381
48,2,car,718,1190,490,681,472,191,0.99364763
49,2,car,722,1193,490,680,471,190,0.99402285
50,2,car,719,1192,490,680,473,190,0.99388003
51,2,car,723,1192,490,680,469,190,0.992976
52,2,car,721,1190,491,680,469,189,0.99315363
53,2,car,721,1190,491,680,469,189,0.9950945
54,2,car,719,1191,490,681,472,191,0.99357724
55,2,car,723,1191,491,680,468,189,0.99360245
56,2,car,721,1190,491,680,469,189,0.99408567
57,2,car,722,1191,490,680,469,190,0.99388546
58,2,car,719,1189,490,681,470,191,0.9933415
59,2,car,721,1189,490,681,468,191,0.99309224
60,2,car,720,1189,490,680,469,190,0.9933535
61,2,car,721,1189,490,680,468,190,0.99278355
62,2,car,722,1191,491,679,469,188,0.99334544
63,2,car,721,1189,491,679,468,188,0.9922223
64,2,car,721,1192,491,679,471,188,0.99353355
65,2,car,721,1190,491,680,469,189,0.9941834
66,2,car,721,1192,490,680,471,190,0.9927697
67,2,car,723,1187,491,680,464,189,0.9929273
68,2,car,720,1192,491,680,472,189,0.9943153
69,2,car,721,1190,490,680,469,190,0.9937749
70,2,car,721,1189,491,680,468,189,0.9938193
71,2,car,721,1193,490,681,472,191,0.9946054
72,2,car,721,1190,490,681,469,191,0.99308574
73,2,car,721,1191,490,680,470,190,0.99485815
74,2,car,719,1191,490,680,472,190,0.99378115
75,2,car,719,1192,490,681,473,191,0.994926
76,2,car,722,1192,490,680,470,190,0.9945114
77,2,car,722,1190,490,680,468,190,0.99356544
78,2,car,718,1192,490,680,474,190,0.99396724
79,2,car,720,1192,491,680,472,189,0.99402833
80,2,car,720,1188,490,681,468,191,0.9936452
81,2,car,722,1188,490,681,466,191,0.9941867
82,2,car,722,1189,490,681,467,191,0.99316216
83,2,car,721,1191,490,681,470,191,0.9934978
84,2,car,722,1192,491,679,470,188,0.9947086
85,2,car,719,1191,490,680,472,190,0.99448395
86,2,car,721,1190,490,681,469,191,0.9950352
87,2,car,718,1192,491,680,474,189,0.9946807
88,2,car,720,1190,491,680,470,189,0.9939705
89,2,car,721,1189,490,680,468,190,0.99420947
90,2,car,721,1188,491,679,467,188,0.9941135
91,2,car,720,1190,491,680,470,189,0.99439865
92,2,car,721,1190,490,680,469,190,0.9935835
93,2,car,720,1190,490,680,470,190,0.99316007
94,2,car,720,1190,490,680,470,190,0.99366015
95,2,car,723,1188,491,680,465,189,0.9940172
96,2,car,723,1190,491,680,467,189,0.9925984
97,2,car,720,1189,491,679,469,188,0.99389535
98,2,car,720,1192,491,680,472,189,0.9947525
99,2,car,720,1189,490,681,469,191,0.99338204
100,2,car,723,1190,490,680,467,190,0.993658
101,2,car,722,1191,490,681,469,191,0.9944046
102,2,car,723,1189,491,680,466,189,0.9941147
103,2,car,592,912,482,651,320,169,0.9904916
104,2,car,593,912,482,651,319,169,0.99101853
105,2,car,591,911,482,650,320,168,0.99045604
0,2,car,720,1192,490,681,472,191,0.9934201
1,2,car,721,1192,491,679,471,188,0.99110234
2,2,car,721,1189,489,681,468,192,0.9942035
3,2,car,720,1192,490,680,472,190,0.9943143
4,2,car,720,1189,491,680,469,189,0.99289626
5,2,car,720,1188,490,681,468,191,0.9936275
6,2,car,721,1188,490,680,467,190,0.99227583
7,2,car,723,1189,490,680,466,190,0.9946215
8,2,car,719,1191,491,679,472,188,0.99300593
9,2,car,718,1191,490,681,473,191,0.9933079
10,2,car,720,1188,490,680,468,190,0.99254847
11,2,car,722,1189,491,679,467,188,0.99210006
12,2,car,720,1188,491,680,468,189,0.9942964
13,2,car,722,1189,490,680,467,190,0.9929243
14,2,car,722,1189,490,680,467,190,0.99385345
15,2,car,722,1190,490,681,468,191,0.9937917
16,2,car,721,1188,491,679,467,188,0.9926908
17,2,car,721,1190,490,681,469,191,0.9932829
18,2,car,721,1190,491,680,469,189,0.9928404
19,2,car,721,1191,491,680,470,189,0.9943646
20,2,car,723,1189,491,680,466,189,0.9942534
21,2,car,720,1191,490,681,471,191,0.9926691
22,2,car,721,1191,491,680,470,189,0.9923738
23,2,car,721,1187,492,679,466,187,0.99343777
24,2,car,721,1190,491,680,469,189,0.9931046
25,2,car,722,1188,492,679,466,187,0.9910961
26,2,car,721,1192,491,680,471,189,0.9921725
27,2,car,723,1190,490,680,467,190,0.9929821
28,2,car,723,1190,492,679,467,187,0.99407345
29,2,car,721,1189,490,680,468,190,0.99229693
30,2,car,720,1190,490,681,470,191,0.9942689
31,2,car,722,1190,491,680,468,189,0.9946975
32,2,car,722,1189,492,679,467,187,0.9933555
33,2,car,719,1191,491,680,472,189,0.99077785
34,2,car,720,1189,492,678,469,186,0.99275035
35,2,car,719,1192,491,680,473,189,0.99213934
36,2,car,724,1188,491,679,464,188,0.9937347
37,2,car,721,1191,490,680,470,190,0.9937846
38,2,car,724,1189,489,681,465,192,0.99227536
39,2,car,721,1191,490,681,470,191,0.99170077
40,2,car,722,1189,492,678,467,186,0.99312747
41,2,car,722,1189,490,680,467,190,0.9928037
42,2,car,722,1191,491,680,469,189,0.9921203
43,2,car,722,1189,490,681,467,191,0.9922209
44,2,car,721,1192,490,681,471,191,0.9930029
45,2,car,721,1191,491,680,470,189,0.99370116
46,2,car,721,1192,491,679,471,188,0.99167436
47,2,car,720,1191,489,681,471,192,0.99269456
48,2,car,721,1190,491,680,469,189,0.993381
49,2,car,718,1190,490,681,472,191,0.99364763
50,2,car,722,1193,490,680,471,190,0.99402285
51,2,car,719,1192,490,680,473,190,0.99388003
52,2,car,723,1192,490,680,469,190,0.992976
53,2,car,721,1190,491,680,469,189,0.99315363
54,2,car,721,1190,491,680,469,189,0.9950945
55,2,car,719,1191,490,681,472,191,0.99357724
56,2,car,723,1191,491,680,468,189,0.99360245
57,2,car,721,1190,491,680,469,189,0.99408567
58,2,car,722,1191,490,680,469,190,0.99388546
59,2,car,719,1189,490,681,470,191,0.9933415
60,2,car,721,1189,490,681,468,191,0.99309224
61,2,car,720,1189,490,680,469,190,0.9933535
62,2,car,721,1189,490,680,468,190,0.99278355
63,2,car,722,1191,491,679,469,188,0.99334544
64,2,car,721,1189,491,679,468,188,0.9922223
65,2,car,721,1192,491,679,471,188,0.99353355
66,2,car,721,1190,491,680,469,189,0.9941834
67,2,car,721,1192,490,680,471,190,0.9927697
68,2,car,723,1187,491,680,464,189,0.9929273
69,2,car,720,1192,491,680,472,189,0.9943153
70,2,car,721,1190,490,680,469,190,0.9937749
71,2,car,721,1189,491,680,468,189,0.9938193
72,2,car,721,1193,490,681,472,191,0.9946054
73,2,car,721,1190,490,681,469,191,0.99308574
74,2,car,721,1191,490,680,470,190,0.99485815
75,2,car,719,1191,490,680,472,190,0.99378115
76,2,car,719,1192,490,681,473,191,0.994926
77,2,car,722,1192,490,680,470,190,0.9945114
78,2,car,722,1190,490,680,468,190,0.99356544
79,2,car,718,1192,490,680,474,190,0.99396724
80,2,car,720,1192,491,680,472,189,0.99402833
81,2,car,720,1188,490,681,468,191,0.9936452
82,2,car,722,1188,490,681,466,191,0.9941867
83,2,car,722,1189,490,681,467,191,0.99316216
84,2,car,721,1191,490,681,470,191,0.9934978
85,2,car,722,1192,491,679,470,188,0.9947086
86,2,car,719,1191,490,680,472,190,0.99448395
87,2,car,721,1190,490,681,469,191,0.9950352
88,2,car,718,1192,491,680,474,189,0.9946807
89,2,car,720,1190,491,680,470,189,0.9939705
90,2,car,721,1189,490,680,468,190,0.99420947
91,2,car,721,1188,491,679,467,188,0.9941135
92,2,car,720,1190,491,680,470,189,0.99439865
93,2,car,721,1190,490,680,469,190,0.9935835
94,2,car,720,1190,490,680,470,190,0.99316007
95,2,car,720,1190,490,680,470,190,0.99366015
96,2,car,723,1188,491,680,465,189,0.9940172
97,2,car,723,1190,491,680,467,189,0.9925984
98,2,car,720,1189,491,679,469,188,0.99389535
99,2,car,720,1192,491,680,472,189,0.9947525
100,2,car,720,1189,490,681,469,191,0.99338204
101,2,car,723,1190,490,680,467,190,0.993658
102,2,car,722,1191,490,681,469,191,0.9944046
103,2,car,723,1189,491,680,466,189,0.9941147
104,2,car,592,912,482,651,320,169,0.9904916
105,2,car,593,912,482,651,319,169,0.99101853
106,2,car,591,911,482,650,320,168,0.99045604
0,2,car,718,1190,490,680,472,190,0.9941106
1,2,car,720,1192,490,681,472,191,0.9934201
2,2,car,721,1192,491,679,471,188,0.99110234
3,2,car,721,1189,489,681,468,192,0.9942035
4,2,car,720,1192,490,680,472,190,0.9943143
5,2,car,720,1189,491,680,469,189,0.99289626
6,2,car,720,1188,490,681,468,191,0.9936275
7,2,car,721,1188,490,680,467,190,0.99227583
8,2,car,723,1189,490,680,466,190,0.9946215
9,2,car,719,1191,491,679,472,188,0.99300593
10,2,car,718,1191,490,681,473,191,0.9933079
11,2,car,720,1188,490,680,468,190,0.99254847
12,2,car,722,1189,491,679,467,188,0.99210006
13,2,car,720,1188,491,680,468,189,0.9942964
14,2,car,722,1189,490,680,467,190,0.9929243
15,2,car,722,1189,490,680,467,190,0.99385345
16,2,car,722,1190,490,681,468,191,0.9937917
17,2,car,721,1188,491,679,467,188,0.9926908
18,2,car,721,1190,490,681,469,191,0.9932829
19,2,car,721,1190,491,680,469,189,0.9928404
20,2,car,721,1191,491,680,470,189,0.9943646
21,2,car,723,1189,491,680,466,189,0.9942534
22,2,car,720,1191,490,681,471,191,0.9926691
23,2,car,721,1191,491,680,470,189,0.9923738
24,2,car,721,1187,492,679,466,187,0.99343777
25,2,car,721,1190,491,680,469,189,0.9931046
26,2,car,722,1188,492,679,466,187,0.9910961
27,2,car,721,1192,491,680,471,189,0.9921725
28,2,car,723,1190,490,680,467,190,0.9929821
29,2,car,723,1190,492,679,467,187,0.99407345
30,2,car,721,1189,490,680,468,190,0.99229693
31,2,car,720,1190,490,681,470,191,0.9942689
32,2,car,722,1190,491,680,468,189,0.9946975
33,2,car,722,1189,492,679,467,187,0.9933555
34,2,car,719,1191,491,680,472,189,0.99077785
35,2,car,720,1189,492,678,469,186,0.99275035
36,2,car,719,1192,491,680,473,189,0.99213934
37,2,car,724,1188,491,679,464,188,0.9937347
38,2,car,721,1191,490,680,470,190,0.9937846
39,2,car,724,1189,489,681,465,192,0.99227536
40,2,car,721,1191,490,681,470,191,0.99170077
41,2,car,722,1189,492,678,467,186,0.99312747
42,2,car,722,1189,490,680,467,190,0.9928037
43,2,car,722,1191,491,680,469,189,0.9921203
44,2,car,722,1189,490,681,467,191,0.9922209
45,2,car,721,1192,490,681,471,191,0.9930029
46,2,car,721,1191,491,680,470,189,0.99370116
47,2,car,721,1192,491,679,471,188,0.99167436
48,2,car,720,1191,489,681,471,192,0.99269456
49,2,car,721,1190,491,680,469,189,0.993381
50,2,car,718,1190,490,681,472,191,0.99364763
51,2,car,722,1193,490,680,471,190,0.99402285
52,2,car,719,1192,490,680,473,190,0.99388003
53,2,car,723,1192,490,680,469,190,0.992976
54,2,car,721,1190,491,680,469,189,0.99315363
55,2,car,721,1190,491,680,469,189,0.9950945
56,2,car,719,1191,490,681,472,191,0.99357724
57,2,car,723,1191,491,680,468,189,0.99360245
58,2,car,721,1190,491,680,469,189,0.99408567
59,2,car,722,1191,490,680,469,190,0.99388546
60,2,car,719,1189,490,681,470,191,0.9933415
61,2,car,721,1189,490,681,468,191,0.99309224
62,2,car,720,1189,490,680,469,190,0.9933535
63,2,car,721,1189,490,680,468,190,0.99278355
64,2,car,722,1191,491,679,469,188,0.99334544
65,2,car,721,1189,491,679,468,188,0.9922223
66,2,car,721,1192,491,679,471,188,0.99353355
67,2,car,721,1190,491,680,469,189,0.9941834
68,2,car,721,1192,490,680,471,190,0.9927697
69,2,car,723,1187,491,680,464,189,0.9929273
70,2,car,720,1192,491,680,472,189,0.9943153
71,2,car,721,1190,490,680,469,190,0.9937749
72,2,car,721,1189,491,680,468,189,0.9938193
73,2,car,721,1193,490,681,472,191,0.9946054
74,2,car,721,1190,490,681,469,191,0.99308574
75,2,car,721,1191,490,680,470,190,0.99485815
76,2,car,719,1191,490,680,472,190,0.99378115
77,2,car,719,1192,490,681,473,191,0.994926
78,2,car,722,1192,490,680,470,190,0.9945114
79,2,car,722,1190,490,680,468,190,0.99356544
80,2,car,718,1192,490,680,474,190,0.99396724
81,2,car,720,1192,491,680,472,189,0.99402833
82,2,car,720,1188,490,681,468,191,0.9936452
83,2,car,722,1188,490,681,466,191,0.9941867
84,2,car,722,1189,490,681,467,191,0.99316216
85,2,car,721,1191,490,681,470,191,0.9934978
86,2,car,722,1192,491,679,470,188,0.9947086
87,2,car,719,1191,490,680,472,190,0.99448395
88,2,car,721,1190,490,681,469,191,0.9950352
89,2,car,718,1192,491,680,474,189,0.9946807
90,2,car,720,1190,491,680,470,189,0.9939705
91,2,car,721,1189,490,680,468,190,0.99420947
92,2,car,721,1188,491,679,467,188,0.9941135
93,2,car,720,1190,491,680,470,189,0.99439865
94,2,car,721,1190,490,680,469,190,0.9935835
95,2,car,720,1190,490,680,470,190,0.99316007
96,2,car,720,1190,490,680,470,190,0.99366015
97,2,car,723,1188,491,680,465,189,0.9940172
98,2,car,723,1190,491,680,467,189,0.9925984
99,2,car,720,1189,491,679,469,188,0.99389535
100,2,car,720,1192,491,680,472,189,0.9947525
101,2,car,720,1189,490,681,469,191,0.99338204
102,2,car,723,1190,490,680,467,190,0.993658
103,2,car,722,1191,490,681,469,191,0.9944046
104,2,car,723,1189,491,680,466,189,0.9941147
105,2,car,592,912,482,651,320,169,0.9904916
106,2,car,593,912,482,651,319,169,0.99101853
107,2,car,591,911,482,650,320,168,0.99045604
0,2,car,724,1188,491,679,464,188,0.99361384
1,2,car,718,1190,490,680,472,190,0.9941106
2,2,car,720,1192,490,681,472,191,0.9934201
3,2,car,721,1192,491,679,471,188,0.99110234
4,2,car,721,1189,489,681,468,192,0.9942035
5,2,car,720,1192,490,680,472,190,0.9943143
6,2,car,720,1189,491,680,469,189,0.99289626
7,2,car,720,1188,490,681,468,191,0.9936275
8,2,car,721,1188,490,680,467,190,0.99227583
9,2,car,723,1189,490,680,466,190,0.9946215
10,2,car,719,1191,491,679,472,188,0.99300593
11,2,car,718,1191,490,681,473,191,0.9933079
12,2,car,720,1188,490,680,468,190,0.99254847
13,2,car,722,1189,491,679,467,188,0.99210006
14,2,car,720,1188,491,680,468,189,0.9942964
15,2,car,722,1189,490,680,467,190,0.9929243
16,2,car,722,1189,490,680,467,190,0.99385345
17,2,car,722,1190,490,681,468,191,0.9937917
18,2,car,721,1188,491,679,467,188,0.9926908
19,2,car,721,1190,490,681,469,191,0.9932829
20,2,car,721,1190,491,680,469,189,0.9928404
21,2,car,721,1191,491,680,470,189,0.9943646
22,2,car,723,1189,491,680,466,189,0.9942534
23,2,car,720,1191,490,681,471,191,0.9926691
24,2,car,721,1191,491,680,470,189,0.9923738
25,2,car,721,1187,492,679,466,187,0.99343777
26,2,car,721,1190,491,680,469,189,0.9931046
27,2,car,722,1188,492,679,466,187,0.9910961
28,2,car,721,1192,491,680,471,189,0.9921725
29,2,car,723,1190,490,680,467,190,0.9929821
30,2,car,723,1190,492,679,467,187,0.99407345
31,2,car,721,1189,490,680,468,190,0.99229693
32,2,car,720,1190,490,681,470,191,0.9942689
33,2,car,722,1190,491,680,468,189,0.9946975
34,2,car,722,1189,492,679,467,187,0.9933555
35,2,car,719,1191,491,680,472,189,0.99077785
36,2,car,720,1189,492,678,469,186,0.99275035
37,2,car,719,1192,491,680,473,189,0.99213934
38,2,car,724,1188,491,679,464,188,0.9937347
39,2,car,721,1191,490,680,470,190,0.9937846
40,2,car,724,1189,489,681,465,192,0.99227536
41,2,car,721,1191,490,681,470,191,0.99170077
42,2,car,722,1189,492,678,467,186,0.99312747
43,2,car,722,1189,490,680,467,190,0.9928037
44,2,car,722,1191,491,680,469,189,0.9921203
45,2,car,722,1189,490,681,467,191,0.9922209
46,2,car,721,1192,490,681,471,191,0.9930029
47,2,car,721,1191,491,680,470,189,0.99370116
48,2,car,721,1192,491,679,471,188,0.99167436
49,2,car,720,1191,489,681,471,192,0.99269456
50,2,car,721,1190,491,680,469,189,0.993381
51,2,car,718,1190,490,681,472,191,0.99364763
52,2,car,722,1193,490,680,471,190,0.99402285
53,2,car,719,1192,490,680,473,190,0.99388003
54,2,car,723,1192,490,680,469,190,0.992976
55,2,car,721,1190,491,680,469,189,0.99315363
56,2,car,721,1190,491,680,469,189,0.9950945
57,2,car,719,1191,490,681,472,191,0.99357724
58,2,car,723,1191,491,680,468,189,0.99360245
59,2,car,721,1190,491,680,469,189,0.99408567
60,2,car,722,1191,490,680,469,190,0.99388546
61,2,car,719,1189,490,681,470,191,0.9933415
62,2,car,721,1189,490,681,468,191,0.99309224
63,2,car,720,1189,490,680,469,190,0.9933535
64,2,car,721,1189,490,680,468,190,0.99278355
65,2,car,722,1191,491,679,469,188,0.99334544
66,2,car,721,1189,491,679,468,188,0.9922223
67,2,car,721,1192,491,679,471,188,0.99353355
68,2,car,721,1190,491,680,469,189,0.9941834
69,2,car,721,1192,490,680,471,190,0.9927697
70,2,car,723,1187,491,680,464,189,0.9929273
71,2,car,720,1192,491,680,472,189,0.9943153
72,2,car,721,1190,490,680,469,190,0.9937749
73,2,car,721,1189,491,680,468,189,0.9938193
74,2,car,721,1193,490,681,472,191,0.9946054
75,2,car,721,1190,490,681,469,191,0.99308574
76,2,car,721,1191,490,680,470,190,0.99485815
77,2,car,719,1191,490,680,472,190,0.99378115
78,2,car,719,1192,490,681,473,191,0.994926
79,2,car,722,1192,490,680,470,190,0.9945114
80,2,car,722,1190,490,680,468,190,0.99356544
81,2,car,718,1192,490,680,474,190,0.99396724
82,2,car,720,1192,491,680,472,189,0.99402833
83,2,car,720,1188,490,681,468,191,0.9936452
84,2,car,722,1188,490,681,466,191,0.9941867
85,2,car,722,1189,490,681,467,191,0.99316216
86,2,car,721,1191,490,681,470,191,0.9934978
87,2,car,722,1192,491,679,470,188,0.9947086
88,2,car,719,1191,490,680,472,190,0.99448395
89,2,car,721,1190,490,681,469,191,0.9950352
90,2,car,718,1192,491,680,474,189,0.9946807
91,2,car,720,1190,491,680,470,189,0.9939705
92,2,car,721,1189,490,680,468,190,0.99420947
93,2,car,721,1188,491,679,467,188,0.9941135
94,2,car,720,1190,491,680,470,189,0.99439865
95,2,car,721,1190,490,680,469,190,0.9935835
96,2,car,720,1190,490,680,470,190,0.99316007
97,2,car,720,1190,490,680,470,190,0.99366015
98,2,car,723,1188,491,680,465,189,0.9940172
99,2,car,723,1190,491,680,467,189,0.9925984
100,2,car,720,1189,491,679,469,188,0.99389535
101,2,car,720,1192,491,680,472,189,0.9947525
102,2,car,720,1189,490,681,469,191,0.99338204
103,2,car,723,1190,490,680,467,190,0.993658
104,2,car,722,1191,490,681,469,191,0.9944046
105,2,car,723,1189,491,680,466,189,0.9941147
106,2,car,592,912,482,651,320,169,0.9904916
107,2,car,593,912,482,651,319,169,0.99101853
108,2,car,591,911,482,650,320,168,0.99045604
0,2,car,718,1190,490,680,472,190,0.99366164
1,2,car,724,1188,491,679,464,188,0.99361384
2,2,car,718,1190,490,680,472,190,0.9941106
3,2,car,720,1192,490,681,472,191,0.9934201
4,2,car,721,1192,491,679,471,188,0.99110234
5,2,car,721,1189,489,681,468,192,0.9942035
6,2,car,720,1192,490,680,472,190,0.9943143
7,2,car,720,1189,491,680,469,189,0.99289626
8,2,car,720,1188,490,681,468,191,0.9936275
9,2,car,721,1188,490,680,467,190,0.99227583
10,2,car,723,1189,490,680,466,190,0.9946215
11,2,car,719,1191,491,679,472,188,0.99300593
12,2,car,718,1191,490,681,473,191,0.9933079
13,2,car,720,1188,490,680,468,190,0.99254847
14,2,car,722,1189,491,679,467,188,0.99210006
15,2,car,720,1188,491,680,468,189,0.9942964
16,2,car,722,1189,490,680,467,190,0.9929243
17,2,car,722,1189,490,680,467,190,0.99385345
18,2,car,722,1190,490,681,468,191,0.9937917
19,2,car,721,1188,491,679,467,188,0.9926908
20,2,car,721,1190,490,681,469,191,0.9932829
21,2,car,721,1190,491,680,469,189,0.9928404
22,2,car,721,1191,491,680,470,189,0.9943646
23,2,car,723,1189,491,680,466,189,0.9942534
24,2,car,720,1191,490,681,471,191,0.9926691
25,2,car,721,1191,491,680,470,189,0.9923738
26,2,car,721,1187,492,679,466,187,0.99343777
27,2,car,721,1190,491,680,469,189,0.9931046
28,2,car,722,1188,492,679,466,187,0.9910961
29,2,car,721,1192,491,680,471,189,0.9921725
30,2,car,723,1190,490,680,467,190,0.9929821
31,2,car,723,1190,492,679,467,187,0.99407345
32,2,car,721,1189,490,680,468,190,0.99229693
33,2,car,720,1190,490,681,470,191,0.9942689
34,2,car,722,1190,491,680,468,189,0.9946975
35,2,car,722,1189,492,679,467,187,0.9933555
36,2,car,719,1191,491,680,472,189,0.99077785
37,2,car,720,1189,492,678,469,186,0.99275035
38,2,car,719,1192,491,680,473,189,0.99213934
39,2,car,724,1188,491,679,464,188,0.9937347
40,2,car,721,1191,490,680,470,190,0.9937846
41,2,car,724,1189,489,681,465,192,0.99227536
42,2,car,721,1191,490,681,470,191,0.99170077
43,2,car,722,1189,492,678,467,186,0.99312747
44,2,car,722,1189,490,680,467,190,0.9928037
45,2,car,722,1191,491,680,469,189,0.9921203
46,2,car,722,1189,490,681,467,191,0.9922209
47,2,car,721,1192,490,681,471,191,0.9930029
48,2,car,721,1191,491,680,470,189,0.99370116
49,2,car,721,1192,491,679,471,188,0.99167436
50,2,car,720,1191,489,681,471,192,0.99269456
51,2,car,721,1190,491,680,469,189,0.993381
52,2,car,718,1190,490,681,472,191,0.99364763
53,2,car,722,1193,490,680,471,190,0.99402285
54,2,car,719,1192,490,680,473,190,0.99388003
55,2,car,723,1192,490,680,469,190,0.992976
56,2,car,721,1190,491,680,469,189,0.99315363
57,2,car,721,1190,491,680,469,189,0.9950945
58,2,car,719,1191,490,681,472,191,0.99357724
59,2,car,723,1191,491,680,468,189,0.99360245
60,2,car,721,1190,491,680,469,189,0.99408567
61,2,car,722,1191,490,680,469,190,0.99388546
62,2,car,719,1189,490,681,470,191,0.9933415
63,2,car,721,1189,490,681,468,191,0.99309224
64,2,car,720,1189,490,680,469,190,0.9933535
65,2,car,721,1189,490,680,468,190,0.99278355
66,2,car,722,1191,491,679,469,188,0.99334544
67,2,car,721,1189,491,679,468,188,0.9922223
68,2,car,721,1192,491,679,471,188,0.99353355
69,2,car,721,1190,491,680,469,189,0.9941834
70,2,car,721,1192,490,680,471,190,0.9927697
71,2,car,723,1187,491,680,464,189,0.9929273
72,2,car,720,1192,491,680,472,189,0.9943153
73,2,car,721,1190,490,680,469,190,0.9937749
74,2,car,721,1189,491,680,468,189,0.9938193
75,2,car,721,1193,490,681,472,191,0.9946054
76,2,car,721,1190,490,681,469,191,0.99308574
77,2,car,721,1191,490,680,470,190,0.99485815
78,2,car,719,1191,490,680,472,190,0.99378115
79,2,car,719,1192,490,681,473,191,0.994926
80,2,car,722,1192,490,680,470,190,0.9945114
81,2,car,722,1190,490,680,468,190,0.99356544
82,2,car,718,1192,490,680,474,190,0.99396724
83,2,car,720,1192,491,680,472,189,0.99402833
84,2,car,720,1188,490,681,468,191,0.9936452
85,2,car,722,1188,490,681,466,191,0.9941867
86,2,car,722,1189,490,681,467,191,0.99316216
87,2,car,721,1191,490,681,470,191,0.9934978
88,2,car,722,1192,491,679,470,188,0.9947086
89,2,car,719,1191,490,680,472,190,0.99448395
90,2,car,721,1190,490,681,469,191,0.9950352
91,2,car,718,1192,491,680,474,189,0.9946807
92,2,car,720,1190,491,680,470,189,0.9939705
93,2,car,721,1189,490,680,468,190,0.99420947
94,2,car,721,1188,491,679,467,188,0.9941135
95,2,car,720,1190,491,680,470,189,0.99439865
96,2,car,721,1190,490,680,469,190,0.9935835
97,2,car,720,1190,490,680,470,190,0.99316007
98,2,car,720,1190,490,680,470,190,0.99366015
99,2,car,723,1188,491,680,465,189,0.9940172
100,2,car,723,1190,491,680,467,189,0.9925984
101,2,car,720,1189,491,679,469,188,0.99389535
102,2,car,720,1192,491,680,472,189,0.9947525
103,2,car,720,1189,490,681,469,191,0.99338204
104,2,car,723,1190,490,680,467,190,0.993658
105,2,car,722,1191,490,681,469,191,0.9944046
106,2,car,723,1189,491,680,466,189,0.9941147
107,2,car,592,912,482,651,320,169,0.9904916
108,2,car,593,912,482,651,319,169,0.99101853
109,2,car,591,911,482,650,320,168,0.99045604
0,2,car,720,1190,491,679,470,188,0.99336284
1,2,car,718,1190,490,680,472,190,0.99366164
2,2,car,724,1188,491,679,464,188,0.99361384
3,2,car,718,1190,490,680,472,190,0.9941106
4,2,car,720,1192,490,681,472,191,0.9934201
5,2,car,721,1192,491,679,471,188,0.99110234
6,2,car,721,1189,489,681,468,192,0.9942035
7,2,car,720,1192,490,680,472,190,0.9943143
8,2,car,720,1189,491,680,469,189,0.99289626
9,2,car,720,1188,490,681,468,191,0.9936275
10,2,car,721,1188,490,680,467,190,0.99227583
11,2,car,723,1189,490,680,466,190,0.9946215
12,2,car,719,1191,491,679,472,188,0.99300593
13,2,car,718,1191,490,681,473,191,0.9933079
14,2,car,720,1188,490,680,468,190,0.99254847
15,2,car,722,1189,491,679,467,188,0.99210006
16,2,car,720,1188,491,680,468,189,0.9942964
17,2,car,722,1189,490,680,467,190,0.9929243
18,2,car,722,1189,490,680,467,190,0.99385345
19,2,car,722,1190,490,681,468,191,0.9937917
20,2,car,721,1188,491,679,467,188,0.9926908
21,2,car,721,1190,490,681,469,191,0.9932829
22,2,car,721,1190,491,680,469,189,0.9928404
23,2,car,721,1191,491,680,470,189,0.9943646
24,2,car,723,1189,491,680,466,189,0.9942534
25,2,car,720,1191,490,681,471,191,0.9926691
26,2,car,721,1191,491,680,470,189,0.9923738
27,2,car,721,1187,492,679,466,187,0.99343777
28,2,car,721,1190,491,680,469,189,0.9931046
29,2,car,722,1188,492,679,466,187,0.9910961
30,2,car,721,1192,491,680,471,189,0.9921725
31,2,car,723,1190,490,680,467,190,0.9929821
32,2,car,723,1190,492,679,467,187,0.99407345
33,2,car,721,1189,490,680,468,190,0.99229693
34,2,car,720,1190,490,681,470,191,0.9942689
35,2,car,722,1190,491,680,468,189,0.9946975
36,2,car,722,1189,492,679,467,187,0.9933555
37,2,car,719,1191,491,680,472,189,0.99077785
38,2,car,720,1189,492,678,469,186,0.99275035
39,2,car,719,1192,491,680,473,189,0.99213934
40,2,car,724,1188,491,679,464,188,0.9937347
41,2,car,721,1191,490,680,470,190,0.9937846
42,2,car,724,1189,489,681,465,192,0.99227536
43,2,car,721,1191,490,681,470,191,0.99170077
44,2,car,722,1189,492,678,467,186,0.99312747
45,2,car,722,1189,490,680,467,190,0.9928037
46,2,car,722,1191,491,680,469,189,0.9921203
47,2,car,722,1189,490,681,467,191,0.9922209
48,2,car,721,1192,490,681,471,191,0.9930029
49,2,car,721,1191,491,680,470,189,0.99370116
50,2,car,721,1192,491,679,471,188,0.99167436
51,2,car,720,1191,489,681,471,192,0.99269456
52,2,car,721,1190,491,680,469,189,0.993381
53,2,car,718,1190,490,681,472,191,0.99364763
54,2,car,722,1193,490,680,471,190,0.99402285
55,2,car,719,1192,490,680,473,190,0.99388003
56,2,car,723,1192,490,680,469,190,0.992976
57,2,car,721,1190,491,680,469,189,0.99315363
58,2,car,721,1190,491,680,469,189,0.9950945
59,2,car,719,1191,490,681,472,191,0.99357724
60,2,car,723,1191,491,680,468,189,0.99360245
61,2,car,721,1190,491,680,469,189,0.99408567
62,2,car,722,1191,490,680,469,190,0.99388546
63,2,car,719,1189,490,681,470,191,0.9933415
64,2,car,721,1189,490,681,468,191,0.99309224
65,2,car,720,1189,490,680,469,190,0.9933535
66,2,car,721,1189,490,680,468,190,0.99278355
67,2,car,722,1191,491,679,469,188,0.99334544
68,2,car,721,1189,491,679,468,188,0.9922223
69,2,car,721,1192,491,679,471,188,0.99353355
70,2,car,721,1190,491,680,469,189,0.9941834
71,2,car,721,1192,490,680,471,190,0.9927697
72,2,car,723,1187,491,680,464,189,0.9929273
73,2,car,720,1192,491,680,472,189,0.9943153
74,2,car,721,1190,490,680,469,190,0.9937749
75,2,car,721,1189,491,680,468,189,0.9938193
76,2,car,721,1193,490,681,472,191,0.9946054
77,2,car,721,1190,490,681,469,191,0.99308574
78,2,car,721,1191,490,680,470,190,0.99485815
79,2,car,719,1191,490,680,472,190,0.99378115
80,2,car,719,1192,490,681,473,191,0.994926
81,2,car,722,1192,490,680,470,190,0.9945114
82,2,car,722,1190,490,680,468,190,0.99356544
83,2,car,718,1192,490,680,474,190,0.99396724
84,2,car,720,1192,491,680,472,189,0.99402833
85,2,car,720,1188,490,681,468,191,0.9936452
86,2,car,722,1188,490,681,466,191,0.9941867
87,2,car,722,1189,490,681,467,191,0.99316216
88,2,car,721,1191,490,681,470,191,0.9934978
89,2,car,722,1192,491,679,470,188,0.9947086
90,2,car,719,1191,490,680,472,190,0.99448395
91,2,car,721,1190,490,681,469,191,0.9950352
92,2,car,718,1192,491,680,474,189,0.9946807
93,2,car,720,1190,491,680,470,189,0.9939705
94,2,car,721,1189,490,680,468,190,0.99420947
95,2,car,721,1188,491,679,467,188,0.9941135
96,2,car,720,1190,491,680,470,189,0.99439865
97,2,car,721,1190,490,680,469,190,0.9935835
98,2,car,720,1190,490,680,470,190,0.99316007
99,2,car,720,1190,490,680,470,190,0.99366015
100,2,car,723,1188,491,680,465,189,0.9940172
101,2,car,723,1190,491,680,467,189,0.9925984
102,2,car,720,1189,491,679,469,188,0.99389535
103,2,car,720,1192,491,680,472,189,0.9947525
104,2,car,720,1189,490,681,469,191,0.99338204
105,2,car,723,1190,490,680,467,190,0.993658
106,2,car,722,1191,490,681,469,191,0.9944046
107,2,car,723,1189,491,680,466,189,0.9941147
108,2,car,592,912,482,651,320,169,0.9904916
109,2,car,593,912,482,651,319,169,0.99101853
110,2,car,591,911,482,650,320,168,0.99045604
0,2,car,721,1190,491,680,469,189,0.9937746
1,2,car,720,1190,491,679,470,188,0.99336284
2,2,car,718,1190,490,680,472,190,0.99366164
3,2,car,724,1188,491,679,464,188,0.99361384
4,2,car,718,1190,490,680,472,190,0.9941106
5,2,car,720,1192,490,681,472,191,0.9934201
6,2,car,721,1192,491,679,471,188,0.99110234
7,2,car,721,1189,489,681,468,192,0.9942035
8,2,car,720,1192,490,680,472,190,0.9943143
9,2,car,720,1189,491,680,469,189,0.99289626
10,2,car,720,1188,490,681,468,191,0.9936275
11,2,car,721,1188,490,680,467,190,0.99227583
12,2,car,723,1189,490,680,466,190,0.9946215
13,2,car,719,1191,491,679,472,188,0.99300593
14,2,car,718,1191,490,681,473,191,0.9933079
15,2,car,720,1188,490,680,468,190,0.99254847
16,2,car,722,1189,491,679,467,188,0.99210006
17,2,car,720,1188,491,680,468,189,0.9942964
18,2,car,722,1189,490,680,467,190,0.9929243
19,2,car,722,1189,490,680,467,190,0.99385345
20,2,car,722,1190,490,681,468,191,0.9937917
21,2,car,721,1188,491,679,467,188,0.9926908
22,2,car,721,1190,490,681,469,191,0.9932829
23,2,car,721,1190,491,680,469,189,0.9928404
24,2,car,721,1191,491,680,470,189,0.9943646
25,2,car,723,1189,491,680,466,189,0.9942534
26,2,car,720,1191,490,681,471,191,0.9926691
27,2,car,721,1191,491,680,470,189,0.9923738
28,2,car,721,1187,492,679,466,187,0.99343777
29,2,car,721,1190,491,680,469,189,0.9931046
30,2,car,722,1188,492,679,466,187,0.9910961
31,2,car,721,1192,491,680,471,189,0.9921725
32,2,car,723,1190,490,680,467,190,0.9929821
33,2,car,723,1190,492,679,467,187,0.99407345
34,2,car,721,1189,490,680,468,190,0.99229693
35,2,car,720,1190,490,681,470,191,0.9942689
36,2,car,722,1190,491,680,468,189,0.9946975
37,2,car,722,1189,492,679,467,187,0.9933555
38,2,car,719,1191,491,680,472,189,0.99077785
39,2,car,720,1189,492,678,469,186,0.99275035
40,2,car,719,1192,491,680,473,189,0.99213934
41,2,car,724,1188,491,679,464,188,0.9937347
42,2,car,721,1191,490,680,470,190,0.9937846
43,2,car,724,1189,489,681,465,192,0.99227536
44,2,car,721,1191,490,681,470,191,0.99170077
45,2,car,722,1189,492,678,467,186,0.99312747
46,2,car,722,1189,490,680,467,190,0.9928037
47,2,car,722,1191,491,680,469,189,0.9921203
48,2,car,722,1189,490,681,467,191,0.9922209
49,2,car,721,1192,490,681,471,191,0.9930029
50,2,car,721,1191,491,680,470,189,0.99370116
51,2,car,721,1192,491,679,471,188,0.99167436
52,2,car,720,1191,489,681,471,192,0.99269456
53,2,car,721,1190,491,680,469,189,0.993381
54,2,car,718,1190,490,681,472,191,0.99364763
55,2,car,722,1193,490,680,471,190,0.99402285
56,2,car,719,1192,490,680,473,190,0.99388003
57,2,car,723,1192,490,680,469,190,0.992976
58,2,car,721,1190,491,680,469,189,0.99315363
59,2,car,721,1190,491,680,469,189,0.9950945
60,2,car,719,1191,490,681,472,191,0.99357724
61,2,car,723,1191,491,680,468,189,0.99360245
62,2,car,721,1190,491,680,469,189,0.99408567
63,2,car,722,1191,490,680,469,190,0.99388546
64,2,car,719,1189,490,681,470,191,0.9933415
65,2,car,721,1189,490,681,468,191,0.99309224
66,2,car,720,1189,490,680,469,190,0.9933535
67,2,car,721,1189,490,680,468,190,0.99278355
68,2,car,722,1191,491,679,469,188,0.99334544
69,2,car,721,1189,491,679,468,188,0.9922223
70,2,car,721,1192,491,679,471,188,0.99353355
71,2,car,721,1190,491,680,469,189,0.9941834
72,2,car,721,1192,490,680,471,190,0.9927697
73,2,car,723,1187,491,680,464,189,0.9929273
74,2,car,720,1192,491,680,472,189,0.9943153
75,2,car,721,1190,490,680,469,190,0.9937749
76,2,car,721,1189,491,680,468,189,0.9938193
77,2,car,721,1193,490,681,472,191,0.9946054
78,2,car,721,1190,490,681,469,191,0.99308574
79,2,car,721,1191,490,680,470,190,0.99485815
80,2,car,719,1191,490,680,472,190,0.99378115
81,2,car,719,1192,490,681,473,191,0.994926
82,2,car,722,1192,490,680,470,190,0.9945114
83,2,car,722,1190,490,680,468,190,0.99356544
84,2,car,718,1192,490,680,474,190,0.99396724
85,2,car,720,1192,491,680,472,189,0.99402833
86,2,car,720,1188,490,681,468,191,0.9936452
87,2,car,722,1188,490,681,466,191,0.9941867
88,2,car,722,1189,490,681,467,191,0.99316216
89,2,car,721,1191,490,681,470,191,0.9934978
90,2,car,722,1192,491,679,470,188,0.9947086
91,2,car,719,1191,490,680,472,190,0.99448395
92,2,car,721,1190,490,681,469,191,0.9950352
93,2,car,718,1192,491,680,474,189,0.9946807
94,2,car,720,1190,491,680,470,189,0.9939705
95,2,car,721,1189,490,680,468,190,0.99420947
96,2,car,721,1188,491,679,467,188,0.9941135
97,2,car,720,1190,491,680,470,189,0.99439865
98,2,car,721,1190,490,680,469,190,0.9935835
99,2,car,720,1190,490,680,470,190,0.99316007
100,2,car,720,1190,490,680,470,190,0.99366015
101,2,car,723,1188,491,680,465,189,0.9940172
102,2,car,723,1190,491,680,467,189,0.9925984
103,2,car,720,1189,491,679,469,188,0.99389535
104,2,car,720,1192,491,680,472,189,0.9947525
105,2,car,720,1189,490,681,469,191,0.99338204
106,2,car,723,1190,490,680,467,190,0.993658
107,2,car,722,1191,490,681,469,191,0.9944046
108,2,car,723,1189,491,680,466,189,0.9941147
109,2,car,592,912,482,651,320,169,0.9904916
110,2,car,593,912,482,651,319,169,0.99101853
111,2,car,591,911,482,650,320,168,0.99045604
0,2,car,720,1191,490,680,471,190,0.9934036
1,2,car,721,1190,491,680,469,189,0.9937746
2,2,car,720,1190,491,679,470,188,0.99336284
3,2,car,718,1190,490,680,472,190,0.99366164
4,2,car,724,1188,491,679,464,188,0.99361384
5,2,car,718,1190,490,680,472,190,0.9941106
6,2,car,720,1192,490,681,472,191,0.9934201
7,2,car,721,1192,491,679,471,188,0.99110234
8,2,car,721,1189,489,681,468,192,0.9942035
9,2,car,720,1192,490,680,472,190,0.9943143
10,2,car,720,1189,491,680,469,189,0.99289626
11,2,car,720,1188,490,681,468,191,0.9936275
12,2,car,721,1188,490,680,467,190,0.99227583
13,2,car,723,1189,490,680,466,190,0.9946215
14,2,car,719,1191,491,679,472,188,0.99300593
15,2,car,718,1191,490,681,473,191,0.9933079
16,2,car,720,1188,490,680,468,190,0.99254847
17,2,car,722,1189,491,679,467,188,0.99210006
18,2,car,720,1188,491,680,468,189,0.9942964
19,2,car,722,1189,490,680,467,190,0.9929243
20,2,car,722,1189,490,680,467,190,0.99385345
21,2,car,722,1190,490,681,468,191,0.9937917
22,2,car,721,1188,491,679,467,188,0.9926908
23,2,car,721,1190,490,681,469,191,0.9932829
24,2,car,721,1190,491,680,469,189,0.9928404
25,2,car,721,1191,491,680,470,189,0.9943646
26,2,car,723,1189,491,680,466,189,0.9942534
27,2,car,720,1191,490,681,471,191,0.9926691
28,2,car,721,1191,491,680,470,189,0.9923738
29,2,car,721,1187,492,679,466,187,0.99343777
30,2,car,721,1190,491,680,469,189,0.9931046
31,2,car,722,1188,492,679,466,187,0.9910961
32,2,car,721,1192,491,680,471,189,0.9921725
33,2,car,723,1190,490,680,467,190,0.9929821
34,2,car,723,1190,492,679,467,187,0.99407345
35,2,car,721,1189,490,680,468,190,0.99229693
36,2,car,720,1190,490,681,470,191,0.9942689
37,2,car,722,1190,491,680,468,189,0.9946975
38,2,car,722,1189,492,679,467,187,0.9933555
39,2,car,719,1191,491,680,472,189,0.99077785
40,2,car,720,1189,492,678,469,186,0.99275035
41,2,car,719,1192,491,680,473,189,0.99213934
42,2,car,724,1188,491,679,464,188,0.9937347
43,2,car,721,1191,490,680,470,190,0.9937846
44,2,car,724,1189,489,681,465,192,0.99227536
45,2,car,721,1191,490,681,470,191,0.99170077
46,2,car,722,1189,492,678,467,186,0.99312747
47,2,car,722,1189,490,680,467,190,0.9928037
48,2,car,722,1191,491,680,469,189,0.9921203
49,2,car,722,1189,490,681,467,191,0.9922209
50,2,car,721,1192,490,681,471,191,0.9930029
51,2,car,721,1191,491,680,470,189,0.99370116
52,2,car,721,1192,491,679,471,188,0.99167436
53,2,car,720,1191,489,681,471,192,0.99269456
54,2,car,721,1190,491,680,469,189,0.993381
55,2,car,718,1190,490,681,472,191,0.99364763
56,2,car,722,1193,490,680,471,190,0.99402285
57,2,car,719,1192,490,680,473,190,0.99388003
58,2,car,723,1192,490,680,469,190,0.992976
59,2,car,721,1190,491,680,469,189,0.99315363
60,2,car,721,1190,491,680,469,189,0.9950945
61,2,car,719,1191,490,681,472,191,0.99357724
62,2,car,723,1191,491,680,468,189,0.99360245
63,2,car,721,1190,491,680,469,189,0.99408567
64,2,car,722,1191,490,680,469,190,0.99388546
65,2,car,719,1189,490,681,470,191,0.9933415
66,2,car,721,1189,490,681,468,191,0.99309224
67,2,car,720,1189,490,680,469,190,0.9933535
68,2,car,721,1189,490,680,468,190,0.99278355
69,2,car,722,1191,491,679,469,188,0.99334544
70,2,car,721,1189,491,679,468,188,0.9922223
71,2,car,721,1192,491,679,471,188,0.99353355
72,2,car,721,1190,491,680,469,189,0.9941834
73,2,car,721,1192,490,680,471,190,0.9927697
74,2,car,723,1187,491,680,464,189,0.9929273
75,2,car,720,1192,491,680,472,189,0.9943153
76,2,car,721,1190,490,680,469,190,0.9937749
77,2,car,721,1189,491,680,468,189,0.9938193
78,2,car,721,1193,490,681,472,191,0.9946054
79,2,car,721,1190,490,681,469,191,0.99308574
80,2,car,721,1191,490,680,470,190,0.99485815
81,2,car,719,1191,490,680,472,190,0.99378115
82,2,car,719,1192,490,681,473,191,0.994926
83,2,car,722,1192,490,680,470,190,0.9945114
84,2,car,722,1190,490,680,468,190,0.99356544
85,2,car,718,1192,490,680,474,190,0.99396724
86,2,car,720,1192,491,680,472,189,0.99402833
87,2,car,720,1188,490,681,468,191,0.9936452
88,2,car,722,1188,490,681,466,191,0.9941867
89,2,car,722,1189,490,681,467,191,0.99316216
90,2,car,721,1191,490,681,470,191,0.9934978
91,2,car,722,1192,491,679,470,188,0.9947086
92,2,car,719,1191,490,680,472,190,0.99448395
93,2,car,721,1190,490,681,469,191,0.9950352
94,2,car,718,1192,491,680,474,189,0.9946807
95,2,car,720,1190,491,680,470,189,0.9939705
96,2,car,721,1189,490,680,468,190,0.99420947
97,2,car,721,1188,491,679,467,188,0.9941135
98,2,car,720,1190,491,680,470,189,0.99439865
99,2,car,721,1190,490,680,469,190,0.9935835
100,2,car,720,1190,490,680,470,190,0.99316007
101,2,car,720,1190,490,680,470,190,0.99366015
102,2,car,723,1188,491,680,465,189,0.9940172
103,2,car,723,1190,491,680,467,189,0.9925984
104,2,car,720,1189,491,679,469,188,0.99389535
105,2,car,720,1192,491,680,472,189,0.9947525
106,2,car,720,1189,490,681,469,191,0.99338204
107,2,car,723,1190,490,680,467,190,0.993658
108,2,car,722,1191,490,681,469,191,0.9944046
109,2,car,723,1189,491,680,466,189,0.9941147
110,2,car,592,912,482,651,320,169,0.9904916
111,2,car,593,912,482,651,319,169,0.99101853
112,2,car,591,911,482,650,320,168,0.99045604
0,2,car,721,1189,490,681,468,191,0.9929695
1,2,car,720,1191,490,680,471,190,0.9934036
2,2,car,721,1190,491,680,469,189,0.9937746
3,2,car,720,1190,491,679,470,188,0.99336284
4,2,car,718,1190,490,680,472,190,0.99366164
5,2,car,724,1188,491,679,464,188,0.99361384
6,2,car,718,1190,490,680,472,190,0.9941106
7,2,car,720,1192,490,681,472,191,0.9934201
8,2,car,721,1192,491,679,471,188,0.99110234
9,2,car,721,1189,489,681,468,192,0.9942035
10,2,car,720,1192,490,680,472,190,0.9943143
11,2,car,720,1189,491,680,469,189,0.99289626
12,2,car,720,1188,490,681,468,191,0.9936275
13,2,car,721,1188,490,680,467,190,0.99227583
14,2,car,723,1189,490,680,466,190,0.9946215
15,2,car,719,1191,491,679,472,188,0.99300593
16,2,car,718,1191,490,681,473,191,0.9933079
17,2,car,720,1188,490,680,468,190,0.99254847
18,2,car,722,1189,491,679,467,188,0.99210006
19,2,car,720,1188,491,680,468,189,0.9942964
20,2,car,722,1189,490,680,467,190,0.9929243
21,2,car,722,1189,490,680,467,190,0.99385345
22,2,car,722,1190,490,681,468,191,0.9937917
23,2,car,721,1188,491,679,467,188,0.9926908
24,2,car,721,1190,490,681,469,191,0.9932829
25,2,car,721,1190,491,680,469,189,0.9928404
26,2,car,721,1191,491,680,470,189,0.9943646
27,2,car,723,1189,491,680,466,189,0.9942534
28,2,car,720,1191,490,681,471,191,0.9926691
29,2,car,721,1191,491,680,470,189,0.9923738
30,2,car,721,1187,492,679,466,187,0.99343777
31,2,car,721,1190,491,680,469,189,0.9931046
32,2,car,722,1188,492,679,466,187,0.9910961
33,2,car,721,1192,491,680,471,189,0.9921725
34,2,car,723,1190,490,680,467,190,0.9929821
35,2,car,723,1190,492,679,467,187,0.99407345
36,2,car,721,1189,490,680,468,190,0.99229693
37,2,car,720,1190,490,681,470,191,0.9942689
38,2,car,722,1190,491,680,468,189,0.9946975
39,2,car,722,1189,492,679,467,187,0.9933555
40,2,car,719,1191,491,680,472,189,0.99077785
41,2,car,720,1189,492,678,469,186,0.99275035
42,2,car,719,1192,491,680,473,189,0.99213934
43,2,car,724,1188,491,679,464,188,0.9937347
44,2,car,721,1191,490,680,470,190,0.9937846
45,2,car,724,1189,489,681,465,192,0.99227536
46,2,car,721,1191,490,681,470,191,0.99170077
47,2,car,722,1189,492,678,467,186,0.99312747
48,2,car,722,1189,490,680,467,190,0.9928037
49,2,car,722,1191,491,680,469,189,0.9921203
50,2,car,722,1189,490,681,467,191,0.9922209
51,2,car,721,1192,490,681,471,191,0.9930029
52,2,car,721,1191,491,680,470,189,0.99370116
53,2,car,721,1192,491,679,471,188,0.99167436
54,2,car,720,1191,489,681,471,192,0.99269456
55,2,car,721,1190,491,680,469,189,0.993381
56,2,car,718,1190,490,681,472,191,0.99364763
57,2,car,722,1193,490,680,471,190,0.99402285
58,2,car,719,1192,490,680,473,190,0.99388003
59,2,car,723,1192,490,680,469,190,0.992976
60,2,car,721,1190,491,680,469,189,0.99315363
61,2,car,721,1190,491,680,469,189,0.9950945
62,2,car,719,1191,490,681,472,191,0.99357724
63,2,car,723,1191,491,680,468,189,0.99360245
64,2,car,721,1190,491,680,469,189,0.99408567
65,2,car,722,1191,490,680,469,190,0.99388546
66,2,car,719,1189,490,681,470,191,0.9933415
67,2,car,721,1189,490,681,468,191,0.99309224
68,2,car,720,1189,490,680,469,190,0.9933535
69,2,car,721,1189,490,680,468,190,0.99278355
70,2,car,722,1191,491,679,469,188,0.99334544
71,2,car,721,1189,491,679,468,188,0.9922223
72,2,car,721,1192,491,679,471,188,0.99353355
73,2,car,721,1190,491,680,469,189,0.9941834
74,2,car,721,1192,490,680,471,190,0.9927697
75,2,car,723,1187,491,680,464,189,0.9929273
76,2,car,720,1192,491,680,472,189,0.9943153
77,2,car,721,1190,490,680,469,190,0.9937749
78,2,car,721,1189,491,680,468,189,0.9938193
79,2,car,721,1193,490,681,472,191,0.9946054
80,2,car,721,1190,490,681,469,191,0.99308574
81,2,car,721,1191,490,680,470,190,0.99485815
82,2,car,719,1191,490,680,472,190,0.99378115
83,2,car,719,1192,490,681,473,191,0.994926
84,2,car,722,1192,490,680,470,190,0.9945114
85,2,car,722,1190,490,680,468,190,0.99356544
86,2,car,718,1192,490,680,474,190,0.99396724
87,2,car,720,1192,491,680,472,189,0.99402833
88,2,car,720,1188,490,681,468,191,0.9936452
89,2,car,722,1188,490,681,466,191,0.9941867
90,2,car,722,1189,490,681,467,191,0.99316216
91,2,car,721,1191,490,681,470,191,0.9934978
92,2,car,722,1192,491,679,470,188,0.9947086
93,2,car,719,1191,490,680,472,190,0.99448395
94,2,car,721,1190,490,681,469,191,0.9950352
95,2,car,718,1192,491,680,474,189,0.9946807
96,2,car,720,1190,491,680,470,189,0.9939705
97,2,car,721,1189,490,680,468,190,0.99420947
98,2,car,721,1188,491,679,467,188,0.9941135
99,2,car,720,1190,491,680,470,189,0.99439865
100,2,car,721,1190,490,680,469,190,0.9935835
101,2,car,720,1190,490,680,470,190,0.99316007
102,2,car,720,1190,490,680,470,190,0.99366015
103,2,car,723,1188,491,680,465,189,0.9940172
104,2,car,723,1190,491,680,467,189,0.9925984
105,2,car,720,1189,491,679,469,188,0.99389535
106,2,car,720,1192,491,680,472,189,0.9947525
107,2,car,720,1189,490,681,469,191,0.99338204
108,2,car,723,1190,490,680,467,190,0.993658
109,2,car,722,1191,490,681,469,191,0.9944046
110,2,car,723,1189,491,680,466,189,0.9941147
111,2,car,592,912,482,651,320,169,0.9904916
112,2,car,593,912,482,651,319,169,0.99101853
113,2,car,591,911,482,650,320,168,0.99045604
0,2,car,722,1192,490,680,470,190,0.99354243
1,2,car,721,1189,490,681,468,191,0.9929695
2,2,car,720,1191,490,680,471,190,0.9934036
3,2,car,721,1190,491,680,469,189,0.9937746
4,2,car,720,1190,491,679,470,188,0.99336284
5,2,car,718,1190,490,680,472,190,0.99366164
6,2,car,724,1188,491,679,464,188,0.99361384
7,2,car,718,1190,490,680,472,190,0.9941106
8,2,car,720,1192,490,681,472,191,0.9934201
9,2,car,721,1192,491,679,471,188,0.99110234
10,2,car,721,1189,489,681,468,192,0.9942035
11,2,car,720,1192,490,680,472,190,0.9943143
12,2,car,720,1189,491,680,469,189,0.99289626
13,2,car,720,1188,490,681,468,191,0.9936275
14,2,car,721,1188,490,680,467,190,0.99227583
15,2,car,723,1189,490,680,466,190,0.9946215
16,2,car,719,1191,491,679,472,188,0.99300593
17,2,car,718,1191,490,681,473,191,0.9933079
18,2,car,720,1188,490,680,468,190,0.99254847
19,2,car,722,1189,491,679,467,188,0.99210006
20,2,car,720,1188,491,680,468,189,0.9942964
21,2,car,722,1189,490,680,467,190,0.9929243
22,2,car,722,1189,490,680,467,190,0.99385345
23,2,car,722,1190,490,681,468,191,0.9937917
24,2,car,721,1188,491,679,467,188,0.9926908
25,2,car,721,1190,490,681,469,191,0.9932829
26,2,car,721,1190,491,680,469,189,0.9928404
27,2,car,721,1191,491,680,470,189,0.9943646
28,2,car,723,1189,491,680,466,189,0.9942534
29,2,car,720,1191,490,681,471,191,0.9926691
30,2,car,721,1191,491,680,470,189,0.9923738
31,2,car,721,1187,492,679,466,187,0.99343777
32,2,car,721,1190,491,680,469,189,0.9931046
33,2,car,722,1188,492,679,466,187,0.9910961
34,2,car,721,1192,491,680,471,189,0.9921725
35,2,car,723,1190,490,680,467,190,0.9929821
36,2,car,723,1190,492,679,467,187,0.99407345
37,2,car,721,1189,490,680,468,190,0.99229693
38,2,car,720,1190,490,681,470,191,0.9942689
39,2,car,722,1190,491,680,468,189,0.9946975
40,2,car,722,1189,492,679,467,187,0.9933555
41,2,car,719,1191,491,680,472,189,0.99077785
42,2,car,720,1189,492,678,469,186,0.99275035
43,2,car,719,1192,491,680,473,189,0.99213934
44,2,car,724,1188,491,679,464,188,0.9937347
45,2,car,721,1191,490,680,470,190,0.9937846
46,2,car,724,1189,489,681,465,192,0.99227536
47,2,car,721,1191,490,681,470,191,0.99170077
48,2,car,722,1189,492,678,467,186,0.99312747
49,2,car,722,1189,490,680,467,190,0.9928037
50,2,car,722,1191,491,680,469,189,0.9921203
51,2,car,722,1189,490,681,467,191,0.9922209
52,2,car,721,1192,490,681,471,191,0.9930029
53,2,car,721,1191,491,680,470,189,0.99370116
54,2,car,721,1192,491,679,471,188,0.99167436
55,2,car,720,1191,489,681,471,192,0.99269456
56,2,car,721,1190,491,680,469,189,0.993381
57,2,car,718,1190,490,681,472,191,0.99364763
58,2,car,722,1193,490,680,471,190,0.99402285
59,2,car,719,1192,490,680,473,190,0.99388003
60,2,car,723,1192,490,680,469,190,0.992976
61,2,car,721,1190,491,680,469,189,0.99315363
62,2,car,721,1190,491,680,469,189,0.9950945
63,2,car,719,1191,490,681,472,191,0.99357724
64,2,car,723,1191,491,680,468,189,0.99360245
65,2,car,721,1190,491,680,469,189,0.99408567
66,2,car,722,1191,490,680,469,190,0.99388546
67,2,car,719,1189,490,681,470,191,0.9933415
68,2,car,721,1189,490,681,468,191,0.99309224
69,2,car,720,1189,490,680,469,190,0.9933535
70,2,car,721,1189,490,680,468,190,0.99278355
71,2,car,722,1191,491,679,469,188,0.99334544
72,2,car,721,1189,491,679,468,188,0.9922223
73,2,car,721,1192,491,679,471,188,0.99353355
74,2,car,721,1190,491,680,469,189,0.9941834
75,2,car,721,1192,490,680,471,190,0.9927697
76,2,car,723,1187,491,680,464,189,0.9929273
77,2,car,720,1192,491,680,472,189,0.9943153
78,2,car,721,1190,490,680,469,190,0.9937749
79,2,car,721,1189,491,680,468,189,0.9938193
80,2,car,721,1193,490,681,472,191,0.9946054
81,2,car,721,1190,490,681,469,191,0.99308574
82,2,car,721,1191,490,680,470,190,0.99485815
83,2,car,719,1191,490,680,472,190,0.99378115
84,2,car,719,1192,490,681,473,191,0.994926
85,2,car,722,1192,490,680,470,190,0.9945114
86,2,car,722,1190,490,680,468,190,0.99356544
87,2,car,718,1192,490,680,474,190,0.99396724
88,2,car,720,1192,491,680,472,189,0.99402833
89,2,car,720,1188,490,681,468,191,0.9936452
90,2,car,722,1188,490,681,466,191,0.9941867
91,2,car,722,1189,490,681,467,191,0.99316216
92,2,car,721,1191,490,681,470,191,0.9934978
93,2,car,722,1192,491,679,470,188,0.9947086
94,2,car,719,1191,490,680,472,190,0.99448395
95,2,car,721,1190,490,681,469,191,0.9950352
96,2,car,718,1192,491,680,474,189,0.9946807
97,2,car,720,1190,491,680,470,189,0.9939705
98,2,car,721,1189,490,680,468,190,0.99420947
99,2,car,721,1188,491,679,467,188,0.9941135
100,2,car,720,1190,491,680,470,189,0.99439865
101,2,car,721,1190,490,680,469,190,0.9935835
102,2,car,720,1190,490,680,470,190,0.99316007
103,2,car,720,1190,490,680,470,190,0.99366015
104,2,car,723,1188,491,680,465,189,0.9940172
105,2,car,723,1190,491,680,467,189,0.9925984
106,2,car,720,1189,491,679,469,188,0.99389535
107,2,car,720,1192,491,680,472,189,0.9947525
108,2,car,720,1189,490,681,469,191,0.99338204
109,2,car,723,1190,490,680,467,190,0.993658
110,2,car,722,1191,490,681,469,191,0.9944046
111,2,car,723,1189,491,680,466,189,0.9941147
112,2,car,592,912,482,651,320,169,0.9904916
113,2,car,593,912,482,651,319,169,0.99101853
114,2,car,591,911,482,650,320,168,0.99045604
0,2,car,721,1187,491,679,466,188,0.99360836
1,2,car,722,1192,490,680,470,190,0.99354243
2,2,car,721,1189,490,681,468,191,0.9929695
3,2,car,720,1191,490,680,471,190,0.9934036
4,2,car,721,1190,491,680,469,189,0.9937746
5,2,car,720,1190,491,679,470,188,0.99336284
6,2,car,718,1190,490,680,472,190,0.99366164
7,2,car,724,1188,491,679,464,188,0.99361384
8,2,car,718,1190,490,680,472,190,0.9941106
9,2,car,720,1192,490,681,472,191,0.9934201
10,2,car,721,1192,491,679,471,188,0.99110234
11,2,car,721,1189,489,681,468,192,0.9942035
12,2,car,720,1192,490,680,472,190,0.9943143
13,2,car,720,1189,491,680,469,189,0.99289626
14,2,car,720,1188,490,681,468,191,0.9936275
15,2,car,721,1188,490,680,467,190,0.99227583
16,2,car,723,1189,490,680,466,190,0.9946215
17,2,car,719,1191,491,679,472,188,0.99300593
18,2,car,718,1191,490,681,473,191,0.9933079
19,2,car,720,1188,490,680,468,190,0.99254847
20,2,car,722,1189,491,679,467,188,0.99210006
21,2,car,720,1188,491,680,468,189,0.9942964
22,2,car,722,1189,490,680,467,190,0.9929243
23,2,car,722,1189,490,680,467,190,0.99385345
24,2,car,722,1190,490,681,468,191,0.9937917
25,2,car,721,1188,491,679,467,188,0.9926908
26,2,car,721,1190,490,681,469,191,0.9932829
27,2,car,721,1190,491,680,469,189,0.9928404
28,2,car,721,1191,491,680,470,189,0.9943646
29,2,car,723,1189,491,680,466,189,0.9942534
30,2,car,720,1191,490,681,471,191,0.9926691
31,2,car,721,1191,491,680,470,189,0.9923738
32,2,car,721,1187,492,679,466,187,0.99343777
33,2,car,721,1190,491,680,469,189,0.9931046
34,2,car,722,1188,492,679,466,187,0.9910961
35,2,car,721,1192,491,680,471,189,0.9921725
36,2,car,723,1190,490,680,467,190,0.9929821
37,2,car,723,1190,492,679,467,187,0.99407345
38,2,car,721,1189,490,680,468,190,0.99229693
39,2,car,720,1190,490,681,470,191,0.9942689
40,2,car,722,1190,491,680,468,189,0.9946975
41,2,car,722,1189,492,679,467,187,0.9933555
42,2,car,719,1191,491,680,472,189,0.99077785
43,2,car,720,1189,492,678,469,186,0.99275035
44,2,car,719,1192,491,680,473,189,0.99213934
45,2,car,724,1188,491,679,464,188,0.9937347
46,2,car,721,1191,490,680,470,190,0.9937846
47,2,car,724,1189,489,681,465,192,0.99227536
48,2,car,721,1191,490,681,470,191,0.99170077
49,2,car,722,1189,492,678,467,186,0.99312747
50,2,car,722,1189,490,680,467,190,0.9928037
51,2,car,722,1191,491,680,469,189,0.9921203
52,2,car,722,1189,490,681,467,191,0.9922209
53,2,car,721,1192,490,681,471,191,0.9930029
54,2,car,721,1191,491,680,470,189,0.99370116
55,2,car,721,1192,491,679,471,188,0.99167436
56,2,car,720,1191,489,681,471,192,0.99269456
57,2,car,721,1190,491,680,469,189,0.993381
58,2,car,718,1190,490,681,472,191,0.99364763
59,2,car,722,1193,490,680,471,190,0.99402285
60,2,car,719,1192,490,680,473,190,0.99388003
61,2,car,723,1192,490,680,469,190,0.992976
62,2,car,721,1190,491,680,469,189,0.99315363
63,2,car,721,1190,491,680,469,189,0.9950945
64,2,car,719,1191,490,681,472,191,0.99357724
65,2,car,723,1191,491,680,468,189,0.99360245
66,2,car,721,1190,491,680,469,189,0.99408567
67,2,car,722,1191,490,680,469,190,0.99388546
68,2,car,719,1189,490,681,470,191,0.9933415
69,2,car,721,1189,490,681,468,191,0.99309224
70,2,car,720,1189,490,680,469,190,0.9933535
71,2,car,721,1189,490,680,468,190,0.99278355
72,2,car,722,1191,491,679,469,188,0.99334544
73,2,car,721,1189,491,679,468,188,0.9922223
74,2,car,721,1192,491,679,471,188,0.99353355
75,2,car,721,1190,491,680,469,189,0.9941834
76,2,car,721,1192,490,680,471,190,0.9927697
77,2,car,723,1187,491,680,464,189,0.9929273
78,2,car,720,1192,491,680,472,189,0.9943153
79,2,car,721,1190,490,680,469,190,0.9937749
80,2,car,721,1189,491,680,468,189,0.9938193
81,2,car,721,1193,490,681,472,191,0.9946054
82,2,car,721,1190,490,681,469,191,0.99308574
83,2,car,721,1191,490,680,470,190,0.99485815
84,2,car,719,1191,490,680,472,190,0.99378115
85,2,car,719,1192,490,681,473,191,0.994926
86,2,car,722,1192,490,680,470,190,0.9945114
87,2,car,722,1190,490,680,468,190,0.99356544
88,2,car,718,1192,490,680,474,190,0.99396724
89,2,car,720,1192,491,680,472,189,0.99402833
90,2,car,720,1188,490,681,468,191,0.9936452
91,2,car,722,1188,490,681,466,191,0.9941867
92,2,car,722,1189,490,681,467,191,0.99316216
93,2,car,721,1191,490,681,470,191,0.9934978
94,2,car,722,1192,491,679,470,188,0.9947086
95,2,car,719,1191,490,680,472,190,0.99448395
96,2,car,721,1190,490,681,469,191,0.9950352
97,2,car,718,1192,491,680,474,189,0.9946807
98,2,car,720,1190,491,680,470,189,0.9939705
99,2,car,721,1189,490,680,468,190,0.99420947
100,2,car,721,1188,491,679,467,188,0.9941135
101,2,car,720,1190,491,680,470,189,0.99439865
102,2,car,721,1190,490,680,469,190,0.9935835
103,2,car,720,1190,490,680,470,190,0.99316007
104,2,car,720,1190,490,680,470,190,0.99366015
105,2,car,723,1188,491,680,465,189,0.9940172
106,2,car,723,1190,491,680,467,189,0.9925984
107,2,car,720,1189,491,679,469,188,0.99389535
108,2,car,720,1192,491,680,472,189,0.9947525
109,2,car,720,1189,490,681,469,191,0.99338204
110,2,car,723,1190,490,680,467,190,0.993658
111,2,car,722,1191,490,681,469,191,0.9944046
112,2,car,723,1189,491,680,466,189,0.9941147
113,2,car,592,912,482,651,320,169,0.9904916
114,2,car,593,912,482,651,319,169,0.99101853
115,2,car,591,911,482,650,320,168,0.99045604
0,2,car,721,1189,492,679,468,187,0.99207807
1,2,car,721,1187,491,679,466,188,0.99360836
2,2,car,722,1192,490,680,470,190,0.99354243
3,2,car,721,1189,490,681,468,191,0.9929695
4,2,car,720,1191,490,680,471,190,0.9934036
5,2,car,721,1190,491,680,469,189,0.9937746
6,2,car,720,1190,491,679,470,188,0.99336284
7,2,car,718,1190,490,680,472,190,0.99366164
8,2,car,724,1188,491,679,464,188,0.99361384
9,2,car,718,1190,490,680,472,190,0.9941106
10,2,car,720,1192,490,681,472,191,0.9934201
11,2,car,721,1192,491,679,471,188,0.99110234
12,2,car,721,1189,489,681,468,192,0.9942035
13,2,car,720,1192,490,680,472,190,0.9943143
14,2,car,720,1189,491,680,469,189,0.99289626
15,2,car,720,1188,490,681,468,191,0.9936275
16,2,car,721,1188,490,680,467,190,0.99227583
17,2,car,723,1189,490,680,466,190,0.9946215
18,2,car,719,1191,491,679,472,188,0.99300593
19,2,car,718,1191,490,681,473,191,0.9933079
20,2,car,720,1188,490,680,468,190,0.99254847
21,2,car,722,1189,491,679,467,188,0.99210006
22,2,car,720,1188,491,680,468,189,0.9942964
23,2,car,722,1189,490,680,467,190,0.9929243
24,2,car,722,1189,490,680,467,190,0.99385345
25,2,car,722,1190,490,681,468,191,0.9937917
26,2,car,721,1188,491,679,467,188,0.9926908
27,2,car,721,1190,490,681,469,191,0.9932829
28,2,car,721,1190,491,680,469,189,0.9928404
29,2,car,721,1191,491,680,470,189,0.9943646
30,2,car,723,1189,491,680,466,189,0.9942534
31,2,car,720,1191,490,681,471,191,0.9926691
32,2,car,721,1191,491,680,470,189,0.9923738
33,2,car,721,1187,492,679,466,187,0.99343777
34,2,car,721,1190,491,680,469,189,0.9931046
35,2,car,722,1188,492,679,466,187,0.9910961
36,2,car,721,1192,491,680,471,189,0.9921725
37,2,car,723,1190,490,680,467,190,0.9929821
38,2,car,723,1190,492,679,467,187,0.99407345
39,2,car,721,1189,490,680,468,190,0.99229693
40,2,car,720,1190,490,681,470,191,0.9942689
41,2,car,722,1190,491,680,468,189,0.9946975
42,2,car,722,1189,492,679,467,187,0.9933555
43,2,car,719,1191,491,680,472,189,0.99077785
44,2,car,720,1189,492,678,469,186,0.99275035
45,2,car,719,1192,491,680,473,189,0.99213934
46,2,car,724,1188,491,679,464,188,0.9937347
47,2,car,721,1191,490,680,470,190,0.9937846
48,2,car,724,1189,489,681,465,192,0.99227536
49,2,car,721,1191,490,681,470,191,0.99170077
50,2,car,722,1189,492,678,467,186,0.99312747
51,2,car,722,1189,490,680,467,190,0.9928037
52,2,car,722,1191,491,680,469,189,0.9921203
53,2,car,722,1189,490,681,467,191,0.9922209
54,2,car,721,1192,490,681,471,191,0.9930029
55,2,car,721,1191,491,680,470,189,0.99370116
56,2,car,721,1192,491,679,471,188,0.99167436
57,2,car,720,1191,489,681,471,192,0.99269456
58,2,car,721,1190,491,680,469,189,0.993381
59,2,car,718,1190,490,681,472,191,0.99364763
60,2,car,722,1193,490,680,471,190,0.99402285
61,2,car,719,1192,490,680,473,190,0.99388003
62,2,car,723,1192,490,680,469,190,0.992976
63,2,car,721,1190,491,680,469,189,0.99315363
64,2,car,721,1190,491,680,469,189,0.9950945
65,2,car,719,1191,490,681,472,191,0.99357724
66,2,car,723,1191,491,680,468,189,0.99360245
67,2,car,721,1190,491,680,469,189,0.99408567
68,2,car,722,1191,490,680,469,190,0.99388546
69,2,car,719,1189,490,681,470,191,0.9933415
70,2,car,721,1189,490,681,468,191,0.99309224
71,2,car,720,1189,490,680,469,190,0.9933535
72,2,car,721,1189,490,680,468,190,0.99278355
73,2,car,722,1191,491,679,469,188,0.99334544
74,2,car,721,1189,491,679,468,188,0.9922223
75,2,car,721,1192,491,679,471,188,0.99353355
76,2,car,721,1190,491,680,469,189,0.9941834
77,2,car,721,1192,490,680,471,190,0.9927697
78,2,car,723,1187,491,680,464,189,0.9929273
79,2,car,720,1192,491,680,472,189,0.9943153
80,2,car,721,1190,490,680,469,190,0.9937749
81,2,car,721,1189,491,680,468,189,0.9938193
82,2,car,721,1193,490,681,472,191,0.9946054
83,2,car,721,1190,490,681,469,191,0.99308574
84,2,car,721,1191,490,680,470,190,0.99485815
85,2,car,719,1191,490,680,472,190,0.99378115
86,2,car,719,1192,490,681,473,191,0.994926
87,2,car,722,1192,490,680,470,190,0.9945114
88,2,car,722,1190,490,680,468,190,0.99356544
89,2,car,718,1192,490,680,474,190,0.99396724
90,2,car,720,1192,491,680,472,189,0.99402833
91,2,car,720,1188,490,681,468,191,0.9936452
92,2,car,722,1188,490,681,466,191,0.9941867
93,2,car,722,1189,490,681,467,191,0.99316216
94,2,car,721,1191,490,681,470,191,0.9934978
95,2,car,722,1192,491,679,470,188,0.9947086
96,2,car,719,1191,490,680,472,190,0.99448395
97,2,car,721,1190,490,681,469,191,0.9950352
98,2,car,718,1192,491,680,474,189,0.9946807
99,2,car,720,1190,491,680,470,189,0.9939705
100,2,car,721,1189,490,680,468,190,0.99420947
101,2,car,721,1188,491,679,467,188,0.9941135
102,2,car,720,1190,491,680,470,189,0.99439865
103,2,car,721,1190,490,680,469,190,0.9935835
104,2,car,720,1190,490,680,470,190,0.99316007
105,2,car,720,1190,490,680,470,190,0.99366015
106,2,car,723,1188,491,680,465,189,0.9940172
107,2,car,723,1190,491,680,467,189,0.9925984
108,2,car,720,1189,491,679,469,188,0.99389535
109,2,car,720,1192,491,680,472,189,0.9947525
110,2,car,720,1189,490,681,469,191,0.99338204
111,2,car,723,1190,490,680,467,190,0.993658
112,2,car,722,1191,490,681,469,191,0.9944046
113,2,car,723,1189,491,680,466,189,0.9941147
114,2,car,592,912,482,651,320,169,0.9904916
115,2,car,593,912,482,651,319,169,0.99101853
116,2,car,591,911,482,650,320,168,0.99045604
0,2,car,720,1190,491,680,470,189,0.9924298
1,2,car,721,1189,492,679,468,187,0.99207807
2,2,car,721,1187,491,679,466,188,0.99360836
3,2,car,722,1192,490,680,470,190,0.99354243
4,2,car,721,1189,490,681,468,191,0.9929695
5,2,car,720,1191,490,680,471,190,0.9934036
6,2,car,721,1190,491,680,469,189,0.9937746
7,2,car,720,1190,491,679,470,188,0.99336284
8,2,car,718,1190,490,680,472,190,0.99366164
9,2,car,724,1188,491,679,464,188,0.99361384
10,2,car,718,1190,490,680,472,190,0.9941106
11,2,car,720,1192,490,681,472,191,0.9934201
12,2,car,721,1192,491,679,471,188,0.99110234
13,2,car,721,1189,489,681,468,192,0.9942035
14,2,car,720,1192,490,680,472,190,0.9943143
15,2,car,720,1189,491,680,469,189,0.99289626
16,2,car,720,1188,490,681,468,191,0.9936275
17,2,car,721,1188,490,680,467,190,0.99227583
18,2,car,723,1189,490,680,466,190,0.9946215
19,2,car,719,1191,491,679,472,188,0.99300593
20,2,car,718,1191,490,681,473,191,0.9933079
21,2,car,720,1188,490,680,468,190,0.99254847
22,2,car,722,1189,491,679,467,188,0.99210006
23,2,car,720,1188,491,680,468,189,0.9942964
24,2,car,722,1189,490,680,467,190,0.9929243
25,2,car,722,1189,490,680,467,190,0.99385345
26,2,car,722,1190,490,681,468,191,0.9937917
27,2,car,721,1188,491,679,467,188,0.9926908
28,2,car,721,1190,490,681,469,191,0.9932829
29,2,car,721,1190,491,680,469,189,0.9928404
30,2,car,721,1191,491,680,470,189,0.9943646
31,2,car,723,1189,491,680,466,189,0.9942534
32,2,car,720,1191,490,681,471,191,0.9926691
33,2,car,721,1191,491,680,470,189,0.9923738
34,2,car,721,1187,492,679,466,187,0.99343777
35,2,car,721,1190,491,680,469,189,0.9931046
36,2,car,722,1188,492,679,466,187,0.9910961
37,2,car,721,1192,491,680,471,189,0.9921725
38,2,car,723,1190,490,680,467,190,0.9929821
39,2,car,723,1190,492,679,467,187,0.99407345
40,2,car,721,1189,490,680,468,190,0.99229693
41,2,car,720,1190,490,681,470,191,0.9942689
42,2,car,722,1190,491,680,468,189,0.9946975
43,2,car,722,1189,492,679,467,187,0.9933555
44,2,car,719,1191,491,680,472,189,0.99077785
45,2,car,720,1189,492,678,469,186,0.99275035
46,2,car,719,1192,491,680,473,189,0.99213934
47,2,car,724,1188,491,679,464,188,0.9937347
48,2,car,721,1191,490,680,470,190,0.9937846
49,2,car,724,1189,489,681,465,192,0.99227536
50,2,car,721,1191,490,681,470,191,0.99170077
51,2,car,722,1189,492,678,467,186,0.99312747
52,2,car,722,1189,490,680,467,190,0.9928037
53,2,car,722,1191,491,680,469,189,0.9921203
54,2,car,722,1189,490,681,467,191,0.9922209
55,2,car,721,1192,490,681,471,191,0.9930029
56,2,car,721,1191,491,680,470,189,0.99370116
57,2,car,721,1192,491,679,471,188,0.99167436
58,2,car,720,1191,489,681,471,192,0.99269456
59,2,car,721,1190,491,680,469,189,0.993381
60,2,car,718,1190,490,681,472,191,0.99364763
61,2,car,722,1193,490,680,471,190,0.99402285
62,2,car,719,1192,490,680,473,190,0.99388003
63,2,car,723,1192,490,680,469,190,0.992976
64,2,car,721,1190,491,680,469,189,0.99315363
65,2,car,721,1190,491,680,469,189,0.9950945
66,2,car,719,1191,490,681,472,191,0.99357724
67,2,car,723,1191,491,680,468,189,0.99360245
68,2,car,721,1190,491,680,469,189,0.99408567
69,2,car,722,1191,490,680,469,190,0.99388546
70,2,car,719,1189,490,681,470,191,0.9933415
71,2,car,721,1189,490,681,468,191,0.99309224
72,2,car,720,1189,490,680,469,190,0.9933535
73,2,car,721,1189,490,680,468,190,0.99278355
74,2,car,722,1191,491,679,469,188,0.99334544
75,2,car,721,1189,491,679,468,188,0.9922223
76,2,car,721,1192,491,679,471,188,0.99353355
77,2,car,721,1190,491,680,469,189,0.9941834
78,2,car,721,1192,490,680,471,190,0.9927697
79,2,car,723,1187,491,680,464,189,0.9929273
80,2,car,720,1192,491,680,472,189,0.9943153
81,2,car,721,1190,490,680,469,190,0.9937749
82,2,car,721,1189,491,680,468,189,0.9938193
83,2,car,721,1193,490,681,472,191,0.9946054
84,2,car,721,1190,490,681,469,191,0.99308574
85,2,car,721,1191,490,680,470,190,0.99485815
86,2,car,719,1191,490,680,472,190,0.99378115
87,2,car,719,1192,490,681,473,191,0.994926
88,2,car,722,1192,490,680,470,190,0.9945114
89,2,car,722,1190,490,680,468,190,0.99356544
90,2,car,718,1192,490,680,474,190,0.99396724
91,2,car,720,1192,491,680,472,189,0.99402833
92,2,car,720,1188,490,681,468,191,0.9936452
93,2,car,722,1188,490,681,466,191,0.9941867
94,2,car,722,1189,490,681,467,191,0.99316216
95,2,car,721,1191,490,681,470,191,0.9934978
96,2,car,722,1192,491,679,470,188,0.9947086
97,2,car,719,1191,490,680,472,190,0.99448395
98,2,car,721,1190,490,681,469,191,0.9950352
99,2,car,718,1192,491,680,474,189,0.9946807
100,2,car,720,1190,491,680,470,189,0.9939705
101,2,car,721,1189,490,680,468,190,0.99420947
102,2,car,721,1188,491,679,467,188,0.9941135
103,2,car,720,1190,491,680,470,189,0.99439865
104,2,car,721,1190,490,680,469,190,0.9935835
105,2,car,720,1190,490,680,470,190,0.99316007
106,2,car,720,1190,490,680,470,190,0.99366015
107,2,car,723,1188,491,680,465,189,0.9940172
108,2,car,723,1190,491,680,467,189,0.9925984
109,2,car,720,1189,491,679,469,188,0.99389535
110,2,car,720,1192,491,680,472,189,0.9947525
111,2,car,720,1189,490,681,469,191,0.99338204
112,2,car,723,1190,490,680,467,190,0.993658
113,2,car,722,1191,490,681,469,191,0.9944046
114,2,car,723,1189,491,680,466,189,0.9941147
115,2,car,592,912,482,651,320,169,0.9904916
116,2,car,593,912,482,651,319,169,0.99101853
117,2,car,591,911,482,650,320,168,0.99045604
0,2,car,723,1189,490,681,466,191,0.9939765
1,2,car,720,1190,491,680,470,189,0.9924298
2,2,car,721,1189,492,679,468,187,0.99207807
3,2,car,721,1187,491,679,466,188,0.99360836
4,2,car,722,1192,490,680,470,190,0.99354243
5,2,car,721,1189,490,681,468,191,0.9929695
6,2,car,720,1191,490,680,471,190,0.9934036
7,2,car,721,1190,491,680,469,189,0.9937746
8,2,car,720,1190,491,679,470,188,0.99336284
9,2,car,718,1190,490,680,472,190,0.99366164
10,2,car,724,1188,491,679,464,188,0.99361384
11,2,car,718,1190,490,680,472,190,0.9941106
12,2,car,720,1192,490,681,472,191,0.9934201
13,2,car,721,1192,491,679,471,188,0.99110234
14,2,car,721,1189,489,681,468,192,0.9942035
15,2,car,720,1192,490,680,472,190,0.9943143
16,2,car,720,1189,491,680,469,189,0.99289626
17,2,car,720,1188,490,681,468,191,0.9936275
18,2,car,721,1188,490,680,467,190,0.99227583
19,2,car,723,1189,490,680,466,190,0.9946215
20,2,car,719,1191,491,679,472,188,0.99300593
21,2,car,718,1191,490,681,473,191,0.9933079
22,2,car,720,1188,490,680,468,190,0.99254847
23,2,car,722,1189,491,679,467,188,0.99210006
24,2,car,720,1188,491,680,468,189,0.9942964
25,2,car,722,1189,490,680,467,190,0.9929243
26,2,car,722,1189,490,680,467,190,0.99385345
27,2,car,722,1190,490,681,468,191,0.9937917
28,2,car,721,1188,491,679,467,188,0.9926908
29,2,car,721,1190,490,681,469,191,0.9932829
30,2,car,721,1190,491,680,469,189,0.9928404
31,2,car,721,1191,491,680,470,189,0.9943646
32,2,car,723,1189,491,680,466,189,0.9942534
33,2,car,720,1191,490,681,471,191,0.9926691
34,2,car,721,1191,491,680,470,189,0.9923738
35,2,car,721,1187,492,679,466,187,0.99343777
36,2,car,721,1190,491,680,469,189,0.9931046
37,2,car,722,1188,492,679,466,187,0.9910961
38,2,car,721,1192,491,680,471,189,0.9921725
39,2,car,723,1190,490,680,467,190,0.9929821
40,2,car,723,1190,492,679,467,187,0.99407345
41,2,car,721,1189,490,680,468,190,0.99229693
42,2,car,720,1190,490,681,470,191,0.9942689
43,2,car,722,1190,491,680,468,189,0.9946975
44,2,car,722,1189,492,679,467,187,0.9933555
45,2,car,719,1191,491,680,472,189,0.99077785
46,2,car,720,1189,492,678,469,186,0.99275035
47,2,car,719,1192,491,680,473,189,0.99213934
48,2,car,724,1188,491,679,464,188,0.9937347
49,2,car,721,1191,490,680,470,190,0.9937846
50,2,car,724,1189,489,681,465,192,0.99227536
51,2,car,721,1191,490,681,470,191,0.99170077
52,2,car,722,1189,492,678,467,186,0.99312747
53,2,car,722,1189,490,680,467,190,0.9928037
54,2,car,722,1191,491,680,469,189,0.9921203
55,2,car,722,1189,490,681,467,191,0.9922209
56,2,car,721,1192,490,681,471,191,0.9930029
57,2,car,721,1191,491,680,470,189,0.99370116
58,2,car,721,1192,491,679,471,188,0.99167436
59,2,car,720,1191,489,681,471,192,0.99269456
60,2,car,721,1190,491,680,469,189,0.993381
61,2,car,718,1190,490,681,472,191,0.99364763
62,2,car,722,1193,490,680,471,190,0.99402285
63,2,car,719,1192,490,680,473,190,0.99388003
64,2,car,723,1192,490,680,469,190,0.992976
65,2,car,721,1190,491,680,469,189,0.99315363
66,2,car,721,1190,491,680,469,189,0.9950945
67,2,car,719,1191,490,681,472,191,0.99357724
68,2,car,723,1191,491,680,468,189,0.99360245
69,2,car,721,1190,491,680,469,189,0.99408567
70,2,car,722,1191,490,680,469,190,0.99388546
71,2,car,719,1189,490,681,470,191,0.9933415
72,2,car,721,1189,490,681,468,191,0.99309224
73,2,car,720,1189,490,680,469,190,0.9933535
74,2,car,721,1189,490,680,468,190,0.99278355
75,2,car,722,1191,491,679,469,188,0.99334544
76,2,car,721,1189,491,679,468,188,0.9922223
77,2,car,721,1192,491,679,471,188,0.99353355
78,2,car,721,1190,491,680,469,189,0.9941834
79,2,car,721,1192,490,680,471,190,0.9927697
80,2,car,723,1187,491,680,464,189,0.9929273
81,2,car,720,1192,491,680,472,189,0.9943153
82,2,car,721,1190,490,680,469,190,0.9937749
83,2,car,721,1189,491,680,468,189,0.9938193
84,2,car,721,1193,490,681,472,191,0.9946054
85,2,car,721,1190,490,681,469,191,0.99308574
86,2,car,721,1191,490,680,470,190,0.99485815
87,2,car,719,1191,490,680,472,190,0.99378115
88,2,car,719,1192,490,681,473,191,0.994926
89,2,car,722,1192,490,680,470,190,0.9945114
90,2,car,722,1190,490,680,468,190,0.99356544
91,2,car,718,1192,490,680,474,190,0.99396724
92,2,car,720,1192,491,680,472,189,0.99402833
93,2,car,720,1188,490,681,468,191,0.9936452
94,2,car,722,1188,490,681,466,191,0.9941867
95,2,car,722,1189,490,681,467,191,0.99316216
96,2,car,721,1191,490,681,470,191,0.9934978
97,2,car,722,1192,491,679,470,188,0.9947086
98,2,car,719,1191,490,680,472,190,0.99448395
99,2,car,721,1190,490,681,469,191,0.9950352
100,2,car,718,1192,491,680,474,189,0.9946807
101,2,car,720,1190,491,680,470,189,0.9939705
102,2,car,721,1189,490,680,468,190,0.99420947
103,2,car,721,1188,491,679,467,188,0.9941135
104,2,car,720,1190,491,680,470,189,0.99439865
105,2,car,721,1190,490,680,469,190,0.9935835
106,2,car,720,1190,490,680,470,190,0.99316007
107,2,car,720,1190,490,680,470,190,0.99366015
108,2,car,723,1188,491,680,465,189,0.9940172
109,2,car,723,1190,491,680,467,189,0.9925984
110,2,car,720,1189,491,679,469,188,0.99389535
111,2,car,720,1192,491,680,472,189,0.9947525
112,2,car,720,1189,490,681,469,191,0.99338204
113,2,car,723,1190,490,680,467,190,0.993658
114,2,car,722,1191,490,681,469,191,0.9944046
115,2,car,723,1189,491,680,466,189,0.9941147
116,2,car,592,912,482,651,320,169,0.9904916
117,2,car,593,912,482,651,319,169,0.99101853
118,2,car,591,911,482,650,320,168,0.99045604
0,2,car,720,1188,490,680,468,190,0.99226046
1,2,car,723,1189,490,681,466,191,0.9939765
2,2,car,720,1190,491,680,470,189,0.9924298
3,2,car,721,1189,492,679,468,187,0.99207807
4,2,car,721,1187,491,679,466,188,0.99360836
5,2,car,722,1192,490,680,470,190,0.99354243
6,2,car,721,1189,490,681,468,191,0.9929695
7,2,car,720,1191,490,680,471,190,0.9934036
8,2,car,721,1190,491,680,469,189,0.9937746
9,2,car,720,1190,491,679,470,188,0.99336284
10,2,car,718,1190,490,680,472,190,0.99366164
11,2,car,724,1188,491,679,464,188,0.99361384
12,2,car,718,1190,490,680,472,190,0.9941106
13,2,car,720,1192,490,681,472,191,0.9934201
14,2,car,721,1192,491,679,471,188,0.99110234
15,2,car,721,1189,489,681,468,192,0.9942035
16,2,car,720,1192,490,680,472,190,0.9943143
17,2,car,720,1189,491,680,469,189,0.99289626
18,2,car,720,1188,490,681,468,191,0.9936275
19,2,car,721,1188,490,680,467,190,0.99227583
20,2,car,723,1189,490,680,466,190,0.9946215
21,2,car,719,1191,491,679,472,188,0.99300593
22,2,car,718,1191,490,681,473,191,0.9933079
23,2,car,720,1188,490,680,468,190,0.99254847
24,2,car,722,1189,491,679,467,188,0.99210006
25,2,car,720,1188,491,680,468,189,0.9942964
26,2,car,722,1189,490,680,467,190,0.9929243
27,2,car,722,1189,490,680,467,190,0.99385345
28,2,car,722,1190,490,681,468,191,0.9937917
29,2,car,721,1188,491,679,467,188,0.9926908
30,2,car,721,1190,490,681,469,191,0.9932829
31,2,car,721,1190,491,680,469,189,0.9928404
32,2,car,721,1191,491,680,470,189,0.9943646
33,2,car,723,1189,491,680,466,189,0.9942534
34,2,car,720,1191,490,681,471,191,0.9926691
35,2,car,721,1191,491,680,470,189,0.9923738
36,2,car,721,1187,492,679,466,187,0.99343777
37,2,car,721,1190,491,680,469,189,0.9931046
38,2,car,722,1188,492,679,466,187,0.9910961
39,2,car,721,1192,491,680,471,189,0.9921725
40,2,car,723,1190,490,680,467,190,0.9929821
41,2,car,723,1190,492,679,467,187,0.99407345
42,2,car,721,1189,490,680,468,190,0.99229693
43,2,car,720,1190,490,681,470,191,0.9942689
44,2,car,722,1190,491,680,468,189,0.9946975
45,2,car,722,1189,492,679,467,187,0.9933555
46,2,car,719,1191,491,680,472,189,0.99077785
47,2,car,720,1189,492,678,469,186,0.99275035
48,2,car,719,1192,491,680,473,189,0.99213934
49,2,car,724,1188,491,679,464,188,0.9937347
50,2,car,721,1191,490,680,470,190,0.9937846
51,2,car,724,1189,489,681,465,192,0.99227536
52,2,car,721,1191,490,681,470,191,0.99170077
53,2,car,722,1189,492,678,467,186,0.99312747
54,2,car,722,1189,490,680,467,190,0.9928037
55,2,car,722,1191,491,680,469,189,0.9921203
56,2,car,722,1189,490,681,467,191,0.9922209
57,2,car,721,1192,490,681,471,191,0.9930029
58,2,car,721,1191,491,680,470,189,0.99370116
59,2,car,721,1192,491,679,471,188,0.99167436
60,2,car,720,1191,489,681,471,192,0.99269456
61,2,car,721,1190,491,680,469,189,0.993381
62,2,car,718,1190,490,681,472,191,0.99364763
63,2,car,722,1193,490,680,471,190,0.99402285
64,2,car,719,1192,490,680,473,190,0.99388003
65,2,car,723,1192,490,680,469,190,0.992976
66,2,car,721,1190,491,680,469,189,0.99315363
67,2,car,721,1190,491,680,469,189,0.9950945
68,2,car,719,1191,490,681,472,191,0.99357724
69,2,car,723,1191,491,680,468,189,0.99360245
70,2,car,721,1190,491,680,469,189,0.99408567
71,2,car,722,1191,490,680,469,190,0.99388546
72,2,car,719,1189,490,681,470,191,0.9933415
73,2,car,721,1189,490,681,468,191,0.99309224
74,2,car,720,1189,490,680,469,190,0.9933535
75,2,car,721,1189,490,680,468,190,0.99278355
76,2,car,722,1191,491,679,469,188,0.99334544
77,2,car,721,1189,491,679,468,188,0.9922223
78,2,car,721,1192,491,679,471,188,0.99353355
79,2,car,721,1190,491,680,469,189,0.9941834
80,2,car,721,1192,490,680,471,190,0.9927697
81,2,car,723,1187,491,680,464,189,0.9929273
82,2,car,720,1192,491,680,472,189,0.9943153
83,2,car,721,1190,490,680,469,190,0.9937749
84,2,car,721,1189,491,680,468,189,0.9938193
85,2,car,721,1193,490,681,472,191,0.9946054
86,2,car,721,1190,490,681,469,191,0.99308574
87,2,car,721,1191,490,680,470,190,0.99485815
88,2,car,719,1191,490,680,472,190,0.99378115
89,2,car,719,1192,490,681,473,191,0.994926
90,2,car,722,1192,490,680,470,190,0.9945114
91,2,car,722,1190,490,680,468,190,0.99356544
92,2,car,718,1192,490,680,474,190,0.99396724
93,2,car,720,1192,491,680,472,189,0.99402833
94,2,car,720,1188,490,681,468,191,0.9936452
95,2,car,722,1188,490,681,466,191,0.9941867
96,2,car,722,1189,490,681,467,191,0.99316216
97,2,car,721,1191,490,681,470,191,0.9934978
98,2,car,722,1192,491,679,470,188,0.9947086
99,2,car,719,1191,490,680,472,190,0.99448395
100,2,car,721,1190,490,681,469,191,0.9950352
101,2,car,718,1192,491,680,474,189,0.9946807
102,2,car,720,1190,491,680,470,189,0.9939705
103,2,car,721,1189,490,680,468,190,0.99420947
104,2,car,721,1188,491,679,467,188,0.9941135
105,2,car,720,1190,491,680,470,189,0.99439865
106,2,car,721,1190,490,680,469,190,0.9935835
107,2,car,720,1190,490,680,470,190,0.99316007
108,2,car,720,1190,490,680,470,190,0.99366015
109,2,car,723,1188,491,680,465,189,0.9940172
110,2,car,723,1190,491,680,467,189,0.9925984
111,2,car,720,1189,491,679,469,188,0.99389535
112,2,car,720,1192,491,680,472,189,0.9947525
113,2,car,720,1189,490,681,469,191,0.99338204
114,2,car,723,1190,490,680,467,190,0.993658
115,2,car,722,1191,490,681,469,191,0.9944046
116,2,car,723,1189,491,680,466,189,0.9941147
117,2,car,592,912,482,651,320,169,0.9904916
118,2,car,593,912,482,651,319,169,0.99101853
119,2,car,591,911,482,650,320,168,0.99045604
0,2,car,722,1190,490,681,468,191,0.9930944
1,2,car,720,1188,490,680,468,190,0.99226046
2,2,car,723,1189,490,681,466,191,0.9939765
3,2,car,720,1190,491,680,470,189,0.9924298
4,2,car,721,1189,492,679,468,187,0.99207807
5,2,car,721,1187,491,679,466,188,0.99360836
6,2,car,722,1192,490,680,470,190,0.99354243
7,2,car,721,1189,490,681,468,191,0.9929695
8,2,car,720,1191,490,680,471,190,0.9934036
9,2,car,721,1190,491,680,469,189,0.9937746
10,2,car,720,1190,491,679,470,188,0.99336284
11,2,car,718,1190,490,680,472,190,0.99366164
12,2,car,724,1188,491,679,464,188,0.99361384
13,2,car,718,1190,490,680,472,190,0.9941106
14,2,car,720,1192,490,681,472,191,0.9934201
15,2,car,721,1192,491,679,471,188,0.99110234
16,2,car,721,1189,489,681,468,192,0.9942035
17,2,car,720,1192,490,680,472,190,0.9943143
18,2,car,720,1189,491,680,469,189,0.99289626
19,2,car,720,1188,490,681,468,191,0.9936275
20,2,car,721,1188,490,680,467,190,0.99227583
21,2,car,723,1189,490,680,466,190,0.9946215
22,2,car,719,1191,491,679,472,188,0.99300593
23,2,car,718,1191,490,681,473,191,0.9933079
24,2,car,720,1188,490,680,468,190,0.99254847
25,2,car,722,1189,491,679,467,188,0.99210006
26,2,car,720,1188,491,680,468,189,0.9942964
27,2,car,722,1189,490,680,467,190,0.9929243
28,2,car,722,1189,490,680,467,190,0.99385345
29,2,car,722,1190,490,681,468,191,0.9937917
30,2,car,721,1188,491,679,467,188,0.9926908
31,2,car,721,1190,490,681,469,191,0.9932829
32,2,car,721,1190,491,680,469,189,0.9928404
33,2,car,721,1191,491,680,470,189,0.9943646
34,2,car,723,1189,491,680,466,189,0.9942534
35,2,car,720,1191,490,681,471,191,0.9926691
36,2,car,721,1191,491,680,470,189,0.9923738
37,2,car,721,1187,492,679,466,187,0.99343777
38,2,car,721,1190,491,680,469,189,0.9931046
39,2,car,722,1188,492,679,466,187,0.9910961
40,2,car,721,1192,491,680,471,189,0.9921725
41,2,car,723,1190,490,680,467,190,0.9929821
42,2,car,723,1190,492,679,467,187,0.99407345
43,2,car,721,1189,490,680,468,190,0.99229693
44,2,car,720,1190,490,681,470,191,0.9942689
45,2,car,722,1190,491,680,468,189,0.9946975
46,2,car,722,1189,492,679,467,187,0.9933555
47,2,car,719,1191,491,680,472,189,0.99077785
48,2,car,720,1189,492,678,469,186,0.99275035
49,2,car,719,1192,491,680,473,189,0.99213934
50,2,car,724,1188,491,679,464,188,0.9937347
51,2,car,721,1191,490,680,470,190,0.9937846
52,2,car,724,1189,489,681,465,192,0.99227536
53,2,car,721,1191,490,681,470,191,0.99170077
54,2,car,722,1189,492,678,467,186,0.99312747
55,2,car,722,1189,490,680,467,190,0.9928037
56,2,car,722,1191,491,680,469,189,0.9921203
57,2,car,722,1189,490,681,467,191,0.9922209
58,2,car,721,1192,490,681,471,191,0.9930029
59,2,car,721,1191,491,680,470,189,0.99370116
60,2,car,721,1192,491,679,471,188,0.99167436
61,2,car,720,1191,489,681,471,192,0.99269456
62,2,car,721,1190,491,680,469,189,0.993381
63,2,car,718,1190,490,681,472,191,0.99364763
64,2,car,722,1193,490,680,471,190,0.99402285
65,2,car,719,1192,490,680,473,190,0.99388003
66,2,car,723,1192,490,680,469,190,0.992976
67,2,car,721,1190,491,680,469,189,0.99315363
68,2,car,721,1190,491,680,469,189,0.9950945
69,2,car,719,1191,490,681,472,191,0.99357724
70,2,car,723,1191,491,680,468,189,0.99360245
71,2,car,721,1190,491,680,469,189,0.99408567
72,2,car,722,1191,490,680,469,190,0.99388546
73,2,car,719,1189,490,681,470,191,0.9933415
74,2,car,721,1189,490,681,468,191,0.99309224
75,2,car,720,1189,490,680,469,190,0.9933535
76,2,car,721,1189,490,680,468,190,0.99278355
77,2,car,722,1191,491,679,469,188,0.99334544
78,2,car,721,1189,491,679,468,188,0.9922223
79,2,car,721,1192,491,679,471,188,0.99353355
80,2,car,721,1190,491,680,469,189,0.9941834
81,2,car,721,1192,490,680,471,190,0.9927697
82,2,car,723,1187,491,680,464,189,0.9929273
83,2,car,720,1192,491,680,472,189,0.9943153
84,2,car,721,1190,490,680,469,190,0.9937749
85,2,car,721,1189,491,680,468,189,0.9938193
86,2,car,721,1193,490,681,472,191,0.9946054
87,2,car,721,1190,490,681,469,191,0.99308574
88,2,car,721,1191,490,680,470,190,0.99485815
89,2,car,719,1191,490,680,472,190,0.99378115
90,2,car,719,1192,490,681,473,191,0.994926
91,2,car,722,1192,490,680,470,190,0.9945114
92,2,car,722,1190,490,680,468,190,0.99356544
93,2,car,718,1192,490,680,474,190,0.99396724
94,2,car,720,1192,491,680,472,189,0.99402833
95,2,car,720,1188,490,681,468,191,0.9936452
96,2,car,722,1188,490,681,466,191,0.9941867
97,2,car,722,1189,490,681,467,191,0.99316216
98,2,car,721,1191,490,681,470,191,0.9934978
99,2,car,722,1192,491,679,470,188,0.9947086
100,2,car,719,1191,490,680,472,190,0.99448395
101,2,car,721,1190,490,681,469,191,0.9950352
102,2,car,718,1192,491,680,474,189,0.9946807
103,2,car,720,1190,491,680,470,189,0.9939705
104,2,car,721,1189,490,680,468,190,0.99420947
105,2,car,721,1188,491,679,467,188,0.9941135
106,2,car,720,1190,491,680,470,189,0.99439865
107,2,car,721,1190,490,680,469,190,0.9935835
108,2,car,720,1190,490,680,470,190,0.99316007
109,2,car,720,1190,490,680,470,190,0.99366015
110,2,car,723,1188,491,680,465,189,0.9940172
111,2,car,723,1190,491,680,467,189,0.9925984
112,2,car,720,1189,491,679,469,188,0.99389535
113,2,car,720,1192,491,680,472,189,0.9947525
114,2,car,720,1189,490,681,469,191,0.99338204
115,2,car,723,1190,490,680,467,190,0.993658
116,2,car,722,1191,490,681,469,191,0.9944046
117,2,car,723,1189,491,680,466,189,0.9941147
118,2,car,592,912,482,651,320,169,0.9904916
119,2,car,593,912,482,651,319,169,0.99101853
120,2,car,591,911,482,650,320,168,0.99045604
0,2,car,720,1190,490,680,470,190,0.9928888
1,2,car,722,1190,490,681,468,191,0.9930944
2,2,car,720,1188,490,680,468,190,0.99226046
3,2,car,723,1189,490,681,466,191,0.9939765
4,2,car,720,1190,491,680,470,189,0.9924298
5,2,car,721,1189,492,679,468,187,0.99207807
6,2,car,721,1187,491,679,466,188,0.99360836
7,2,car,722,1192,490,680,470,190,0.99354243
8,2,car,721,1189,490,681,468,191,0.9929695
9,2,car,720,1191,490,680,471,190,0.9934036
10,2,car,721,1190,491,680,469,189,0.9937746
11,2,car,720,1190,491,679,470,188,0.99336284
12,2,car,718,1190,490,680,472,190,0.99366164
13,2,car,724,1188,491,679,464,188,0.99361384
14,2,car,718,1190,490,680,472,190,0.9941106
15,2,car,720,1192,490,681,472,191,0.9934201
16,2,car,721,1192,491,679,471,188,0.99110234
17,2,car,721,1189,489,681,468,192,0.9942035
18,2,car,720,1192,490,680,472,190,0.9943143
19,2,car,720,1189,491,680,469,189,0.99289626
20,2,car,720,1188,490,681,468,191,0.9936275
21,2,car,721,1188,490,680,467,190,0.99227583
22,2,car,723,1189,490,680,466,190,0.9946215
23,2,car,719,1191,491,679,472,188,0.99300593
24,2,car,718,1191,490,681,473,191,0.9933079
25,2,car,720,1188,490,680,468,190,0.99254847
26,2,car,722,1189,491,679,467,188,0.99210006
27,2,car,720,1188,491,680,468,189,0.9942964
28,2,car,722,1189,490,680,467,190,0.9929243
29,2,car,722,1189,490,680,467,190,0.99385345
30,2,car,722,1190,490,681,468,191,0.9937917
31,2,car,721,1188,491,679,467,188,0.9926908
32,2,car,721,1190,490,681,469,191,0.9932829
33,2,car,721,1190,491,680,469,189,0.9928404
34,2,car,721,1191,491,680,470,189,0.9943646
35,2,car,723,1189,491,680,466,189,0.9942534
36,2,car,720,1191,490,681,471,191,0.9926691
37,2,car,721,1191,491,680,470,189,0.9923738
38,2,car,721,1187,492,679,466,187,0.99343777
39,2,car,721,1190,491,680,469,189,0.9931046
40,2,car,722,1188,492,679,466,187,0.9910961
41,2,car,721,1192,491,680,471,189,0.9921725
42,2,car,723,1190,490,680,467,190,0.9929821
43,2,car,723,1190,492,679,467,187,0.99407345
44,2,car,721,1189,490,680,468,190,0.99229693
45,2,car,720,1190,490,681,470,191,0.9942689
46,2,car,722,1190,491,680,468,189,0.9946975
47,2,car,722,1189,492,679,467,187,0.9933555
48,2,car,719,1191,491,680,472,189,0.99077785
49,2,car,720,1189,492,678,469,186,0.99275035
50,2,car,719,1192,491,680,473,189,0.99213934
51,2,car,724,1188,491,679,464,188,0.9937347
52,2,car,721,1191,490,680,470,190,0.9937846
53,2,car,724,1189,489,681,465,192,0.99227536
54,2,car,721,1191,490,681,470,191,0.99170077
55,2,car,722,1189,492,678,467,186,0.99312747
56,2,car,722,1189,490,680,467,190,0.9928037
57,2,car,722,1191,491,680,469,189,0.9921203
58,2,car,722,1189,490,681,467,191,0.9922209
59,2,car,721,1192,490,681,471,191,0.9930029
60,2,car,721,1191,491,680,470,189,0.99370116
61,2,car,721,1192,491,679,471,188,0.99167436
62,2,car,720,1191,489,681,471,192,0.99269456
63,2,car,721,1190,491,680,469,189,0.993381
64,2,car,718,1190,490,681,472,191,0.99364763
65,2,car,722,1193,490,680,471,190,0.99402285
66,2,car,719,1192,490,680,473,190,0.99388003
67,2,car,723,1192,490,680,469,190,0.992976
68,2,car,721,1190,491,680,469,189,0.99315363
69,2,car,721,1190,491,680,469,189,0.9950945
70,2,car,719,1191,490,681,472,191,0.99357724
71,2,car,723,1191,491,680,468,189,0.99360245
72,2,car,721,1190,491,680,469,189,0.99408567
73,2,car,722,1191,490,680,469,190,0.99388546
74,2,car,719,1189,490,681,470,191,0.9933415
75,2,car,721,1189,490,681,468,191,0.99309224
76,2,car,720,1189,490,680,469,190,0.9933535
77,2,car,721,1189,490,680,468,190,0.99278355
78,2,car,722,1191,491,679,469,188,0.99334544
79,2,car,721,1189,491,679,468,188,0.9922223
80,2,car,721,1192,491,679,471,188,0.99353355
81,2,car,721,1190,491,680,469,189,0.9941834
82,2,car,721,1192,490,680,471,190,0.9927697
83,2,car,723,1187,491,680,464,189,0.9929273
84,2,car,720,1192,491,680,472,189,0.9943153
85,2,car,721,1190,490,680,469,190,0.9937749
86,2,car,721,1189,491,680,468,189,0.9938193
87,2,car,721,1193,490,681,472,191,0.9946054
88,2,car,721,1190,490,681,469,191,0.99308574
89,2,car,721,1191,490,680,470,190,0.99485815
90,2,car,719,1191,490,680,472,190,0.99378115
91,2,car,719,1192,490,681,473,191,0.994926
92,2,car,722,1192,490,680,470,190,0.9945114
93,2,car,722,1190,490,680,468,190,0.99356544
94,2,car,718,1192,490,680,474,190,0.99396724
95,2,car,720,1192,491,680,472,189,0.99402833
96,2,car,720,1188,490,681,468,191,0.9936452
97,2,car,722,1188,490,681,466,191,0.9941867
98,2,car,722,1189,490,681,467,191,0.99316216
99,2,car,721,1191,490,681,470,191,0.9934978
100,2,car,722,1192,491,679,470,188,0.9947086
101,2,car,719,1191,490,680,472,190,0.99448395
102,2,car,721,1190,490,681,469,191,0.9950352
103,2,car,718,1192,491,680,474,189,0.9946807
104,2,car,720,1190,491,680,470,189,0.9939705
105,2,car,721,1189,490,680,468,190,0.99420947
106,2,car,721,1188,491,679,467,188,0.9941135
107,2,car,720,1190,491,680,470,189,0.99439865
108,2,car,721,1190,490,680,469,190,0.9935835
109,2,car,720,1190,490,680,470,190,0.99316007
110,2,car,720,1190,490,680,470,190,0.99366015
111,2,car,723,1188,491,680,465,189,0.9940172
112,2,car,723,1190,491,680,467,189,0.9925984
113,2,car,720,1189,491,679,469,188,0.99389535
114,2,car,720,1192,491,680,472,189,0.9947525
115,2,car,720,1189,490,681,469,191,0.99338204
116,2,car,723,1190,490,680,467,190,0.993658
117,2,car,722,1191,490,681,469,191,0.9944046
118,2,car,723,1189,491,680,466,189,0.9941147
119,2,car,592,912,482,651,320,169,0.9904916
120,2,car,593,912,482,651,319,169,0.99101853
121,2,car,591,911,482,650,320,168,0.99045604
0,2,car,720,1191,490,680,471,190,0.99199617
1,2,car,720,1190,490,680,470,190,0.9928888
2,2,car,722,1190,490,681,468,191,0.9930944
3,2,car,720,1188,490,680,468,190,0.99226046
4,2,car,723,1189,490,681,466,191,0.9939765
5,2,car,720,1190,491,680,470,189,0.9924298
6,2,car,721,1189,492,679,468,187,0.99207807
7,2,car,721,1187,491,679,466,188,0.99360836
8,2,car,722,1192,490,680,470,190,0.99354243
9,2,car,721,1189,490,681,468,191,0.9929695
10,2,car,720,1191,490,680,471,190,0.9934036
11,2,car,721,1190,491,680,469,189,0.9937746
12,2,car,720,1190,491,679,470,188,0.99336284
13,2,car,718,1190,490,680,472,190,0.99366164
14,2,car,724,1188,491,679,464,188,0.99361384
15,2,car,718,1190,490,680,472,190,0.9941106
16,2,car,720,1192,490,681,472,191,0.9934201
17,2,car,721,1192,491,679,471,188,0.99110234
18,2,car,721,1189,489,681,468,192,0.9942035
19,2,car,720,1192,490,680,472,190,0.9943143
20,2,car,720,1189,491,680,469,189,0.99289626
21,2,car,720,1188,490,681,468,191,0.9936275
22,2,car,721,1188,490,680,467,190,0.99227583
23,2,car,723,1189,490,680,466,190,0.9946215
24,2,car,719,1191,491,679,472,188,0.99300593
25,2,car,718,1191,490,681,473,191,0.9933079
26,2,car,720,1188,490,680,468,190,0.99254847
27,2,car,722,1189,491,679,467,188,0.99210006
28,2,car,720,1188,491,680,468,189,0.9942964
29,2,car,722,1189,490,680,467,190,0.9929243
30,2,car,722,1189,490,680,467,190,0.99385345
31,2,car,722,1190,490,681,468,191,0.9937917
32,2,car,721,1188,491,679,467,188,0.9926908
33,2,car,721,1190,490,681,469,191,0.9932829
34,2,car,721,1190,491,680,469,189,0.9928404
35,2,car,721,1191,491,680,470,189,0.9943646
36,2,car,723,1189,491,680,466,189,0.9942534
37,2,car,720,1191,490,681,471,191,0.9926691
38,2,car,721,1191,491,680,470,189,0.9923738
39,2,car,721,1187,492,679,466,187,0.99343777
40,2,car,721,1190,491,680,469,189,0.9931046
41,2,car,722,1188,492,679,466,187,0.9910961
42,2,car,721,1192,491,680,471,189,0.9921725
43,2,car,723,1190,490,680,467,190,0.9929821
44,2,car,723,1190,492,679,467,187,0.99407345
45,2,car,721,1189,490,680,468,190,0.99229693
46,2,car,720,1190,490,681,470,191,0.9942689
47,2,car,722,1190,491,680,468,189,0.9946975
48,2,car,722,1189,492,679,467,187,0.9933555
49,2,car,719,1191,491,680,472,189,0.99077785
50,2,car,720,1189,492,678,469,186,0.99275035
51,2,car,719,1192,491,680,473,189,0.99213934
52,2,car,724,1188,491,679,464,188,0.9937347
53,2,car,721,1191,490,680,470,190,0.9937846
54,2,car,724,1189,489,681,465,192,0.99227536
55,2,car,721,1191,490,681,470,191,0.99170077
56,2,car,722,1189,492,678,467,186,0.99312747
57,2,car,722,1189,490,680,467,190,0.9928037
58,2,car,722,1191,491,680,469,189,0.9921203
59,2,car,722,1189,490,681,467,191,0.9922209
60,2,car,721,1192,490,681,471,191,0.9930029
61,2,car,721,1191,491,680,470,189,0.99370116
62,2,car,721,1192,491,679,471,188,0.99167436
63,2,car,720,1191,489,681,471,192,0.99269456
64,2,car,721,1190,491,680,469,189,0.993381
65,2,car,718,1190,490,681,472,191,0.99364763
66,2,car,722,1193,490,680,471,190,0.99402285
67,2,car,719,1192,490,680,473,190,0.99388003
68,2,car,723,1192,490,680,469,190,0.992976
69,2,car,721,1190,491,680,469,189,0.99315363
70,2,car,721,1190,491,680,469,189,0.9950945
71,2,car,719,1191,490,681,472,191,0.99357724
72,2,car,723,1191,491,680,468,189,0.99360245
73,2,car,721,1190,491,680,469,189,0.99408567
74,2,car,722,1191,490,680,469,190,0.99388546
75,2,car,719,1189,490,681,470,191,0.9933415
76,2,car,721,1189,490,681,468,191,0.99309224
77,2,car,720,1189,490,680,469,190,0.9933535
78,2,car,721,1189,490,680,468,190,0.99278355
79,2,car,722,1191,491,679,469,188,0.99334544
80,2,car,721,1189,491,679,468,188,0.9922223
81,2,car,721,1192,491,679,471,188,0.99353355
82,2,car,721,1190,491,680,469,189,0.9941834
83,2,car,721,1192,490,680,471,190,0.9927697
84,2,car,723,1187,491,680,464,189,0.9929273
85,2,car,720,1192,491,680,472,189,0.9943153
86,2,car,721,1190,490,680,469,190,0.9937749
87,2,car,721,1189,491,680,468,189,0.9938193
88,2,car,721,1193,490,681,472,191,0.9946054
89,2,car,721,1190,490,681,469,191,0.99308574
90,2,car,721,1191,490,680,470,190,0.99485815
91,2,car,719,1191,490,680,472,190,0.99378115
92,2,car,719,1192,490,681,473,191,0.994926
93,2,car,722,1192,490,680,470,190,0.9945114
94,2,car,722,1190,490,680,468,190,0.99356544
95,2,car,718,1192,490,680,474,190,0.99396724
96,2,car,720,1192,491,680,472,189,0.99402833
97,2,car,720,1188,490,681,468,191,0.9936452
98,2,car,722,1188,490,681,466,191,0.9941867
99,2,car,722,1189,490,681,467,191,0.99316216
100,2,car,721,1191,490,681,470,191,0.9934978
101,2,car,722,1192,491,679,470,188,0.9947086
102,2,car,719,1191,490,680,472,190,0.99448395
103,2,car,721,1190,490,681,469,191,0.9950352
104,2,car,718,1192,491,680,474,189,0.9946807
105,2,car,720,1190,491,680,470,189,0.9939705
106,2,car,721,1189,490,680,468,190,0.99420947
107,2,car,721,1188,491,679,467,188,0.9941135
108,2,car,720,1190,491,680,470,189,0.99439865
109,2,car,721,1190,490,680,469,190,0.9935835
110,2,car,720,1190,490,680,470,190,0.99316007
111,2,car,720,1190,490,680,470,190,0.99366015
112,2,car,723,1188,491,680,465,189,0.9940172
113,2,car,723,1190,491,680,467,189,0.9925984
114,2,car,720,1189,491,679,469,188,0.99389535
115,2,car,720,1192,491,680,472,189,0.9947525
116,2,car,720,1189,490,681,469,191,0.99338204
117,2,car,723,1190,490,680,467,190,0.993658
118,2,car,722,1191,490,681,469,191,0.9944046
119,2,car,723,1189,491,680,466,189,0.9941147
120,2,car,592,912,482,651,320,169,0.9904916
121,2,car,593,912,482,651,319,169,0.99101853
122,2,car,591,911,482,650,320,168,0.99045604
0,2,car,721,1190,490,681,469,191,0.9938494
1,2,car,720,1191,490,680,471,190,0.99199617
2,2,car,720,1190,490,680,470,190,0.9928888
3,2,car,722,1190,490,681,468,191,0.9930944
4,2,car,720,1188,490,680,468,190,0.99226046
5,2,car,723,1189,490,681,466,191,0.9939765
6,2,car,720,1190,491,680,470,189,0.9924298
7,2,car,721,1189,492,679,468,187,0.99207807
8,2,car,721,1187,491,679,466,188,0.99360836
9,2,car,722,1192,490,680,470,190,0.99354243
10,2,car,721,1189,490,681,468,191,0.9929695
11,2,car,720,1191,490,680,471,190,0.9934036
12,2,car,721,1190,491,680,469,189,0.9937746
13,2,car,720,1190,491,679,470,188,0.99336284
14,2,car,718,1190,490,680,472,190,0.99366164
15,2,car,724,1188,491,679,464,188,0.99361384
16,2,car,718,1190,490,680,472,190,0.9941106
17,2,car,720,1192,490,681,472,191,0.9934201
18,2,car,721,1192,491,679,471,188,0.99110234
19,2,car,721,1189,489,681,468,192,0.9942035
20,2,car,720,1192,490,680,472,190,0.9943143
21,2,car,720,1189,491,680,469,189,0.99289626
22,2,car,720,1188,490,681,468,191,0.9936275
23,2,car,721,1188,490,680,467,190,0.99227583
24,2,car,723,1189,490,680,466,190,0.9946215
25,2,car,719,1191,491,679,472,188,0.99300593
26,2,car,718,1191,490,681,473,191,0.9933079
27,2,car,720,1188,490,680,468,190,0.99254847
28,2,car,722,1189,491,679,467,188,0.99210006
29,2,car,720,1188,491,680,468,189,0.9942964
30,2,car,722,1189,490,680,467,190,0.9929243
31,2,car,722,1189,490,680,467,190,0.99385345
32,2,car,722,1190,490,681,468,191,0.9937917
33,2,car,721,1188,491,679,467,188,0.9926908
34,2,car,721,1190,490,681,469,191,0.9932829
35,2,car,721,1190,491,680,469,189,0.9928404
36,2,car,721,1191,491,680,470,189,0.9943646
37,2,car,723,1189,491,680,466,189,0.9942534
38,2,car,720,1191,490,681,471,191,0.9926691
39,2,car,721,1191,491,680,470,189,0.9923738
40,2,car,721,1187,492,679,466,187,0.99343777
41,2,car,721,1190,491,680,469,189,0.9931046
42,2,car,722,1188,492,679,466,187,0.9910961
43,2,car,721,1192,491,680,471,189,0.9921725
44,2,car,723,1190,490,680,467,190,0.9929821
45,2,car,723,1190,492,679,467,187,0.99407345
46,2,car,721,1189,490,680,468,190,0.99229693
47,2,car,720,1190,490,681,470,191,0.9942689
48,2,car,722,1190,491,680,468,189,0.9946975
49,2,car,722,1189,492,679,467,187,0.9933555
50,2,car,719,1191,491,680,472,189,0.99077785
51,2,car,720,1189,492,678,469,186,0.99275035
52,2,car,719,1192,491,680,473,189,0.99213934
53,2,car,724,1188,491,679,464,188,0.9937347
54,2,car,721,1191,490,680,470,190,0.9937846
55,2,car,724,1189,489,681,465,192,0.99227536
56,2,car,721,1191,490,681,470,191,0.99170077
57,2,car,722,1189,492,678,467,186,0.99312747
58,2,car,722,1189,490,680,467,190,0.9928037
59,2,car,722,1191,491,680,469,189,0.9921203
60,2,car,722,1189,490,681,467,191,0.9922209
61,2,car,721,1192,490,681,471,191,0.9930029
62,2,car,721,1191,491,680,470,189,0.99370116
63,2,car,721,1192,491,679,471,188,0.99167436
64,2,car,720,1191,489,681,471,192,0.99269456
65,2,car,721,1190,491,680,469,189,0.993381
66,2,car,718,1190,490,681,472,191,0.99364763
67,2,car,722,1193,490,680,471,190,0.99402285
68,2,car,719,1192,490,680,473,190,0.99388003
69,2,car,723,1192,490,680,469,190,0.992976
70,2,car,721,1190,491,680,469,189,0.99315363
71,2,car,721,1190,491,680,469,189,0.9950945
72,2,car,719,1191,490,681,472,191,0.99357724
73,2,car,723,1191,491,680,468,189,0.99360245
74,2,car,721,1190,491,680,469,189,0.99408567
75,2,car,722,1191,490,680,469,190,0.99388546
76,2,car,719,1189,490,681,470,191,0.9933415
77,2,car,721,1189,490,681,468,191,0.99309224
78,2,car,720,1189,490,680,469,190,0.9933535
79,2,car,721,1189,490,680,468,190,0.99278355
80,2,car,722,1191,491,679,469,188,0.99334544
81,2,car,721,1189,491,679,468,188,0.9922223
82,2,car,721,1192,491,679,471,188,0.99353355
83,2,car,721,1190,491,680,469,189,0.9941834
84,2,car,721,1192,490,680,471,190,0.9927697
85,2,car,723,1187,491,680,464,189,0.9929273
86,2,car,720,1192,491,680,472,189,0.9943153
87,2,car,721,1190,490,680,469,190,0.9937749
88,2,car,721,1189,491,680,468,189,0.9938193
89,2,car,721,1193,490,681,472,191,0.9946054
90,2,car,721,1190,490,681,469,191,0.99308574
91,2,car,721,1191,490,680,470,190,0.99485815
92,2,car,719,1191,490,680,472,190,0.99378115
93,2,car,719,1192,490,681,473,191,0.994926
94,2,car,722,1192,490,680,470,190,0.9945114
95,2,car,722,1190,490,680,468,190,0.99356544
96,2,car,718,1192,490,680,474,190,0.99396724
97,2,car,720,1192,491,680,472,189,0.99402833
98,2,car,720,1188,490,681,468,191,0.9936452
99,2,car,722,1188,490,681,466,191,0.9941867
100,2,car,722,1189,490,681,467,191,0.99316216
101,2,car,721,1191,490,681,470,191,0.9934978
102,2,car,722,1192,491,679,470,188,0.9947086
103,2,car,719,1191,490,680,472,190,0.99448395
104,2,car,721,1190,490,681,469,191,0.9950352
105,2,car,718,1192,491,680,474,189,0.9946807
106,2,car,720,1190,491,680,470,189,0.9939705
107,2,car,721,1189,490,680,468,190,0.99420947
108,2,car,721,1188,491,679,467,188,0.9941135
109,2,car,720,1190,491,680,470,189,0.99439865
110,2,car,721,1190,490,680,469,190,0.9935835
111,2,car,720,1190,490,680,470,190,0.99316007
112,2,car,720,1190,490,680,470,190,0.99366015
113,2,car,723,1188,491,680,465,189,0.9940172
114,2,car,723,1190,491,680,467,189,0.9925984
115,2,car,720,1189,491,679,469,188,0.99389535
116,2,car,720,1192,491,680,472,189,0.9947525
117,2,car,720,1189,490,681,469,191,0.99338204
118,2,car,723,1190,490,680,467,190,0.993658
119,2,car,722,1191,490,681,469,191,0.9944046
120,2,car,723,1189,491,680,466,189,0.9941147
121,2,car,592,912,482,651,320,169,0.9904916
122,2,car,593,912,482,651,319,169,0.99101853
123,2,car,591,911,482,650,320,168,0.99045604
0,2,car,721,1189,490,680,468,190,0.99354804
1,2,car,721,1190,490,681,469,191,0.9938494
2,2,car,720,1191,490,680,471,190,0.99199617
3,2,car,720,1190,490,680,470,190,0.9928888
4,2,car,722,1190,490,681,468,191,0.9930944
5,2,car,720,1188,490,680,468,190,0.99226046
6,2,car,723,1189,490,681,466,191,0.9939765
7,2,car,720,1190,491,680,470,189,0.9924298
8,2,car,721,1189,492,679,468,187,0.99207807
9,2,car,721,1187,491,679,466,188,0.99360836
10,2,car,722,1192,490,680,470,190,0.99354243
11,2,car,721,1189,490,681,468,191,0.9929695
12,2,car,720,1191,490,680,471,190,0.9934036
13,2,car,721,1190,491,680,469,189,0.9937746
14,2,car,720,1190,491,679,470,188,0.99336284
15,2,car,718,1190,490,680,472,190,0.99366164
16,2,car,724,1188,491,679,464,188,0.99361384
17,2,car,718,1190,490,680,472,190,0.9941106
18,2,car,720,1192,490,681,472,191,0.9934201
19,2,car,721,1192,491,679,471,188,0.99110234
20,2,car,721,1189,489,681,468,192,0.9942035
21,2,car,720,1192,490,680,472,190,0.9943143
22,2,car,720,1189,491,680,469,189,0.99289626
23,2,car,720,1188,490,681,468,191,0.9936275
24,2,car,721,1188,490,680,467,190,0.99227583
25,2,car,723,1189,490,680,466,190,0.9946215
26,2,car,719,1191,491,679,472,188,0.99300593
27,2,car,718,1191,490,681,473,191,0.9933079
28,2,car,720,1188,490,680,468,190,0.99254847
29,2,car,722,1189,491,679,467,188,0.99210006
30,2,car,720,1188,491,680,468,189,0.9942964
31,2,car,722,1189,490,680,467,190,0.9929243
32,2,car,722,1189,490,680,467,190,0.99385345
33,2,car,722,1190,490,681,468,191,0.9937917
34,2,car,721,1188,491,679,467,188,0.9926908
35,2,car,721,1190,490,681,469,191,0.9932829
36,2,car,721,1190,491,680,469,189,0.9928404
37,2,car,721,1191,491,680,470,189,0.9943646
38,2,car,723,1189,491,680,466,189,0.9942534
39,2,car,720,1191,490,681,471,191,0.9926691
40,2,car,721,1191,491,680,470,189,0.9923738
41,2,car,721,1187,492,679,466,187,0.99343777
42,2,car,721,1190,491,680,469,189,0.9931046
43,2,car,722,1188,492,679,466,187,0.9910961
44,2,car,721,1192,491,680,471,189,0.9921725
45,2,car,723,1190,490,680,467,190,0.9929821
46,2,car,723,1190,492,679,467,187,0.99407345
47,2,car,721,1189,490,680,468,190,0.99229693
48,2,car,720,1190,490,681,470,191,0.9942689
49,2,car,722,1190,491,680,468,189,0.9946975
50,2,car,722,1189,492,679,467,187,0.9933555
51,2,car,719,1191,491,680,472,189,0.99077785
52,2,car,720,1189,492,678,469,186,0.99275035
53,2,car,719,1192,491,680,473,189,0.99213934
54,2,car,724,1188,491,679,464,188,0.9937347
55,2,car,721,1191,490,680,470,190,0.9937846
56,2,car,724,1189,489,681,465,192,0.99227536
57,2,car,721,1191,490,681,470,191,0.99170077
58,2,car,722,1189,492,678,467,186,0.99312747
59,2,car,722,1189,490,680,467,190,0.9928037
60,2,car,722,1191,491,680,469,189,0.9921203
61,2,car,722,1189,490,681,467,191,0.9922209
62,2,car,721,1192,490,681,471,191,0.9930029
63,2,car,721,1191,491,680,470,189,0.99370116
64,2,car,721,1192,491,679,471,188,0.99167436
65,2,car,720,1191,489,681,471,192,0.99269456
66,2,car,721,1190,491,680,469,189,0.993381
67,2,car,718,1190,490,681,472,191,0.99364763
68,2,car,722,1193,490,680,471,190,0.99402285
69,2,car,719,1192,490,680,473,190,0.99388003
70,2,car,723,1192,490,680,469,190,0.992976
71,2,car,721,1190,491,680,469,189,0.99315363
72,2,car,721,1190,491,680,469,189,0.9950945
73,2,car,719,1191,490,681,472,191,0.99357724
74,2,car,723,1191,491,680,468,189,0.99360245
75,2,car,721,1190,491,680,469,189,0.99408567
76,2,car,722,1191,490,680,469,190,0.99388546
77,2,car,719,1189,490,681,470,191,0.9933415
78,2,car,721,1189,490,681,468,191,0.99309224
79,2,car,720,1189,490,680,469,190,0.9933535
80,2,car,721,1189,490,680,468,190,0.99278355
81,2,car,722,1191,491,679,469,188,0.99334544
82,2,car,721,1189,491,679,468,188,0.9922223
83,2,car,721,1192,491,679,471,188,0.99353355
84,2,car,721,1190,491,680,469,189,0.9941834
85,2,car,721,1192,490,680,471,190,0.9927697
86,2,car,723,1187,491,680,464,189,0.9929273
87,2,car,720,1192,491,680,472,189,0.9943153
88,2,car,721,1190,490,680,469,190,0.9937749
89,2,car,721,1189,491,680,468,189,0.9938193
90,2,car,721,1193,490,681,472,191,0.9946054
91,2,car,721,1190,490,681,469,191,0.99308574
92,2,car,721,1191,490,680,470,190,0.99485815
93,2,car,719,1191,490,680,472,190,0.99378115
94,2,car,719,1192,490,681,473,191,0.994926
95,2,car,722,1192,490,680,470,190,0.9945114
96,2,car,722,1190,490,680,468,190,0.99356544
97,2,car,718,1192,490,680,474,190,0.99396724
98,2,car,720,1192,491,680,472,189,0.99402833
99,2,car,720,1188,490,681,468,191,0.9936452
100,2,car,722,1188,490,681,466,191,0.9941867
101,2,car,722,1189,490,681,467,191,0.99316216
102,2,car,721,1191,490,681,470,191,0.9934978
103,2,car,722,1192,491,679,470,188,0.9947086
104,2,car,719,1191,490,680,472,190,0.99448395
105,2,car,721,1190,490,681,469,191,0.9950352
106,2,car,718,1192,491,680,474,189,0.9946807
107,2,car,720,1190,491,680,470,189,0.9939705
108,2,car,721,1189,490,680,468,190,0.99420947
109,2,car,721,1188,491,679,467,188,0.9941135
110,2,car,720,1190,491,680,470,189,0.99439865
111,2,car,721,1190,490,680,469,190,0.9935835
112,2,car,720,1190,490,680,470,190,0.99316007
113,2,car,720,1190,490,680,470,190,0.99366015
114,2,car,723,1188,491,680,465,189,0.9940172
115,2,car,723,1190,491,680,467,189,0.9925984
116,2,car,720,1189,491,679,469,188,0.99389535
117,2,car,720,1192,491,680,472,189,0.9947525
118,2,car,720,1189,490,681,469,191,0.99338204
119,2,car,723,1190,490,680,467,190,0.993658
120,2,car,722,1191,490,681,469,191,0.9944046
121,2,car,723,1189,491,680,466,189,0.9941147
122,2,car,592,912,482,651,320,169,0.9904916
123,2,car,593,912,482,651,319,169,0.99101853
124,2,car,591,911,482,650,320,168,0.99045604
0,2,car,720,1191,491,680,471,189,0.99219567
1,2,car,721,1189,490,680,468,190,0.99354804
2,2,car,721,1190,490,681,469,191,0.9938494
3,2,car,720,1191,490,680,471,190,0.99199617
4,2,car,720,1190,490,680,470,190,0.9928888
5,2,car,722,1190,490,681,468,191,0.9930944
6,2,car,720,1188,490,680,468,190,0.99226046
7,2,car,723,1189,490,681,466,191,0.9939765
8,2,car,720,1190,491,680,470,189,0.9924298
9,2,car,721,1189,492,679,468,187,0.99207807
10,2,car,721,1187,491,679,466,188,0.99360836
11,2,car,722,1192,490,680,470,190,0.99354243
12,2,car,721,1189,490,681,468,191,0.9929695
13,2,car,720,1191,490,680,471,190,0.9934036
14,2,car,721,1190,491,680,469,189,0.9937746
15,2,car,720,1190,491,679,470,188,0.99336284
16,2,car,718,1190,490,680,472,190,0.99366164
17,2,car,724,1188,491,679,464,188,0.99361384
18,2,car,718,1190,490,680,472,190,0.9941106
19,2,car,720,1192,490,681,472,191,0.9934201
20,2,car,721,1192,491,679,471,188,0.99110234
21,2,car,721,1189,489,681,468,192,0.9942035
22,2,car,720,1192,490,680,472,190,0.9943143
23,2,car,720,1189,491,680,469,189,0.99289626
24,2,car,720,1188,490,681,468,191,0.9936275
25,2,car,721,1188,490,680,467,190,0.99227583
26,2,car,723,1189,490,680,466,190,0.9946215
27,2,car,719,1191,491,679,472,188,0.99300593
28,2,car,718,1191,490,681,473,191,0.9933079
29,2,car,720,1188,490,680,468,190,0.99254847
30,2,car,722,1189,491,679,467,188,0.99210006
31,2,car,720,1188,491,680,468,189,0.9942964
32,2,car,722,1189,490,680,467,190,0.9929243
33,2,car,722,1189,490,680,467,190,0.99385345
34,2,car,722,1190,490,681,468,191,0.9937917
35,2,car,721,1188,491,679,467,188,0.9926908
36,2,car,721,1190,490,681,469,191,0.9932829
37,2,car,721,1190,491,680,469,189,0.9928404
38,2,car,721,1191,491,680,470,189,0.9943646
39,2,car,723,1189,491,680,466,189,0.9942534
40,2,car,720,1191,490,681,471,191,0.9926691
41,2,car,721,1191,491,680,470,189,0.9923738
42,2,car,721,1187,492,679,466,187,0.99343777
43,2,car,721,1190,491,680,469,189,0.9931046
44,2,car,722,1188,492,679,466,187,0.9910961
45,2,car,721,1192,491,680,471,189,0.9921725
46,2,car,723,1190,490,680,467,190,0.9929821
47,2,car,723,1190,492,679,467,187,0.99407345
48,2,car,721,1189,490,680,468,190,0.99229693
49,2,car,720,1190,490,681,470,191,0.9942689
50,2,car,722,1190,491,680,468,189,0.9946975
51,2,car,722,1189,492,679,467,187,0.9933555
52,2,car,719,1191,491,680,472,189,0.99077785
53,2,car,720,1189,492,678,469,186,0.99275035
54,2,car,719,1192,491,680,473,189,0.99213934
55,2,car,724,1188,491,679,464,188,0.9937347
56,2,car,721,1191,490,680,470,190,0.9937846
57,2,car,724,1189,489,681,465,192,0.99227536
58,2,car,721,1191,490,681,470,191,0.99170077
59,2,car,722,1189,492,678,467,186,0.99312747
60,2,car,722,1189,490,680,467,190,0.9928037
61,2,car,722,1191,491,680,469,189,0.9921203
62,2,car,722,1189,490,681,467,191,0.9922209
63,2,car,721,1192,490,681,471,191,0.9930029
64,2,car,721,1191,491,680,470,189,0.99370116
65,2,car,721,1192,491,679,471,188,0.99167436
66,2,car,720,1191,489,681,471,192,0.99269456
67,2,car,721,1190,491,680,469,189,0.993381
68,2,car,718,1190,490,681,472,191,0.99364763
69,2,car,722,1193,490,680,471,190,0.99402285
70,2,car,719,1192,490,680,473,190,0.99388003
71,2,car,723,1192,490,680,469,190,0.992976
72,2,car,721,1190,491,680,469,189,0.99315363
73,2,car,721,1190,491,680,469,189,0.9950945
74,2,car,719,1191,490,681,472,191,0.99357724
75,2,car,723,1191,491,680,468,189,0.99360245
76,2,car,721,1190,491,680,469,189,0.99408567
77,2,car,722,1191,490,680,469,190,0.99388546
78,2,car,719,1189,490,681,470,191,0.9933415
79,2,car,721,1189,490,681,468,191,0.99309224
80,2,car,720,1189,490,680,469,190,0.9933535
81,2,car,721,1189,490,680,468,190,0.99278355
82,2,car,722,1191,491,679,469,188,0.99334544
83,2,car,721,1189,491,679,468,188,0.9922223
84,2,car,721,1192,491,679,471,188,0.99353355
85,2,car,721,1190,491,680,469,189,0.9941834
86,2,car,721,1192,490,680,471,190,0.9927697
87,2,car,723,1187,491,680,464,189,0.9929273
88,2,car,720,1192,491,680,472,189,0.9943153
89,2,car,721,1190,490,680,469,190,0.9937749
90,2,car,721,1189,491,680,468,189,0.9938193
91,2,car,721,1193,490,681,472,191,0.9946054
92,2,car,721,1190,490,681,469,191,0.99308574
93,2,car,721,1191,490,680,470,190,0.99485815
94,2,car,719,1191,490,680,472,190,0.99378115
95,2,car,719,1192,490,681,473,191,0.994926
96,2,car,722,1192,490,680,470,190,0.9945114
97,2,car,722,1190,490,680,468,190,0.99356544
98,2,car,718,1192,490,680,474,190,0.99396724
99,2,car,720,1192,491,680,472,189,0.99402833
100,2,car,720,1188,490,681,468,191,0.9936452
101,2,car,722,1188,490,681,466,191,0.9941867
102,2,car,722,1189,490,681,467,191,0.99316216
103,2,car,721,1191,490,681,470,191,0.9934978
104,2,car,722,1192,491,679,470,188,0.9947086
105,2,car,719,1191,490,680,472,190,0.99448395
106,2,car,721,1190,490,681,469,191,0.9950352
107,2,car,718,1192,491,680,474,189,0.9946807
108,2,car,720,1190,491,680,470,189,0.9939705
109,2,car,721,1189,490,680,468,190,0.99420947
110,2,car,721,1188,491,679,467,188,0.9941135
111,2,car,720,1190,491,680,470,189,0.99439865
112,2,car,721,1190,490,680,469,190,0.9935835
113,2,car,720,1190,490,680,470,190,0.99316007
114,2,car,720,1190,490,680,470,190,0.99366015
115,2,car,723,1188,491,680,465,189,0.9940172
116,2,car,723,1190,491,680,467,189,0.9925984
117,2,car,720,1189,491,679,469,188,0.99389535
118,2,car,720,1192,491,680,472,189,0.9947525
119,2,car,720,1189,490,681,469,191,0.99338204
120,2,car,723,1190,490,680,467,190,0.993658
121,2,car,722,1191,490,681,469,191,0.9944046
122,2,car,723,1189,491,680,466,189,0.9941147
123,2,car,592,912,482,651,320,169,0.9904916
124,2,car,593,912,482,651,319,169,0.99101853
125,2,car,591,911,482,650,320,168,0.99045604
0,2,car,722,1186,491,680,464,189,0.993539
1,2,car,720,1191,491,680,471,189,0.99219567
2,2,car,721,1189,490,680,468,190,0.99354804
3,2,car,721,1190,490,681,469,191,0.9938494
4,2,car,720,1191,490,680,471,190,0.99199617
5,2,car,720,1190,490,680,470,190,0.9928888
6,2,car,722,1190,490,681,468,191,0.9930944
7,2,car,720,1188,490,680,468,190,0.99226046
8,2,car,723,1189,490,681,466,191,0.9939765
9,2,car,720,1190,491,680,470,189,0.9924298
10,2,car,721,1189,492,679,468,187,0.99207807
11,2,car,721,1187,491,679,466,188,0.99360836
12,2,car,722,1192,490,680,470,190,0.99354243
13,2,car,721,1189,490,681,468,191,0.9929695
14,2,car,720,1191,490,680,471,190,0.9934036
15,2,car,721,1190,491,680,469,189,0.9937746
16,2,car,720,1190,491,679,470,188,0.99336284
17,2,car,718,1190,490,680,472,190,0.99366164
18,2,car,724,1188,491,679,464,188,0.99361384
19,2,car,718,1190,490,680,472,190,0.9941106
20,2,car,720,1192,490,681,472,191,0.9934201
21,2,car,721,1192,491,679,471,188,0.99110234
22,2,car,721,1189,489,681,468,192,0.9942035
23,2,car,720,1192,490,680,472,190,0.9943143
24,2,car,720,1189,491,680,469,189,0.99289626
25,2,car,720,1188,490,681,468,191,0.9936275
26,2,car,721,1188,490,680,467,190,0.99227583
27,2,car,723,1189,490,680,466,190,0.9946215
28,2,car,719,1191,491,679,472,188,0.99300593
29,2,car,718,1191,490,681,473,191,0.9933079
30,2,car,720,1188,490,680,468,190,0.99254847
31,2,car,722,1189,491,679,467,188,0.99210006
32,2,car,720,1188,491,680,468,189,0.9942964
33,2,car,722,1189,490,680,467,190,0.9929243
34,2,car,722,1189,490,680,467,190,0.99385345
35,2,car,722,1190,490,681,468,191,0.9937917
36,2,car,721,1188,491,679,467,188,0.9926908
37,2,car,721,1190,490,681,469,191,0.9932829
38,2,car,721,1190,491,680,469,189,0.9928404
39,2,car,721,1191,491,680,470,189,0.9943646
40,2,car,723,1189,491,680,466,189,0.9942534
41,2,car,720,1191,490,681,471,191,0.9926691
42,2,car,721,1191,491,680,470,189,0.9923738
43,2,car,721,1187,492,679,466,187,0.99343777
44,2,car,721,1190,491,680,469,189,0.9931046
45,2,car,722,1188,492,679,466,187,0.9910961
46,2,car,721,1192,491,680,471,189,0.9921725
47,2,car,723,1190,490,680,467,190,0.9929821
48,2,car,723,1190,492,679,467,187,0.99407345
49,2,car,721,1189,490,680,468,190,0.99229693
50,2,car,720,1190,490,681,470,191,0.9942689
51,2,car,722,1190,491,680,468,189,0.9946975
52,2,car,722,1189,492,679,467,187,0.9933555
53,2,car,719,1191,491,680,472,189,0.99077785
54,2,car,720,1189,492,678,469,186,0.99275035
55,2,car,719,1192,491,680,473,189,0.99213934
56,2,car,724,1188,491,679,464,188,0.9937347
57,2,car,721,1191,490,680,470,190,0.9937846
58,2,car,724,1189,489,681,465,192,0.99227536
59,2,car,721,1191,490,681,470,191,0.99170077
60,2,car,722,1189,492,678,467,186,0.99312747
61,2,car,722,1189,490,680,467,190,0.9928037
62,2,car,722,1191,491,680,469,189,0.9921203
63,2,car,722,1189,490,681,467,191,0.9922209
64,2,car,721,1192,490,681,471,191,0.9930029
65,2,car,721,1191,491,680,470,189,0.99370116
66,2,car,721,1192,491,679,471,188,0.99167436
67,2,car,720,1191,489,681,471,192,0.99269456
68,2,car,721,1190,491,680,469,189,0.993381
69,2,car,718,1190,490,681,472,191,0.99364763
70,2,car,722,1193,490,680,471,190,0.99402285
71,2,car,719,1192,490,680,473,190,0.99388003
72,2,car,723,1192,490,680,469,190,0.992976
73,2,car,721,1190,491,680,469,189,0.99315363
74,2,car,721,1190,491,680,469,189,0.9950945
75,2,car,719,1191,490,681,472,191,0.99357724
76,2,car,723,1191,491,680,468,189,0.99360245
77,2,car,721,1190,491,680,469,189,0.99408567
78,2,car,722,1191,490,680,469,190,0.99388546
79,2,car,719,1189,490,681,470,191,0.9933415
80,2,car,721,1189,490,681,468,191,0.99309224
81,2,car,720,1189,490,680,469,190,0.9933535
82,2,car,721,1189,490,680,468,190,0.99278355
83,2,car,722,1191,491,679,469,188,0.99334544
84,2,car,721,1189,491,679,468,188,0.9922223
85,2,car,721,1192,491,679,471,188,0.99353355
86,2,car,721,1190,491,680,469,189,0.9941834
87,2,car,721,1192,490,680,471,190,0.9927697
88,2,car,723,1187,491,680,464,189,0.9929273
89,2,car,720,1192,491,680,472,189,0.9943153
90,2,car,721,1190,490,680,469,190,0.9937749
91,2,car,721,1189,491,680,468,189,0.9938193
92,2,car,721,1193,490,681,472,191,0.9946054
93,2,car,721,1190,490,681,469,191,0.99308574
94,2,car,721,1191,490,680,470,190,0.99485815
95,2,car,719,1191,490,680,472,190,0.99378115
96,2,car,719,1192,490,681,473,191,0.994926
97,2,car,722,1192,490,680,470,190,0.9945114
98,2,car,722,1190,490,680,468,190,0.99356544
99,2,car,718,1192,490,680,474,190,0.99396724
100,2,car,720,1192,491,680,472,189,0.99402833
101,2,car,720,1188,490,681,468,191,0.9936452
102,2,car,722,1188,490,681,466,191,0.9941867
103,2,car,722,1189,490,681,467,191,0.99316216
104,2,car,721,1191,490,681,470,191,0.9934978
105,2,car,722,1192,491,679,470,188,0.9947086
106,2,car,719,1191,490,680,472,190,0.99448395
107,2,car,721,1190,490,681,469,191,0.9950352
108,2,car,718,1192,491,680,474,189,0.9946807
109,2,car,720,1190,491,680,470,189,0.9939705
110,2,car,721,1189,490,680,468,190,0.99420947
111,2,car,721,1188,491,679,467,188,0.9941135
112,2,car,720,1190,491,680,470,189,0.99439865
113,2,car,721,1190,490,680,469,190,0.9935835
114,2,car,720,1190,490,680,470,190,0.99316007
115,2,car,720,1190,490,680,470,190,0.99366015
116,2,car,723,1188,491,680,465,189,0.9940172
117,2,car,723,1190,491,680,467,189,0.9925984
118,2,car,720,1189,491,679,469,188,0.99389535
119,2,car,720,1192,491,680,472,189,0.9947525
120,2,car,720,1189,490,681,469,191,0.99338204
121,2,car,723,1190,490,680,467,190,0.993658
122,2,car,722,1191,490,681,469,191,0.9944046
123,2,car,723,1189,491,680,466,189,0.9941147
124,2,car,592,912,482,651,320,169,0.9904916
125,2,car,593,912,482,651,319,169,0.99101853
126,2,car,591,911,482,650,320,168,0.99045604
0,2,car,719,1189,491,680,470,189,0.9919515
1,2,car,722,1186,491,680,464,189,0.993539
2,2,car,720,1191,491,680,471,189,0.99219567
3,2,car,721,1189,490,680,468,190,0.99354804
4,2,car,721,1190,490,681,469,191,0.9938494
5,2,car,720,1191,490,680,471,190,0.99199617
6,2,car,720,1190,490,680,470,190,0.9928888
7,2,car,722,1190,490,681,468,191,0.9930944
8,2,car,720,1188,490,680,468,190,0.99226046
9,2,car,723,1189,490,681,466,191,0.9939765
10,2,car,720,1190,491,680,470,189,0.9924298
11,2,car,721,1189,492,679,468,187,0.99207807
12,2,car,721,1187,491,679,466,188,0.99360836
13,2,car,722,1192,490,680,470,190,0.99354243
14,2,car,721,1189,490,681,468,191,0.9929695
15,2,car,720,1191,490,680,471,190,0.9934036
16,2,car,721,1190,491,680,469,189,0.9937746
17,2,car,720,1190,491,679,470,188,0.99336284
18,2,car,718,1190,490,680,472,190,0.99366164
19,2,car,724,1188,491,679,464,188,0.99361384
20,2,car,718,1190,490,680,472,190,0.9941106
21,2,car,720,1192,490,681,472,191,0.9934201
22,2,car,721,1192,491,679,471,188,0.99110234
23,2,car,721,1189,489,681,468,192,0.9942035
24,2,car,720,1192,490,680,472,190,0.9943143
25,2,car,720,1189,491,680,469,189,0.99289626
26,2,car,720,1188,490,681,468,191,0.9936275
27,2,car,721,1188,490,680,467,190,0.99227583
28,2,car,723,1189,490,680,466,190,0.9946215
29,2,car,719,1191,491,679,472,188,0.99300593
30,2,car,718,1191,490,681,473,191,0.9933079
31,2,car,720,1188,490,680,468,190,0.99254847
32,2,car,722,1189,491,679,467,188,0.99210006
33,2,car,720,1188,491,680,468,189,0.9942964
34,2,car,722,1189,490,680,467,190,0.9929243
35,2,car,722,1189,490,680,467,190,0.99385345
36,2,car,722,1190,490,681,468,191,0.9937917
37,2,car,721,1188,491,679,467,188,0.9926908
38,2,car,721,1190,490,681,469,191,0.9932829
39,2,car,721,1190,491,680,469,189,0.9928404
40,2,car,721,1191,491,680,470,189,0.9943646
41,2,car,723,1189,491,680,466,189,0.9942534
42,2,car,720,1191,490,681,471,191,0.9926691
43,2,car,721,1191,491,680,470,189,0.9923738
44,2,car,721,1187,492,679,466,187,0.99343777
45,2,car,721,1190,491,680,469,189,0.9931046
46,2,car,722,1188,492,679,466,187,0.9910961
47,2,car,721,1192,491,680,471,189,0.9921725
48,2,car,723,1190,490,680,467,190,0.9929821
49,2,car,723,1190,492,679,467,187,0.99407345
50,2,car,721,1189,490,680,468,190,0.99229693
51,2,car,720,1190,490,681,470,191,0.9942689
52,2,car,722,1190,491,680,468,189,0.9946975
53,2,car,722,1189,492,679,467,187,0.9933555
54,2,car,719,1191,491,680,472,189,0.99077785
55,2,car,720,1189,492,678,469,186,0.99275035
56,2,car,719,1192,491,680,473,189,0.99213934
57,2,car,724,1188,491,679,464,188,0.9937347
58,2,car,721,1191,490,680,470,190,0.9937846
59,2,car,724,1189,489,681,465,192,0.99227536
60,2,car,721,1191,490,681,470,191,0.99170077
61,2,car,722,1189,492,678,467,186,0.99312747
62,2,car,722,1189,490,680,467,190,0.9928037
63,2,car,722,1191,491,680,469,189,0.9921203
64,2,car,722,1189,490,681,467,191,0.9922209
65,2,car,721,1192,490,681,471,191,0.9930029
66,2,car,721,1191,491,680,470,189,0.99370116
67,2,car,721,1192,491,679,471,188,0.99167436
68,2,car,720,1191,489,681,471,192,0.99269456
69,2,car,721,1190,491,680,469,189,0.993381
70,2,car,718,1190,490,681,472,191,0.99364763
71,2,car,722,1193,490,680,471,190,0.99402285
72,2,car,719,1192,490,680,473,190,0.99388003
73,2,car,723,1192,490,680,469,190,0.992976
74,2,car,721,1190,491,680,469,189,0.99315363
75,2,car,721,1190,491,680,469,189,0.9950945
76,2,car,719,1191,490,681,472,191,0.99357724
77,2,car,723,1191,491,680,468,189,0.99360245
78,2,car,721,1190,491,680,469,189,0.99408567
79,2,car,722,1191,490,680,469,190,0.99388546
80,2,car,719,1189,490,681,470,191,0.9933415
81,2,car,721,1189,490,681,468,191,0.99309224
82,2,car,720,1189,490,680,469,190,0.9933535
83,2,car,721,1189,490,680,468,190,0.99278355
84,2,car,722,1191,491,679,469,188,0.99334544
85,2,car,721,1189,491,679,468,188,0.9922223
86,2,car,721,1192,491,679,471,188,0.99353355
87,2,car,721,1190,491,680,469,189,0.9941834
88,2,car,721,1192,490,680,471,190,0.9927697
89,2,car,723,1187,491,680,464,189,0.9929273
90,2,car,720,1192,491,680,472,189,0.9943153
91,2,car,721,1190,490,680,469,190,0.9937749
92,2,car,721,1189,491,680,468,189,0.9938193
93,2,car,721,1193,490,681,472,191,0.9946054
94,2,car,721,1190,490,681,469,191,0.99308574
95,2,car,721,1191,490,680,470,190,0.99485815
96,2,car,719,1191,490,680,472,190,0.99378115
97,2,car,719,1192,490,681,473,191,0.994926
98,2,car,722,1192,490,680,470,190,0.9945114
99,2,car,722,1190,490,680,468,190,0.99356544
100,2,car,718,1192,490,680,474,190,0.99396724
101,2,car,720,1192,491,680,472,189,0.99402833
102,2,car,720,1188,490,681,468,191,0.9936452
103,2,car,722,1188,490,681,466,191,0.9941867
104,2,car,722,1189,490,681,467,191,0.99316216
105,2,car,721,1191,490,681,470,191,0.9934978
106,2,car,722,1192,491,679,470,188,0.9947086
107,2,car,719,1191,490,680,472,190,0.99448395
108,2,car,721,1190,490,681,469,191,0.9950352
109,2,car,718,1192,491,680,474,189,0.9946807
110,2,car,720,1190,491,680,470,189,0.9939705
111,2,car,721,1189,490,680,468,190,0.99420947
112,2,car,721,1188,491,679,467,188,0.9941135
113,2,car,720,1190,491,680,470,189,0.99439865
114,2,car,721,1190,490,680,469,190,0.9935835
115,2,car,720,1190,490,680,470,190,0.99316007
116,2,car,720,1190,490,680,470,190,0.99366015
117,2,car,723,1188,491,680,465,189,0.9940172
118,2,car,723,1190,491,680,467,189,0.9925984
119,2,car,720,1189,491,679,469,188,0.99389535
120,2,car,720,1192,491,680,472,189,0.9947525
121,2,car,720,1189,490,681,469,191,0.99338204
122,2,car,723,1190,490,680,467,190,0.993658
123,2,car,722,1191,490,681,469,191,0.9944046
124,2,car,723,1189,491,680,466,189,0.9941147
125,2,car,592,912,482,651,320,169,0.9904916
126,2,car,593,912,482,651,319,169,0.99101853
127,2,car,591,911,482,650,320,168,0.99045604
0,2,car,722,1189,491,680,467,189,0.9922194
1,2,car,719,1189,491,680,470,189,0.9919515
2,2,car,722,1186,491,680,464,189,0.993539
3,2,car,720,1191,491,680,471,189,0.99219567
4,2,car,721,1189,490,680,468,190,0.99354804
5,2,car,721,1190,490,681,469,191,0.9938494
6,2,car,720,1191,490,680,471,190,0.99199617
7,2,car,720,1190,490,680,470,190,0.9928888
8,2,car,722,1190,490,681,468,191,0.9930944
9,2,car,720,1188,490,680,468,190,0.99226046
10,2,car,723,1189,490,681,466,191,0.9939765
11,2,car,720,1190,491,680,470,189,0.9924298
12,2,car,721,1189,492,679,468,187,0.99207807
13,2,car,721,1187,491,679,466,188,0.99360836
14,2,car,722,1192,490,680,470,190,0.99354243
15,2,car,721,1189,490,681,468,191,0.9929695
16,2,car,720,1191,490,680,471,190,0.9934036
17,2,car,721,1190,491,680,469,189,0.9937746
18,2,car,720,1190,491,679,470,188,0.99336284
19,2,car,718,1190,490,680,472,190,0.99366164
20,2,car,724,1188,491,679,464,188,0.99361384
21,2,car,718,1190,490,680,472,190,0.9941106
22,2,car,720,1192,490,681,472,191,0.9934201
23,2,car,721,1192,491,679,471,188,0.99110234
24,2,car,721,1189,489,681,468,192,0.9942035
25,2,car,720,1192,490,680,472,190,0.9943143
26,2,car,720,1189,491,680,469,189,0.99289626
27,2,car,720,1188,490,681,468,191,0.9936275
28,2,car,721,1188,490,680,467,190,0.99227583
29,2,car,723,1189,490,680,466,190,0.9946215
30,2,car,719,1191,491,679,472,188,0.99300593
31,2,car,718,1191,490,681,473,191,0.9933079
32,2,car,720,1188,490,680,468,190,0.99254847
33,2,car,722,1189,491,679,467,188,0.99210006
34,2,car,720,1188,491,680,468,189,0.9942964
35,2,car,722,1189,490,680,467,190,0.9929243
36,2,car,722,1189,490,680,467,190,0.99385345
37,2,car,722,1190,490,681,468,191,0.9937917
38,2,car,721,1188,491,679,467,188,0.9926908
39,2,car,721,1190,490,681,469,191,0.9932829
40,2,car,721,1190,491,680,469,189,0.9928404
41,2,car,721,1191,491,680,470,189,0.9943646
42,2,car,723,1189,491,680,466,189,0.9942534
43,2,car,720,1191,490,681,471,191,0.9926691
44,2,car,721,1191,491,680,470,189,0.9923738
45,2,car,721,1187,492,679,466,187,0.99343777
46,2,car,721,1190,491,680,469,189,0.9931046
47,2,car,722,1188,492,679,466,187,0.9910961
48,2,car,721,1192,491,680,471,189,0.9921725
49,2,car,723,1190,490,680,467,190,0.9929821
50,2,car,723,1190,492,679,467,187,0.99407345
51,2,car,721,1189,490,680,468,190,0.99229693
52,2,car,720,1190,490,681,470,191,0.9942689
53,2,car,722,1190,491,680,468,189,0.9946975
54,2,car,722,1189,492,679,467,187,0.9933555
55,2,car,719,1191,491,680,472,189,0.99077785
56,2,car,720,1189,492,678,469,186,0.99275035
57,2,car,719,1192,491,680,473,189,0.99213934
58,2,car,724,1188,491,679,464,188,0.9937347
59,2,car,721,1191,490,680,470,190,0.9937846
60,2,car,724,1189,489,681,465,192,0.99227536
61,2,car,721,1191,490,681,470,191,0.99170077
62,2,car,722,1189,492,678,467,186,0.99312747
63,2,car,722,1189,490,680,467,190,0.9928037
64,2,car,722,1191,491,680,469,189,0.9921203
65,2,car,722,1189,490,681,467,191,0.9922209
66,2,car,721,1192,490,681,471,191,0.9930029
67,2,car,721,1191,491,680,470,189,0.99370116
68,2,car,721,1192,491,679,471,188,0.99167436
69,2,car,720,1191,489,681,471,192,0.99269456
70,2,car,721,1190,491,680,469,189,0.993381
71,2,car,718,1190,490,681,472,191,0.99364763
72,2,car,722,1193,490,680,471,190,0.99402285
73,2,car,719,1192,490,680,473,190,0.99388003
74,2,car,723,1192,490,680,469,190,0.992976
75,2,car,721,1190,491,680,469,189,0.99315363
76,2,car,721,1190,491,680,469,189,0.9950945
77,2,car,719,1191,490,681,472,191,0.99357724
78,2,car,723,1191,491,680,468,189,0.99360245
79,2,car,721,1190,491,680,469,189,0.99408567
80,2,car,722,1191,490,680,469,190,0.99388546
81,2,car,719,1189,490,681,470,191,0.9933415
82,2,car,721,1189,490,681,468,191,0.99309224
83,2,car,720,1189,490,680,469,190,0.9933535
84,2,car,721,1189,490,680,468,190,0.99278355
85,2,car,722,1191,491,679,469,188,0.99334544
86,2,car,721,1189,491,679,468,188,0.9922223
87,2,car,721,1192,491,679,471,188,0.99353355
88,2,car,721,1190,491,680,469,189,0.9941834
89,2,car,721,1192,490,680,471,190,0.9927697
90,2,car,723,1187,491,680,464,189,0.9929273
91,2,car,720,1192,491,680,472,189,0.9943153
92,2,car,721,1190,490,680,469,190,0.9937749
93,2,car,721,1189,491,680,468,189,0.9938193
94,2,car,721,1193,490,681,472,191,0.9946054
95,2,car,721,1190,490,681,469,191,0.99308574
96,2,car,721,1191,490,680,470,190,0.99485815
97,2,car,719,1191,490,680,472,190,0.99378115
98,2,car,719,1192,490,681,473,191,0.994926
99,2,car,722,1192,490,680,470,190,0.9945114
100,2,car,722,1190,490,680,468,190,0.99356544
101,2,car,718,1192,490,680,474,190,0.99396724
102,2,car,720,1192,491,680,472,189,0.99402833
103,2,car,720,1188,490,681,468,191,0.9936452
104,2,car,722,1188,490,681,466,191,0.9941867
105,2,car,722,1189,490,681,467,191,0.99316216
106,2,car,721,1191,490,681,470,191,0.9934978
107,2,car,722,1192,491,679,470,188,0.9947086
108,2,car,719,1191,490,680,472,190,0.99448395
109,2,car,721,1190,490,681,469,191,0.9950352
110,2,car,718,1192,491,680,474,189,0.9946807
111,2,car,720,1190,491,680,470,189,0.9939705
112,2,car,721,1189,490,680,468,190,0.99420947
113,2,car,721,1188,491,679,467,188,0.9941135
114,2,car,720,1190,491,680,470,189,0.99439865
115,2,car,721,1190,490,680,469,190,0.9935835
116,2,car,720,1190,490,680,470,190,0.99316007
117,2,car,720,1190,490,680,470,190,0.99366015
118,2,car,723,1188,491,680,465,189,0.9940172
119,2,car,723,1190,491,680,467,189,0.9925984
120,2,car,720,1189,491,679,469,188,0.99389535
121,2,car,720,1192,491,680,472,189,0.9947525
122,2,car,720,1189,490,681,469,191,0.99338204
123,2,car,723,1190,490,680,467,190,0.993658
124,2,car,722,1191,490,681,469,191,0.9944046
125,2,car,723,1189,491,680,466,189,0.9941147
126,2,car,592,912,482,651,320,169,0.9904916
127,2,car,593,912,482,651,319,169,0.99101853
128,2,car,591,911,482,650,320,168,0.99045604
0,2,car,721,1191,490,680,470,190,0.99220794
1,2,car,722,1189,491,680,467,189,0.9922194
2,2,car,719,1189,491,680,470,189,0.9919515
3,2,car,722,1186,491,680,464,189,0.993539
4,2,car,720,1191,491,680,471,189,0.99219567
5,2,car,721,1189,490,680,468,190,0.99354804
6,2,car,721,1190,490,681,469,191,0.9938494
7,2,car,720,1191,490,680,471,190,0.99199617
8,2,car,720,1190,490,680,470,190,0.9928888
9,2,car,722,1190,490,681,468,191,0.9930944
10,2,car,720,1188,490,680,468,190,0.99226046
11,2,car,723,1189,490,681,466,191,0.9939765
12,2,car,720,1190,491,680,470,189,0.9924298
13,2,car,721,1189,492,679,468,187,0.99207807
14,2,car,721,1187,491,679,466,188,0.99360836
15,2,car,722,1192,490,680,470,190,0.99354243
16,2,car,721,1189,490,681,468,191,0.9929695
17,2,car,720,1191,490,680,471,190,0.9934036
18,2,car,721,1190,491,680,469,189,0.9937746
19,2,car,720,1190,491,679,470,188,0.99336284
20,2,car,718,1190,490,680,472,190,0.99366164
21,2,car,724,1188,491,679,464,188,0.99361384
22,2,car,718,1190,490,680,472,190,0.9941106
23,2,car,720,1192,490,681,472,191,0.9934201
24,2,car,721,1192,491,679,471,188,0.99110234
25,2,car,721,1189,489,681,468,192,0.9942035
26,2,car,720,1192,490,680,472,190,0.9943143
27,2,car,720,1189,491,680,469,189,0.99289626
28,2,car,720,1188,490,681,468,191,0.9936275
29,2,car,721,1188,490,680,467,190,0.99227583
30,2,car,723,1189,490,680,466,190,0.9946215
31,2,car,719,1191,491,679,472,188,0.99300593
32,2,car,718,1191,490,681,473,191,0.9933079
33,2,car,720,1188,490,680,468,190,0.99254847
34,2,car,722,1189,491,679,467,188,0.99210006
35,2,car,720,1188,491,680,468,189,0.9942964
36,2,car,722,1189,490,680,467,190,0.9929243
37,2,car,722,1189,490,680,467,190,0.99385345
38,2,car,722,1190,490,681,468,191,0.9937917
39,2,car,721,1188,491,679,467,188,0.9926908
40,2,car,721,1190,490,681,469,191,0.9932829
41,2,car,721,1190,491,680,469,189,0.9928404
42,2,car,721,1191,491,680,470,189,0.9943646
43,2,car,723,1189,491,680,466,189,0.9942534
44,2,car,720,1191,490,681,471,191,0.9926691
45,2,car,721,1191,491,680,470,189,0.9923738
46,2,car,721,1187,492,679,466,187,0.99343777
47,2,car,721,1190,491,680,469,189,0.9931046
48,2,car,722,1188,492,679,466,187,0.9910961
49,2,car,721,1192,491,680,471,189,0.9921725
50,2,car,723,1190,490,680,467,190,0.9929821
51,2,car,723,1190,492,679,467,187,0.99407345
52,2,car,721,1189,490,680,468,190,0.99229693
53,2,car,720,1190,490,681,470,191,0.9942689
54,2,car,722,1190,491,680,468,189,0.9946975
55,2,car,722,1189,492,679,467,187,0.9933555
56,2,car,719,1191,491,680,472,189,0.99077785
57,2,car,720,1189,492,678,469,186,0.99275035
58,2,car,719,1192,491,680,473,189,0.99213934
59,2,car,724,1188,491,679,464,188,0.9937347
60,2,car,721,1191,490,680,470,190,0.9937846
61,2,car,724,1189,489,681,465,192,0.99227536
62,2,car,721,1191,490,681,470,191,0.99170077
63,2,car,722,1189,492,678,467,186,0.99312747
64,2,car,722,1189,490,680,467,190,0.9928037
65,2,car,722,1191,491,680,469,189,0.9921203
66,2,car,722,1189,490,681,467,191,0.9922209
67,2,car,721,1192,490,681,471,191,0.9930029
68,2,car,721,1191,491,680,470,189,0.99370116
69,2,car,721,1192,491,679,471,188,0.99167436
70,2,car,720,1191,489,681,471,192,0.99269456
71,2,car,721,1190,491,680,469,189,0.993381
72,2,car,718,1190,490,681,472,191,0.99364763
73,2,car,722,1193,490,680,471,190,0.99402285
74,2,car,719,1192,490,680,473,190,0.99388003
75,2,car,723,1192,490,680,469,190,0.992976
76,2,car,721,1190,491,680,469,189,0.99315363
77,2,car,721,1190,491,680,469,189,0.9950945
78,2,car,719,1191,490,681,472,191,0.99357724
79,2,car,723,1191,491,680,468,189,0.99360245
80,2,car,721,1190,491,680,469,189,0.99408567
81,2,car,722,1191,490,680,469,190,0.99388546
82,2,car,719,1189,490,681,470,191,0.9933415
83,2,car,721,1189,490,681,468,191,0.99309224
84,2,car,720,1189,490,680,469,190,0.9933535
85,2,car,721,1189,490,680,468,190,0.99278355
86,2,car,722,1191,491,679,469,188,0.99334544
87,2,car,721,1189,491,679,468,188,0.9922223
88,2,car,721,1192,491,679,471,188,0.99353355
89,2,car,721,1190,491,680,469,189,0.9941834
90,2,car,721,1192,490,680,471,190,0.9927697
91,2,car,723,1187,491,680,464,189,0.9929273
92,2,car,720,1192,491,680,472,189,0.9943153
93,2,car,721,1190,490,680,469,190,0.9937749
94,2,car,721,1189,491,680,468,189,0.9938193
95,2,car,721,1193,490,681,472,191,0.9946054
96,2,car,721,1190,490,681,469,191,0.99308574
97,2,car,721,1191,490,680,470,190,0.99485815
98,2,car,719,1191,490,680,472,190,0.99378115
99,2,car,719,1192,490,681,473,191,0.994926
100,2,car,722,1192,490,680,470,190,0.9945114
101,2,car,722,1190,490,680,468,190,0.99356544
102,2,car,718,1192,490,680,474,190,0.99396724
103,2,car,720,1192,491,680,472,189,0.99402833
104,2,car,720,1188,490,681,468,191,0.9936452
105,2,car,722,1188,490,681,466,191,0.9941867
106,2,car,722,1189,490,681,467,191,0.99316216
107,2,car,721,1191,490,681,470,191,0.9934978
108,2,car,722,1192,491,679,470,188,0.9947086
109,2,car,719,1191,490,680,472,190,0.99448395
110,2,car,721,1190,490,681,469,191,0.9950352
111,2,car,718,1192,491,680,474,189,0.9946807
112,2,car,720,1190,491,680,470,189,0.9939705
113,2,car,721,1189,490,680,468,190,0.99420947
114,2,car,721,1188,491,679,467,188,0.9941135
115,2,car,720,1190,491,680,470,189,0.99439865
116,2,car,721,1190,490,680,469,190,0.9935835
117,2,car,720,1190,490,680,470,190,0.99316007
118,2,car,720,1190,490,680,470,190,0.99366015
119,2,car,723,1188,491,680,465,189,0.9940172
120,2,car,723,1190,491,680,467,189,0.9925984
121,2,car,720,1189,491,679,469,188,0.99389535
122,2,car,720,1192,491,680,472,189,0.9947525
123,2,car,720,1189,490,681,469,191,0.99338204
124,2,car,723,1190,490,680,467,190,0.993658
125,2,car,722,1191,490,681,469,191,0.9944046
126,2,car,723,1189,491,680,466,189,0.9941147
127,2,car,592,912,482,651,320,169,0.9904916
128,2,car,593,912,482,651,319,169,0.99101853
129,2,car,591,911,482,650,320,168,0.99045604
0,2,car,721,1188,490,680,467,190,0.9927945
1,2,car,721,1191,490,680,470,190,0.99220794
2,2,car,722,1189,491,680,467,189,0.9922194
3,2,car,719,1189,491,680,470,189,0.9919515
4,2,car,722,1186,491,680,464,189,0.993539
5,2,car,720,1191,491,680,471,189,0.99219567
6,2,car,721,1189,490,680,468,190,0.99354804
7,2,car,721,1190,490,681,469,191,0.9938494
8,2,car,720,1191,490,680,471,190,0.99199617
9,2,car,720,1190,490,680,470,190,0.9928888
10,2,car,722,1190,490,681,468,191,0.9930944
11,2,car,720,1188,490,680,468,190,0.99226046
12,2,car,723,1189,490,681,466,191,0.9939765
13,2,car,720,1190,491,680,470,189,0.9924298
14,2,car,721,1189,492,679,468,187,0.99207807
15,2,car,721,1187,491,679,466,188,0.99360836
16,2,car,722,1192,490,680,470,190,0.99354243
17,2,car,721,1189,490,681,468,191,0.9929695
18,2,car,720,1191,490,680,471,190,0.9934036
19,2,car,721,1190,491,680,469,189,0.9937746
20,2,car,720,1190,491,679,470,188,0.99336284
21,2,car,718,1190,490,680,472,190,0.99366164
22,2,car,724,1188,491,679,464,188,0.99361384
23,2,car,718,1190,490,680,472,190,0.9941106
24,2,car,720,1192,490,681,472,191,0.9934201
25,2,car,721,1192,491,679,471,188,0.99110234
26,2,car,721,1189,489,681,468,192,0.9942035
27,2,car,720,1192,490,680,472,190,0.9943143
28,2,car,720,1189,491,680,469,189,0.99289626
29,2,car,720,1188,490,681,468,191,0.9936275
30,2,car,721,1188,490,680,467,190,0.99227583
31,2,car,723,1189,490,680,466,190,0.9946215
32,2,car,719,1191,491,679,472,188,0.99300593
33,2,car,718,1191,490,681,473,191,0.9933079
34,2,car,720,1188,490,680,468,190,0.99254847
35,2,car,722,1189,491,679,467,188,0.99210006
36,2,car,720,1188,491,680,468,189,0.9942964
37,2,car,722,1189,490,680,467,190,0.9929243
38,2,car,722,1189,490,680,467,190,0.99385345
39,2,car,722,1190,490,681,468,191,0.9937917
40,2,car,721,1188,491,679,467,188,0.9926908
41,2,car,721,1190,490,681,469,191,0.9932829
42,2,car,721,1190,491,680,469,189,0.9928404
43,2,car,721,1191,491,680,470,189,0.9943646
44,2,car,723,1189,491,680,466,189,0.9942534
45,2,car,720,1191,490,681,471,191,0.9926691
46,2,car,721,1191,491,680,470,189,0.9923738
47,2,car,721,1187,492,679,466,187,0.99343777
48,2,car,721,1190,491,680,469,189,0.9931046
49,2,car,722,1188,492,679,466,187,0.9910961
50,2,car,721,1192,491,680,471,189,0.9921725
51,2,car,723,1190,490,680,467,190,0.9929821
52,2,car,723,1190,492,679,467,187,0.99407345
53,2,car,721,1189,490,680,468,190,0.99229693
54,2,car,720,1190,490,681,470,191,0.9942689
55,2,car,722,1190,491,680,468,189,0.9946975
56,2,car,722,1189,492,679,467,187,0.9933555
57,2,car,719,1191,491,680,472,189,0.99077785
58,2,car,720,1189,492,678,469,186,0.99275035
59,2,car,719,1192,491,680,473,189,0.99213934
60,2,car,724,1188,491,679,464,188,0.9937347
61,2,car,721,1191,490,680,470,190,0.9937846
62,2,car,724,1189,489,681,465,192,0.99227536
63,2,car,721,1191,490,681,470,191,0.99170077
64,2,car,722,1189,492,678,467,186,0.99312747
65,2,car,722,1189,490,680,467,190,0.9928037
66,2,car,722,1191,491,680,469,189,0.9921203
67,2,car,722,1189,490,681,467,191,0.9922209
68,2,car,721,1192,490,681,471,191,0.9930029
69,2,car,721,1191,491,680,470,189,0.99370116
70,2,car,721,1192,491,679,471,188,0.99167436
71,2,car,720,1191,489,681,471,192,0.99269456
72,2,car,721,1190,491,680,469,189,0.993381
73,2,car,718,1190,490,681,472,191,0.99364763
74,2,car,722,1193,490,680,471,190,0.99402285
75,2,car,719,1192,490,680,473,190,0.99388003
76,2,car,723,1192,490,680,469,190,0.992976
77,2,car,721,1190,491,680,469,189,0.99315363
78,2,car,721,1190,491,680,469,189,0.9950945
79,2,car,719,1191,490,681,472,191,0.99357724
80,2,car,723,1191,491,680,468,189,0.99360245
81,2,car,721,1190,491,680,469,189,0.99408567
82,2,car,722,1191,490,680,469,190,0.99388546
83,2,car,719,1189,490,681,470,191,0.9933415
84,2,car,721,1189,490,681,468,191,0.99309224
85,2,car,720,1189,490,680,469,190,0.9933535
86,2,car,721,1189,490,680,468,190,0.99278355
87,2,car,722,1191,491,679,469,188,0.99334544
88,2,car,721,1189,491,679,468,188,0.9922223
89,2,car,721,1192,491,679,471,188,0.99353355
90,2,car,721,1190,491,680,469,189,0.9941834
91,2,car,721,1192,490,680,471,190,0.9927697
92,2,car,723,1187,491,680,464,189,0.9929273
93,2,car,720,1192,491,680,472,189,0.9943153
94,2,car,721,1190,490,680,469,190,0.9937749
95,2,car,721,1189,491,680,468,189,0.9938193
96,2,car,721,1193,490,681,472,191,0.9946054
97,2,car,721,1190,490,681,469,191,0.99308574
98,2,car,721,1191,490,680,470,190,0.99485815
99,2,car,719,1191,490,680,472,190,0.99378115
100,2,car,719,1192,490,681,473,191,0.994926
101,2,car,722,1192,490,680,470,190,0.9945114
102,2,car,722,1190,490,680,468,190,0.99356544
103,2,car,718,1192,490,680,474,190,0.99396724
104,2,car,720,1192,491,680,472,189,0.99402833
105,2,car,720,1188,490,681,468,191,0.9936452
106,2,car,722,1188,490,681,466,191,0.9941867
107,2,car,722,1189,490,681,467,191,0.99316216
108,2,car,721,1191,490,681,470,191,0.9934978
109,2,car,722,1192,491,679,470,188,0.9947086
110,2,car,719,1191,490,680,472,190,0.99448395
111,2,car,721,1190,490,681,469,191,0.9950352
112,2,car,718,1192,491,680,474,189,0.9946807
113,2,car,720,1190,491,680,470,189,0.9939705
114,2,car,721,1189,490,680,468,190,0.99420947
115,2,car,721,1188,491,679,467,188,0.9941135
116,2,car,720,1190,491,680,470,189,0.99439865
117,2,car,721,1190,490,680,469,190,0.9935835
118,2,car,720,1190,490,680,470,190,0.99316007
119,2,car,720,1190,490,680,470,190,0.99366015
120,2,car,723,1188,491,680,465,189,0.9940172
121,2,car,723,1190,491,680,467,189,0.9925984
122,2,car,720,1189,491,679,469,188,0.99389535
123,2,car,720,1192,491,680,472,189,0.9947525
124,2,car,720,1189,490,681,469,191,0.99338204
125,2,car,723,1190,490,680,467,190,0.993658
126,2,car,722,1191,490,681,469,191,0.9944046
127,2,car,723,1189,491,680,466,189,0.9941147
128,2,car,592,912,482,651,320,169,0.9904916
129,2,car,593,912,482,651,319,169,0.99101853
130,2,car,591,911,482,650,320,168,0.99045604
0,2,car,719,1189,491,680,470,189,0.9926875
1,2,car,721,1188,490,680,467,190,0.9927945
2,2,car,721,1191,490,680,470,190,0.99220794
3,2,car,722,1189,491,680,467,189,0.9922194
4,2,car,719,1189,491,680,470,189,0.9919515
5,2,car,722,1186,491,680,464,189,0.993539
6,2,car,720,1191,491,680,471,189,0.99219567
7,2,car,721,1189,490,680,468,190,0.99354804
8,2,car,721,1190,490,681,469,191,0.9938494
9,2,car,720,1191,490,680,471,190,0.99199617
10,2,car,720,1190,490,680,470,190,0.9928888
11,2,car,722,1190,490,681,468,191,0.9930944
12,2,car,720,1188,490,680,468,190,0.99226046
13,2,car,723,1189,490,681,466,191,0.9939765
14,2,car,720,1190,491,680,470,189,0.9924298
15,2,car,721,1189,492,679,468,187,0.99207807
16,2,car,721,1187,491,679,466,188,0.99360836
17,2,car,722,1192,490,680,470,190,0.99354243
18,2,car,721,1189,490,681,468,191,0.9929695
19,2,car,720,1191,490,680,471,190,0.9934036
20,2,car,721,1190,491,680,469,189,0.9937746
21,2,car,720,1190,491,679,470,188,0.99336284
22,2,car,718,1190,490,680,472,190,0.99366164
23,2,car,724,1188,491,679,464,188,0.99361384
24,2,car,718,1190,490,680,472,190,0.9941106
25,2,car,720,1192,490,681,472,191,0.9934201
26,2,car,721,1192,491,679,471,188,0.99110234
27,2,car,721,1189,489,681,468,192,0.9942035
28,2,car,720,1192,490,680,472,190,0.9943143
29,2,car,720,1189,491,680,469,189,0.99289626
30,2,car,720,1188,490,681,468,191,0.9936275
31,2,car,721,1188,490,680,467,190,0.99227583
32,2,car,723,1189,490,680,466,190,0.9946215
33,2,car,719,1191,491,679,472,188,0.99300593
34,2,car,718,1191,490,681,473,191,0.9933079
35,2,car,720,1188,490,680,468,190,0.99254847
36,2,car,722,1189,491,679,467,188,0.99210006
37,2,car,720,1188,491,680,468,189,0.9942964
38,2,car,722,1189,490,680,467,190,0.9929243
39,2,car,722,1189,490,680,467,190,0.99385345
40,2,car,722,1190,490,681,468,191,0.9937917
41,2,car,721,1188,491,679,467,188,0.9926908
42,2,car,721,1190,490,681,469,191,0.9932829
43,2,car,721,1190,491,680,469,189,0.9928404
44,2,car,721,1191,491,680,470,189,0.9943646
45,2,car,723,1189,491,680,466,189,0.9942534
46,2,car,720,1191,490,681,471,191,0.9926691
47,2,car,721,1191,491,680,470,189,0.9923738
48,2,car,721,1187,492,679,466,187,0.99343777
49,2,car,721,1190,491,680,469,189,0.9931046
50,2,car,722,1188,492,679,466,187,0.9910961
51,2,car,721,1192,491,680,471,189,0.9921725
52,2,car,723,1190,490,680,467,190,0.9929821
53,2,car,723,1190,492,679,467,187,0.99407345
54,2,car,721,1189,490,680,468,190,0.99229693
55,2,car,720,1190,490,681,470,191,0.9942689
56,2,car,722,1190,491,680,468,189,0.9946975
57,2,car,722,1189,492,679,467,187,0.9933555
58,2,car,719,1191,491,680,472,189,0.99077785
59,2,car,720,1189,492,678,469,186,0.99275035
60,2,car,719,1192,491,680,473,189,0.99213934
61,2,car,724,1188,491,679,464,188,0.9937347
62,2,car,721,1191,490,680,470,190,0.9937846
63,2,car,724,1189,489,681,465,192,0.99227536
64,2,car,721,1191,490,681,470,191,0.99170077
65,2,car,722,1189,492,678,467,186,0.99312747
66,2,car,722,1189,490,680,467,190,0.9928037
67,2,car,722,1191,491,680,469,189,0.9921203
68,2,car,722,1189,490,681,467,191,0.9922209
69,2,car,721,1192,490,681,471,191,0.9930029
70,2,car,721,1191,491,680,470,189,0.99370116
71,2,car,721,1192,491,679,471,188,0.99167436
72,2,car,720,1191,489,681,471,192,0.99269456
73,2,car,721,1190,491,680,469,189,0.993381
74,2,car,718,1190,490,681,472,191,0.99364763
75,2,car,722,1193,490,680,471,190,0.99402285
76,2,car,719,1192,490,680,473,190,0.99388003
77,2,car,723,1192,490,680,469,190,0.992976
78,2,car,721,1190,491,680,469,189,0.99315363
79,2,car,721,1190,491,680,469,189,0.9950945
80,2,car,719,1191,490,681,472,191,0.99357724
81,2,car,723,1191,491,680,468,189,0.99360245
82,2,car,721,1190,491,680,469,189,0.99408567
83,2,car,722,1191,490,680,469,190,0.99388546
84,2,car,719,1189,490,681,470,191,0.9933415
85,2,car,721,1189,490,681,468,191,0.99309224
86,2,car,720,1189,490,680,469,190,0.9933535
87,2,car,721,1189,490,680,468,190,0.99278355
88,2,car,722,1191,491,679,469,188,0.99334544
89,2,car,721,1189,491,679,468,188,0.9922223
90,2,car,721,1192,491,679,471,188,0.99353355
91,2,car,721,1190,491,680,469,189,0.9941834
92,2,car,721,1192,490,680,471,190,0.9927697
93,2,car,723,1187,491,680,464,189,0.9929273
94,2,car,720,1192,491,680,472,189,0.9943153
95,2,car,721,1190,490,680,469,190,0.9937749
96,2,car,721,1189,491,680,468,189,0.9938193
97,2,car,721,1193,490,681,472,191,0.9946054
98,2,car,721,1190,490,681,469,191,0.99308574
99,2,car,721,1191,490,680,470,190,0.99485815
100,2,car,719,1191,490,680,472,190,0.99378115
101,2,car,719,1192,490,681,473,191,0.994926
102,2,car,722,1192,490,680,470,190,0.9945114
103,2,car,722,1190,490,680,468,190,0.99356544
104,2,car,718,1192,490,680,474,190,0.99396724
105,2,car,720,1192,491,680,472,189,0.99402833
106,2,car,720,1188,490,681,468,191,0.9936452
107,2,car,722,1188,490,681,466,191,0.9941867
108,2,car,722,1189,490,681,467,191,0.99316216
109,2,car,721,1191,490,681,470,191,0.9934978
110,2,car,722,1192,491,679,470,188,0.9947086
111,2,car,719,1191,490,680,472,190,0.99448395
112,2,car,721,1190,490,681,469,191,0.9950352
113,2,car,718,1192,491,680,474,189,0.9946807
114,2,car,720,1190,491,680,470,189,0.9939705
115,2,car,721,1189,490,680,468,190,0.99420947
116,2,car,721,1188,491,679,467,188,0.9941135
117,2,car,720,1190,491,680,470,189,0.99439865
118,2,car,721,1190,490,680,469,190,0.9935835
119,2,car,720,1190,490,680,470,190,0.99316007
120,2,car,720,1190,490,680,470,190,0.99366015
121,2,car,723,1188,491,680,465,189,0.9940172
122,2,car,723,1190,491,680,467,189,0.9925984
123,2,car,720,1189,491,679,469,188,0.99389535
124,2,car,720,1192,491,680,472,189,0.9947525
125,2,car,720,1189,490,681,469,191,0.99338204
126,2,car,723,1190,490,680,467,190,0.993658
127,2,car,722,1191,490,681,469,191,0.9944046
128,2,car,723,1189,491,680,466,189,0.9941147
129,2,car,592,912,482,651,320,169,0.9904916
130,2,car,593,912,482,651,319,169,0.99101853
131,2,car,591,911,482,650,320,168,0.99045604
0,2,car,718,1190,490,680,472,190,0.9926309
1,2,car,719,1189,491,680,470,189,0.9926875
2,2,car,721,1188,490,680,467,190,0.9927945
3,2,car,721,1191,490,680,470,190,0.99220794
4,2,car,722,1189,491,680,467,189,0.9922194
5,2,car,719,1189,491,680,470,189,0.9919515
6,2,car,722,1186,491,680,464,189,0.993539
7,2,car,720,1191,491,680,471,189,0.99219567
8,2,car,721,1189,490,680,468,190,0.99354804
9,2,car,721,1190,490,681,469,191,0.9938494
10,2,car,720,1191,490,680,471,190,0.99199617
11,2,car,720,1190,490,680,470,190,0.9928888
12,2,car,722,1190,490,681,468,191,0.9930944
13,2,car,720,1188,490,680,468,190,0.99226046
14,2,car,723,1189,490,681,466,191,0.9939765
15,2,car,720,1190,491,680,470,189,0.9924298
16,2,car,721,1189,492,679,468,187,0.99207807
17,2,car,721,1187,491,679,466,188,0.99360836
18,2,car,722,1192,490,680,470,190,0.99354243
19,2,car,721,1189,490,681,468,191,0.9929695
20,2,car,720,1191,490,680,471,190,0.9934036
21,2,car,721,1190,491,680,469,189,0.9937746
22,2,car,720,1190,491,679,470,188,0.99336284
23,2,car,718,1190,490,680,472,190,0.99366164
24,2,car,724,1188,491,679,464,188,0.99361384
25,2,car,718,1190,490,680,472,190,0.9941106
26,2,car,720,1192,490,681,472,191,0.9934201
27,2,car,721,1192,491,679,471,188,0.99110234
28,2,car,721,1189,489,681,468,192,0.9942035
29,2,car,720,1192,490,680,472,190,0.9943143
30,2,car,720,1189,491,680,469,189,0.99289626
31,2,car,720,1188,490,681,468,191,0.9936275
32,2,car,721,1188,490,680,467,190,0.99227583
33,2,car,723,1189,490,680,466,190,0.9946215
34,2,car,719,1191,491,679,472,188,0.99300593
35,2,car,718,1191,490,681,473,191,0.9933079
36,2,car,720,1188,490,680,468,190,0.99254847
37,2,car,722,1189,491,679,467,188,0.99210006
38,2,car,720,1188,491,680,468,189,0.9942964
39,2,car,722,1189,490,680,467,190,0.9929243
40,2,car,722,1189,490,680,467,190,0.99385345
41,2,car,722,1190,490,681,468,191,0.9937917
42,2,car,721,1188,491,679,467,188,0.9926908
43,2,car,721,1190,490,681,469,191,0.9932829
44,2,car,721,1190,491,680,469,189,0.9928404
45,2,car,721,1191,491,680,470,189,0.9943646
46,2,car,723,1189,491,680,466,189,0.9942534
47,2,car,720,1191,490,681,471,191,0.9926691
48,2,car,721,1191,491,680,470,189,0.9923738
49,2,car,721,1187,492,679,466,187,0.99343777
50,2,car,721,1190,491,680,469,189,0.9931046
51,2,car,722,1188,492,679,466,187,0.9910961
52,2,car,721,1192,491,680,471,189,0.9921725
53,2,car,723,1190,490,680,467,190,0.9929821
54,2,car,723,1190,492,679,467,187,0.99407345
55,2,car,721,1189,490,680,468,190,0.99229693
56,2,car,720,1190,490,681,470,191,0.9942689
57,2,car,722,1190,491,680,468,189,0.9946975
58,2,car,722,1189,492,679,467,187,0.9933555
59,2,car,719,1191,491,680,472,189,0.99077785
60,2,car,720,1189,492,678,469,186,0.99275035
61,2,car,719,1192,491,680,473,189,0.99213934
62,2,car,724,1188,491,679,464,188,0.9937347
63,2,car,721,1191,490,680,470,190,0.9937846
64,2,car,724,1189,489,681,465,192,0.99227536
65,2,car,721,1191,490,681,470,191,0.99170077
66,2,car,722,1189,492,678,467,186,0.99312747
67,2,car,722,1189,490,680,467,190,0.9928037
68,2,car,722,1191,491,680,469,189,0.9921203
69,2,car,722,1189,490,681,467,191,0.9922209
70,2,car,721,1192,490,681,471,191,0.9930029
71,2,car,721,1191,491,680,470,189,0.99370116
72,2,car,721,1192,491,679,471,188,0.99167436
73,2,car,720,1191,489,681,471,192,0.99269456
74,2,car,721,1190,491,680,469,189,0.993381
75,2,car,718,1190,490,681,472,191,0.99364763
76,2,car,722,1193,490,680,471,190,0.99402285
77,2,car,719,1192,490,680,473,190,0.99388003
78,2,car,723,1192,490,680,469,190,0.992976
79,2,car,721,1190,491,680,469,189,0.99315363
80,2,car,721,1190,491,680,469,189,0.9950945
81,2,car,719,1191,490,681,472,191,0.99357724
82,2,car,723,1191,491,680,468,189,0.99360245
83,2,car,721,1190,491,680,469,189,0.99408567
84,2,car,722,1191,490,680,469,190,0.99388546
85,2,car,719,1189,490,681,470,191,0.9933415
86,2,car,721,1189,490,681,468,191,0.99309224
87,2,car,720,1189,490,680,469,190,0.9933535
88,2,car,721,1189,490,680,468,190,0.99278355
89,2,car,722,1191,491,679,469,188,0.99334544
90,2,car,721,1189,491,679,468,188,0.9922223
91,2,car,721,1192,491,679,471,188,0.99353355
92,2,car,721,1190,491,680,469,189,0.9941834
93,2,car,721,1192,490,680,471,190,0.9927697
94,2,car,723,1187,491,680,464,189,0.9929273
95,2,car,720,1192,491,680,472,189,0.9943153
96,2,car,721,1190,490,680,469,190,0.9937749
97,2,car,721,1189,491,680,468,189,0.9938193
98,2,car,721,1193,490,681,472,191,0.9946054
99,2,car,721,1190,490,681,469,191,0.99308574
100,2,car,721,1191,490,680,470,190,0.99485815
101,2,car,719,1191,490,680,472,190,0.99378115
102,2,car,719,1192,490,681,473,191,0.994926
103,2,car,722,1192,490,680,470,190,0.9945114
104,2,car,722,1190,490,680,468,190,0.99356544
105,2,car,718,1192,490,680,474,190,0.99396724
106,2,car,720,1192,491,680,472,189,0.99402833
107,2,car,720,1188,490,681,468,191,0.9936452
108,2,car,722,1188,490,681,466,191,0.9941867
109,2,car,722,1189,490,681,467,191,0.99316216
110,2,car,721,1191,490,681,470,191,0.9934978
111,2,car,722,1192,491,679,470,188,0.9947086
112,2,car,719,1191,490,680,472,190,0.99448395
113,2,car,721,1190,490,681,469,191,0.9950352
114,2,car,718,1192,491,680,474,189,0.9946807
115,2,car,720,1190,491,680,470,189,0.9939705
116,2,car,721,1189,490,680,468,190,0.99420947
117,2,car,721,1188,491,679,467,188,0.9941135
118,2,car,720,1190,491,680,470,189,0.99439865
119,2,car,721,1190,490,680,469,190,0.9935835
120,2,car,720,1190,490,680,470,190,0.99316007
121,2,car,720,1190,490,680,470,190,0.99366015
122,2,car,723,1188,491,680,465,189,0.9940172
123,2,car,723,1190,491,680,467,189,0.9925984
124,2,car,720,1189,491,679,469,188,0.99389535
125,2,car,720,1192,491,680,472,189,0.9947525
126,2,car,720,1189,490,681,469,191,0.99338204
127,2,car,723,1190,490,680,467,190,0.993658
128,2,car,722,1191,490,681,469,191,0.9944046
129,2,car,723,1189,491,680,466,189,0.9941147
130,2,car,592,912,482,651,320,169,0.9904916
131,2,car,593,912,482,651,319,169,0.99101853
132,2,car,591,911,482,650,320,168,0.99045604
