,cid,label,vehicle,left,right,top,bottom,width,height,score,distance_estimate,angle_estimate,real_distance,ratio,elapsed_time
0,2,car,van,341,720,440,705,379,265,0.9988129,[[10.62404092]],[[-84.00437658]],3,0.6992084432717678,
0,2,car,van,331,725,449,722,394,273,0.99893653,[[7.6388042]],[[-83.16424404]],3,0.6928934010152284,
1,2,car,van,341,720,440,705,379,265,0.9988129,[[10.62404092]],[[-84.00437658]],3,0.6992084432717678,
0,2,car,van,334,728,450,721,394,271,0.99925107,[[8.08523286]],[[-84.27413386]],3,0.6878172588832487,
1,2,car,van,331,725,449,722,394,273,0.99893653,[[7.6388042]],[[-83.16424404]],3,0.6928934010152284,
2,2,car,van,341,720,440,705,379,265,0.9988129,[[10.62404092]],[[-84.00437658]],3,0.6992084432717678,
0,2,car,van,356,718,441,696,362,255,0.9822874,[[12.80532617]],[[-84.88734094]],3,0.7044198895027625,
1,2,car,van,334,728,450,721,394,271,0.99925107,[[8.08523286]],[[-84.27413386]],3,0.6878172588832487,
2,2,car,van,331,725,449,722,394,273,0.99893653,[[7.6388042]],[[-83.16424404]],3,0.6928934010152284,
3,2,car,van,341,720,440,705,379,265,0.9988129,[[10.62404092]],[[-84.00437658]],3,0.6992084432717678,
0,2,car,van,352,721,444,697,369,253,0.9763852,[[13.1724195]],[[-88.03748403]],3,0.6856368563685636,
1,2,car,van,356,718,441,696,362,255,0.9822874,[[12.80532617]],[[-84.88734094]],3,0.7044198895027625,
2,2,car,van,334,728,450,721,394,271,0.99925107,[[8.08523286]],[[-84.27413386]],3,0.6878172588832487,
3,2,car,van,331,725,449,722,394,273,0.99893653,[[7.6388042]],[[-83.16424404]],3,0.6928934010152284,
4,2,car,van,341,720,440,705,379,265,0.9988129,[[10.62404092]],[[-84.00437658]],3,0.6992084432717678,
0,2,car,van,357,718,443,695,361,252,0.98117363,[[13.29299264]],[[-86.27341276]],3,0.6980609418282548,
1,2,car,van,352,721,444,697,369,253,0.9763852,[[13.1724195]],[[-88.03748403]],3,0.6856368563685636,
2,2,car,van,356,718,441,696,362,255,0.9822874,[[12.80532617]],[[-84.88734094]],3,0.7044198895027625,
3,2,car,van,334,728,450,721,394,271,0.99925107,[[8.08523286]],[[-84.27413386]],3,0.6878172588832487,
4,2,car,van,331,725,449,722,394,273,0.99893653,[[7.6388042]],[[-83.16424404]],3,0.6928934010152284,
5,2,car,van,341,720,440,705,379,265,0.9988129,[[10.62404092]],[[-84.00437658]],3,0.6992084432717678,
0,2,car,van,356,717,445,700,361,255,0.98048055,[[12.79547224]],[[-84.59101244]],3,0.7063711911357341,
1,2,car,van,357,718,443,695,361,252,0.98117363,[[13.29299264]],[[-86.27341276]],3,0.6980609418282548,
2,2,car,van,352,721,444,697,369,253,0.9763852,[[13.1724195]],[[-88.03748403]],3,0.6856368563685636,
3,2,car,van,356,718,441,696,362,255,0.9822874,[[12.80532617]],[[-84.88734094]],3,0.7044198895027625,
4,2,car,van,334,728,450,721,394,271,0.99925107,[[8.08523286]],[[-84.27413386]],3,0.6878172588832487,
5,2,car,van,331,725,449,722,394,273,0.99893653,[[7.6388042]],[[-83.16424404]],3,0.6928934010152284,
6,2,car,van,341,720,440,705,379,265,0.9988129,[[10.62404092]],[[-84.00437658]],3,0.6992084432717678,
0,2,car,van,356,719,444,695,363,251,0.9872646,[[13.49161823]],[[-87.43249881]],3,0.6914600550964187,
1,2,car,van,356,717,445,700,361,255,0.98048055,[[12.79547224]],[[-84.59101244]],3,0.7063711911357341,
2,2,car,van,357,718,443,695,361,252,0.98117363,[[13.29299264]],[[-86.27341276]],3,0.6980609418282548,
3,2,car,van,352,721,444,697,369,253,0.9763852,[[13.1724195]],[[-88.03748403]],3,0.6856368563685636,
4,2,car,van,356,718,441,696,362,255,0.9822874,[[12.80532617]],[[-84.88734094]],3,0.7044198895027625,
5,2,car,van,334,728,450,721,394,271,0.99925107,[[8.08523286]],[[-84.27413386]],3,0.6878172588832487,
6,2,car,van,331,725,449,722,394,273,0.99893653,[[7.6388042]],[[-83.16424404]],3,0.6928934010152284,
7,2,car,van,341,720,440,705,379,265,0.9988129,[[10.62404092]],[[-84.00437658]],3,0.6992084432717678,
0,2,car,van,355,718,442,697,363,255,0.9835155,[[12.81299323]],[[-85.18174273]],3,0.7024793388429752,
1,2,car,van,356,719,444,695,363,251,0.9872646,[[13.49161823]],[[-87.43249881]],3,0.6914600550964187,
2,2,car,van,356,717,445,700,361,255,0.98048055,[[12.79547224]],[[-84.59101244]],3,0.7063711911357341,
3,2,car,van,357,718,443,695,361,252,0.98117363,[[13.29299264]],[[-86.27341276]],3,0.6980609418282548,
4,2,car,van,352,721,444,697,369,253,0.9763852,[[13.1724195]],[[-88.03748403]],3,0.6856368563685636,
5,2,car,van,356,718,441,696,362,255,0.9822874,[[12.80532617]],[[-84.88734094]],3,0.7044198895027625,
6,2,car,van,334,728,450,721,394,271,0.99925107,[[8.08523286]],[[-84.27413386]],3,0.6878172588832487,
7,2,car,van,331,725,449,722,394,273,0.99893653,[[7.6388042]],[[-83.16424404]],3,0.6928934010152284,
8,2,car,van,341,720,440,705,379,265,0.9988129,[[10.62404092]],[[-84.00437658]],3,0.6992084432717678,
0,2,car,van,349,720,444,698,371,254,0.9789437,[[12.97550655]],[[-88.03299612]],3,0.6846361185983828,
1,2,car,van,355,718,442,697,363,255,0.9835155,[[12.81299323]],[[-85.18174273]],3,0.7024793388429752,
2,2,car,van,356,719,444,695,363,251,0.9872646,[[13.49161823]],[[-87.43249881]],3,0.6914600550964187,
3,2,car,van,356,717,445,700,361,255,0.98048055,[[12.79547224]],[[-84.59101244]],3,0.7063711911357341,
4,2,car,van,357,718,443,695,361,252,0.98117363,[[13.29299264]],[[-86.27341276]],3,0.6980609418282548,
5,2,car,van,352,721,444,697,369,253,0.9763852,[[13.1724195]],[[-88.03748403]],3,0.6856368563685636,
6,2,car,van,356,718,441,696,362,255,0.9822874,[[12.80532617]],[[-84.88734094]],3,0.7044198895027625,
7,2,car,van,334,728,450,721,394,271,0.99925107,[[8.08523286]],[[-84.27413386]],3,0.6878172588832487,
8,2,car,van,331,725,449,722,394,273,0.99893653,[[7.6388042]],[[-83.16424404]],3,0.6928934010152284,
9,2,car,van,341,720,440,705,379,265,0.9988129,[[10.62404092]],[[-84.00437658]],3,0.6992084432717678,
0,2,car,van,354,717,444,692,363,248,0.97865987,[[14.0033309]],[[-89.13509799]],3,0.6831955922865014,
1,2,car,van,349,720,444,698,371,254,0.9789437,[[12.97550655]],[[-88.03299612]],3,0.6846361185983828,
2,2,car,van,355,718,442,697,363,255,0.9835155,[[12.81299323]],[[-85.18174273]],3,0.7024793388429752,
3,2,car,van,356,719,444,695,363,251,0.9872646,[[13.49161823]],[[-87.43249881]],3,0.6914600550964187,
4,2,car,van,356,717,445,700,361,255,0.98048055,[[12.79547224]],[[-84.59101244]],3,0.7063711911357341,
5,2,car,van,357,718,443,695,361,252,0.98117363,[[13.29299264]],[[-86.27341276]],3,0.6980609418282548,
6,2,car,van,352,721,444,697,369,253,0.9763852,[[13.1724195]],[[-88.03748403]],3,0.6856368563685636,
7,2,car,van,356,718,441,696,362,255,0.9822874,[[12.80532617]],[[-84.88734094]],3,0.7044198895027625,
8,2,car,van,334,728,450,721,394,271,0.99925107,[[8.08523286]],[[-84.27413386]],3,0.6878172588832487,
9,2,car,van,331,725,449,722,394,273,0.99893653,[[7.6388042]],[[-83.16424404]],3,0.6928934010152284,
10,2,car,van,341,720,440,705,379,265,0.9988129,[[10.62404092]],[[-84.00437658]],3,0.6992084432717678,
0,2,car,van,350,720,444,699,370,255,0.97152954,[[12.80223224]],[[-87.18860737]],3,0.6891891891891891,
1,2,car,van,354,717,444,692,363,248,0.97865987,[[14.0033309]],[[-89.13509799]],3,0.6831955922865014,
2,2,car,van,349,720,444,698,371,254,0.9789437,[[12.97550655]],[[-88.03299612]],3,0.6846361185983828,
3,2,car,van,355,718,442,697,363,255,0.9835155,[[12.81299323]],[[-85.18174273]],3,0.7024793388429752,
4,2,car,van,356,719,444,695,363,251,0.9872646,[[13.49161823]],[[-87.43249881]],3,0.6914600550964187,
5,2,car,van,356,717,445,700,361,255,0.98048055,[[12.79547224]],[[-84.59101244]],3,0.7063711911357341,
6,2,car,van,357,718,443,695,361,252,0.98117363,[[13.29299264]],[[-86.27341276]],3,0.6980609418282548,
7,2,car,van,352,721,444,697,369,253,0.9763852,[[13.1724195]],[[-88.03748403]],3,0.6856368563685636,
8,2,car,van,356,718,441,696,362,255,0.9822874,[[12.80532617]],[[-84.88734094]],3,0.7044198895027625,
9,2,car,van,334,728,450,721,394,271,0.99925107,[[8.08523286]],[[-84.27413386]],3,0.6878172588832487,
10,2,car,van,331,725,449,722,394,273,0.99893653,[[7.6388042]],[[-83.16424404]],3,0.6928934010152284,
11,2,car,van,341,720,440,705,379,265,0.9988129,[[10.62404092]],[[-84.00437658]],3,0.6992084432717678,
0,2,car,van,354,720,442,696,366,254,0.9823021,[[12.99732295]],[[-86.6157962]],3,0.6939890710382514,
1,2,car,van,350,720,444,699,370,255,0.97152954,[[12.80223224]],[[-87.18860737]],3,0.6891891891891891,
2,2,car,van,354,717,444,692,363,248,0.97865987,[[14.0033309]],[[-89.13509799]],3,0.6831955922865014,
3,2,car,van,349,720,444,698,371,254,0.9789437,[[12.97550655]],[[-88.03299612]],3,0.6846361185983828,
4,2,car,van,355,718,442,697,363,255,0.9835155,[[12.81299323]],[[-85.18174273]],3,0.7024793388429752,
5,2,car,van,356,719,444,695,363,251,0.9872646,[[13.49161823]],[[-87.43249881]],3,0.6914600550964187,
6,2,car,van,356,717,445,700,361,255,0.98048055,[[12.79547224]],[[-84.59101244]],3,0.7063711911357341,
7,2,car,van,357,718,443,695,361,252,0.98117363,[[13.29299264]],[[-86.27341276]],3,0.6980609418282548,
8,2,car,van,352,721,444,697,369,253,0.9763852,[[13.1724195]],[[-88.03748403]],3,0.6856368563685636,
9,2,car,van,356,718,441,696,362,255,0.9822874,[[12.80532617]],[[-84.88734094]],3,0.7044198895027625,
10,2,car,van,334,728,450,721,394,271,0.99925107,[[8.08523286]],[[-84.27413386]],3,0.6878172588832487,
11,2,car,van,331,725,449,722,394,273,0.99893653,[[7.6388042]],[[-83.16424404]],3,0.6928934010152284,
12,2,car,van,341,720,440,705,379,265,0.9988129,[[10.62404092]],[[-84.00437658]],3,0.6992084432717678,
0,2,car,van,350,719,446,695,369,249,0.9818381,[[13.89903545]],[[-90.31367511]],3,0.6747967479674797,
1,2,car,van,354,720,442,696,366,254,0.9823021,[[12.99732295]],[[-86.6157962]],3,0.6939890710382514,
2,2,car,van,350,720,444,699,370,255,0.97152954,[[12.80223224]],[[-87.18860737]],3,0.6891891891891891,
3,2,car,van,354,717,444,692,363,248,0.97865987,[[14.0033309]],[[-89.13509799]],3,0.6831955922865014,
4,2,car,van,349,720,444,698,371,254,0.9789437,[[12.97550655]],[[-88.03299612]],3,0.6846361185983828,
5,2,car,van,355,718,442,697,363,255,0.9835155,[[12.81299323]],[[-85.18174273]],3,0.7024793388429752,
6,2,car,van,356,719,444,695,363,251,0.9872646,[[13.49161823]],[[-87.43249881]],3,0.6914600550964187,
7,2,car,van,356,717,445,700,361,255,0.98048055,[[12.79547224]],[[-84.59101244]],3,0.7063711911357341,
8,2,car,van,357,718,443,695,361,252,0.98117363,[[13.29299264]],[[-86.27341276]],3,0.6980609418282548,
9,2,car,van,352,721,444,697,369,253,0.9763852,[[13.1724195]],[[-88.03748403]],3,0.6856368563685636,
10,2,car,van,356,718,441,696,362,255,0.9822874,[[12.80532617]],[[-84.88734094]],3,0.7044198895027625,
11,2,car,van,334,728,450,721,394,271,0.99925107,[[8.08523286]],[[-84.27413386]],3,0.6878172588832487,
12,2,car,van,331,725,449,722,394,273,0.99893653,[[7.6388042]],[[-83.16424404]],3,0.6928934010152284,
13,2,car,van,341,720,440,705,379,265,0.9988129,[[10.62404092]],[[-84.00437658]],3,0.6992084432717678,
0,2,car,van,354,720,443,693,366,250,0.98107594,[[13.69964617]],[[-88.87926979]],3,0.6830601092896175,
1,2,car,van,350,719,446,695,369,249,0.9818381,[[13.89903545]],[[-90.31367511]],3,0.6747967479674797,
2,2,car,van,354,720,442,696,366,254,0.9823021,[[12.99732295]],[[-86.6157962]],3,0.6939890710382514,
3,2,car,van,350,720,444,699,370,255,0.97152954,[[12.80223224]],[[-87.18860737]],3,0.6891891891891891,
4,2,car,van,354,717,444,692,363,248,0.97865987,[[14.0033309]],[[-89.13509799]],3,0.6831955922865014,
5,2,car,van,349,720,444,698,371,254,0.9789437,[[12.97550655]],[[-88.03299612]],3,0.6846361185983828,
6,2,car,van,355,718,442,697,363,255,0.9835155,[[12.81299323]],[[-85.18174273]],3,0.7024793388429752,
7,2,car,van,356,719,444,695,363,251,0.9872646,[[13.49161823]],[[-87.43249881]],3,0.6914600550964187,
8,2,car,van,356,717,445,700,361,255,0.98048055,[[12.79547224]],[[-84.59101244]],3,0.7063711911357341,
9,2,car,van,357,718,443,695,361,252,0.98117363,[[13.29299264]],[[-86.27341276]],3,0.6980609418282548,
10,2,car,van,352,721,444,697,369,253,0.9763852,[[13.1724195]],[[-88.03748403]],3,0.6856368563685636,
11,2,car,van,356,718,441,696,362,255,0.9822874,[[12.80532617]],[[-84.88734094]],3,0.7044198895027625,
12,2,car,van,334,728,450,721,394,271,0.99925107,[[8.08523286]],[[-84.27413386]],3,0.6878172588832487,
13,2,car,van,331,725,449,722,394,273,0.99893653,[[7.6388042]],[[-83.16424404]],3,0.6928934010152284,
14,2,car,van,341,720,440,705,379,265,0.9988129,[[10.62404092]],[[-84.00437658]],3,0.6992084432717678,
0,2,car,van,354,720,443,697,366,254,0.9826344,[[12.99732295]],[[-86.6157962]],3,0.6939890710382514,
1,2,car,van,354,720,443,693,366,250,0.98107594,[[13.69964617]],[[-88.87926979]],3,0.6830601092896175,
2,2,car,van,350,719,446,695,369,249,0.9818381,[[13.89903545]],[[-90.31367511]],3,0.6747967479674797,
3,2,car,van,354,720,442,696,366,254,0.9823021,[[12.99732295]],[[-86.6157962]],3,0.6939890710382514,
4,2,car,van,350,720,444,699,370,255,0.97152954,[[12.80223224]],[[-87.18860737]],3,0.6891891891891891,
5,2,car,van,354,717,444,692,363,248,0.97865987,[[14.0033309]],[[-89.13509799]],3,0.6831955922865014,
6,2,car,van,349,720,444,698,371,254,0.9789437,[[12.97550655]],[[-88.03299612]],3,0.6846361185983828,
7,2,car,van,355,718,442,697,363,255,0.9835155,[[12.81299323]],[[-85.18174273]],3,0.7024793388429752,
8,2,car,van,356,719,444,695,363,251,0.9872646,[[13.49161823]],[[-87.43249881]],3,0.6914600550964187,
9,2,car,van,356,717,445,700,361,255,0.98048055,[[12.79547224]],[[-84.59101244]],3,0.7063711911357341,
10,2,car,van,357,718,443,695,361,252,0.98117363,[[13.29299264]],[[-86.27341276]],3,0.6980609418282548,
11,2,car,van,352,721,444,697,369,253,0.9763852,[[13.1724195]],[[-88.03748403]],3,0.6856368563685636,
12,2,car,van,356,718,441,696,362,255,0.9822874,[[12.80532617]],[[-84.88734094]],3,0.7044198895027625,
13,2,car,van,334,728,450,721,394,271,0.99925107,[[8.08523286]],[[-84.27413386]],3,0.6878172588832487,
14,2,car,van,331,725,449,722,394,273,0.99893653,[[7.6388042]],[[-83.16424404]],3,0.6928934010152284,
15,2,car,van,341,720,440,705,379,265,0.9988129,[[10.62404092]],[[-84.00437658]],3,0.6992084432717678,
0,2,car,van,355,718,445,696,363,251,0.9827555,[[13.49161823]],[[-87.43249881]],3,0.6914600550964187,
1,2,car,van,354,720,443,697,366,254,0.9826344,[[12.99732295]],[[-86.6157962]],3,0.6939890710382514,
2,2,car,van,354,720,443,693,366,250,0.98107594,[[13.69964617]],[[-88.87926979]],3,0.6830601092896175,
3,2,car,van,350,719,446,695,369,249,0.9818381,[[13.89903545]],[[-90.31367511]],3,0.6747967479674797,
4,2,car,van,354,720,442,696,366,254,0.9823021,[[12.99732295]],[[-86.6157962]],3,0.6939890710382514,
5,2,car,van,350,720,444,699,370,255,0.97152954,[[12.80223224]],[[-87.18860737]],3,0.6891891891891891,
6,2,car,van,354,717,444,692,363,248,0.97865987,[[14.0033309]],[[-89.13509799]],3,0.6831955922865014,
7,2,car,van,349,720,444,698,371,254,0.9789437,[[12.97550655]],[[-88.03299612]],3,0.6846361185983828,
8,2,car,van,355,718,442,697,363,255,0.9835155,[[12.81299323]],[[-85.18174273]],3,0.7024793388429752,
9,2,car,van,356,719,444,695,363,251,0.9872646,[[13.49161823]],[[-87.43249881]],3,0.6914600550964187,
10,2,car,van,356,717,445,700,361,255,0.98048055,[[12.79547224]],[[-84.59101244]],3,0.7063711911357341,
11,2,car,van,357,718,443,695,361,252,0.98117363,[[13.29299264]],[[-86.27341276]],3,0.6980609418282548,
12,2,car,van,352,721,444,697,369,253,0.9763852,[[13.1724195]],[[-88.03748403]],3,0.6856368563685636,
13,2,car,van,356,718,441,696,362,255,0.9822874,[[12.80532617]],[[-84.88734094]],3,0.7044198895027625,
14,2,car,van,334,728,450,721,394,271,0.99925107,[[8.08523286]],[[-84.27413386]],3,0.6878172588832487,
15,2,car,van,331,725,449,722,394,273,0.99893653,[[7.6388042]],[[-83.16424404]],3,0.6928934010152284,
16,2,car,van,341,720,440,705,379,265,0.9988129,[[10.62404092]],[[-84.00437658]],3,0.6992084432717678,
0,2,car,van,357,716,446,697,359,251,0.9763643,[[13.41877532]],[[-86.23375612]],3,0.6991643454038997,
1,2,car,van,355,718,445,696,363,251,0.9827555,[[13.49161823]],[[-87.43249881]],3,0.6914600550964187,
2,2,car,van,354,720,443,697,366,254,0.9826344,[[12.99732295]],[[-86.6157962]],3,0.6939890710382514,
3,2,car,van,354,720,443,693,366,250,0.98107594,[[13.69964617]],[[-88.87926979]],3,0.6830601092896175,
4,2,car,van,350,719,446,695,369,249,0.9818381,[[13.89903545]],[[-90.31367511]],3,0.6747967479674797,
5,2,car,van,354,720,442,696,366,254,0.9823021,[[12.99732295]],[[-86.6157962]],3,0.6939890710382514,
6,2,car,van,350,720,444,699,370,255,0.97152954,[[12.80223224]],[[-87.18860737]],3,0.6891891891891891,
7,2,car,van,354,717,444,692,363,248,0.97865987,[[14.0033309]],[[-89.13509799]],3,0.6831955922865014,
8,2,car,van,349,720,444,698,371,254,0.9789437,[[12.97550655]],[[-88.03299612]],3,0.6846361185983828,
9,2,car,van,355,718,442,697,363,255,0.9835155,[[12.81299323]],[[-85.18174273]],3,0.7024793388429752,
10,2,car,van,356,719,444,695,363,251,0.9872646,[[13.49161823]],[[-87.43249881]],3,0.6914600550964187,
11,2,car,van,356,717,445,700,361,255,0.98048055,[[12.79547224]],[[-84.59101244]],3,0.7063711911357341,
12,2,car,van,357,718,443,695,361,252,0.98117363,[[13.29299264]],[[-86.27341276]],3,0.6980609418282548,
13,2,car,van,352,721,444,697,369,253,0.9763852,[[13.1724195]],[[-88.03748403]],3,0.6856368563685636,
14,2,car,van,356,718,441,696,362,255,0.9822874,[[12.80532617]],[[-84.88734094]],3,0.7044198895027625,
15,2,car,van,334,728,450,721,394,271,0.99925107,[[8.08523286]],[[-84.27413386]],3,0.6878172588832487,
16,2,car,van,331,725,449,722,394,273,0.99893653,[[7.6388042]],[[-83.16424404]],3,0.6928934010152284,
17,2,car,van,341,720,440,705,379,265,0.9988129,[[10.62404092]],[[-84.00437658]],3,0.6992084432717678,
0,2,car,van,352,719,444,695,367,251,0.98687744,[[13.52981284]],[[-88.60041414]],3,0.6839237057220708,
1,2,car,van,357,716,446,697,359,251,0.9763643,[[13.41877532]],[[-86.23375612]],3,0.6991643454038997,
2,2,car,van,355,718,445,696,363,251,0.9827555,[[13.49161823]],[[-87.43249881]],3,0.6914600550964187,
3,2,car,van,354,720,443,697,366,254,0.9826344,[[12.99732295]],[[-86.6157962]],3,0.6939890710382514,
4,2,car,van,354,720,443,693,366,250,0.98107594,[[13.69964617]],[[-88.87926979]],3,0.6830601092896175,
5,2,car,van,350,719,446,695,369,249,0.9818381,[[13.89903545]],[[-90.31367511]],3,0.6747967479674797,
6,2,car,van,354,720,442,696,366,254,0.9823021,[[12.99732295]],[[-86.6157962]],3,0.6939890710382514,
7,2,car,van,350,720,444,699,370,255,0.97152954,[[12.80223224]],[[-87.18860737]],3,0.6891891891891891,
8,2,car,van,354,717,444,692,363,248,0.97865987,[[14.0033309]],[[-89.13509799]],3,0.6831955922865014,
9,2,car,van,349,720,444,698,371,254,0.9789437,[[12.97550655]],[[-88.03299612]],3,0.6846361185983828,
10,2,car,van,355,718,442,697,363,255,0.9835155,[[12.81299323]],[[-85.18174273]],3,0.7024793388429752,
11,2,car,van,356,719,444,695,363,251,0.9872646,[[13.49161823]],[[-87.43249881]],3,0.6914600550964187,
12,2,car,van,356,717,445,700,361,255,0.98048055,[[12.79547224]],[[-84.59101244]],3,0.7063711911357341,
13,2,car,van,357,718,443,695,361,252,0.98117363,[[13.29299264]],[[-86.27341276]],3,0.6980609418282548,
14,2,car,van,352,721,444,697,369,253,0.9763852,[[13.1724195]],[[-88.03748403]],3,0.6856368563685636,
15,2,car,van,356,718,441,696,362,255,0.9822874,[[12.80532617]],[[-84.88734094]],3,0.7044198895027625,
16,2,car,van,334,728,450,721,394,271,0.99925107,[[8.08523286]],[[-84.27413386]],3,0.6878172588832487,
17,2,car,van,331,725,449,722,394,273,0.99893653,[[7.6388042]],[[-83.16424404]],3,0.6928934010152284,
18,2,car,van,341,720,440,705,379,265,0.9988129,[[10.62404092]],[[-84.00437658]],3,0.6992084432717678,
0,2,car,van,349,717,443,697,368,254,0.9859856,[[12.99583974]],[[-87.1884563]],3,0.6902173913043478,
1,2,car,van,352,719,444,695,367,251,0.98687744,[[13.52981284]],[[-88.60041414]],3,0.6839237057220708,
2,2,car,van,357,716,446,697,359,251,0.9763643,[[13.41877532]],[[-86.23375612]],3,0.6991643454038997,
3,2,car,van,355,718,445,696,363,251,0.9827555,[[13.49161823]],[[-87.43249881]],3,0.6914600550964187,
4,2,car,van,354,720,443,697,366,254,0.9826344,[[12.99732295]],[[-86.6157962]],3,0.6939890710382514,
5,2,car,van,354,720,443,693,366,250,0.98107594,[[13.69964617]],[[-88.87926979]],3,0.6830601092896175,
6,2,car,van,350,719,446,695,369,249,0.9818381,[[13.89903545]],[[-90.31367511]],3,0.6747967479674797,
7,2,car,van,354,720,442,696,366,254,0.9823021,[[12.99732295]],[[-86.6157962]],3,0.6939890710382514,
8,2,car,van,350,720,444,699,370,255,0.97152954,[[12.80223224]],[[-87.18860737]],3,0.6891891891891891,
9,2,car,van,354,717,444,692,363,248,0.97865987,[[14.0033309]],[[-89.13509799]],3,0.6831955922865014,
10,2,car,van,349,720,444,698,371,254,0.9789437,[[12.97550655]],[[-88.03299612]],3,0.6846361185983828,
11,2,car,van,355,718,442,697,363,255,0.9835155,[[12.81299323]],[[-85.18174273]],3,0.7024793388429752,
12,2,car,van,356,719,444,695,363,251,0.9872646,[[13.49161823]],[[-87.43249881]],3,0.6914600550964187,
13,2,car,van,356,717,445,700,361,255,0.98048055,[[12.79547224]],[[-84.59101244]],3,0.7063711911357341,
14,2,car,van,357,718,443,695,361,252,0.98117363,[[13.29299264]],[[-86.27341276]],3,0.6980609418282548,
15,2,car,van,352,721,444,697,369,253,0.9763852,[[13.1724195]],[[-88.03748403]],3,0.6856368563685636,
16,2,car,van,356,718,441,696,362,255,0.9822874,[[12.80532617]],[[-84.88734094]],3,0.7044198895027625,
17,2,car,van,334,728,450,721,394,271,0.99925107,[[8.08523286]],[[-84.27413386]],3,0.6878172588832487,
18,2,car,van,331,725,449,722,394,273,0.99893653,[[7.6388042]],[[-83.16424404]],3,0.6928934010152284,
19,2,car,van,341,720,440,705,379,265,0.9988129,[[10.62404092]],[[-84.00437658]],3,0.6992084432717678,
0,2,car,van,356,720,446,697,364,251,0.9813424,[[13.50450931]],[[-87.72736771]],3,0.6895604395604396,
1,2,car,van,349,717,443,697,368,254,0.9859856,[[12.99583974]],[[-87.1884563]],3,0.6902173913043478,
2,2,car,van,352,719,444,695,367,251,0.98687744,[[13.52981284]],[[-88.60041414]],3,0.6839237057220708,
3,2,car,van,357,716,446,697,359,251,0.9763643,[[13.41877532]],[[-86.23375612]],3,0.6991643454038997,
4,2,car,van,355,718,445,696,363,251,0.9827555,[[13.49161823]],[[-87.43249881]],3,0.6914600550964187,
5,2,car,van,354,720,443,697,366,254,0.9826344,[[12.99732295]],[[-86.6157962]],3,0.6939890710382514,
6,2,car,van,354,720,443,693,366,250,0.98107594,[[13.69964617]],[[-88.87926979]],3,0.6830601092896175,
7,2,car,van,350,719,446,695,369,249,0.9818381,[[13.89903545]],[[-90.31367511]],3,0.6747967479674797,
8,2,car,van,354,720,442,696,366,254,0.9823021,[[12.99732295]],[[-86.6157962]],3,0.6939890710382514,
9,2,car,van,350,720,444,699,370,255,0.97152954,[[12.80223224]],[[-87.18860737]],3,0.6891891891891891,
10,2,car,van,354,717,444,692,363,248,0.97865987,[[14.0033309]],[[-89.13509799]],3,0.6831955922865014,
11,2,car,van,349,720,444,698,371,254,0.9789437,[[12.97550655]],[[-88.03299612]],3,0.6846361185983828,
12,2,car,van,355,718,442,697,363,255,0.9835155,[[12.81299323]],[[-85.18174273]],3,0.7024793388429752,
13,2,car,van,356,719,444,695,363,251,0.9872646,[[13.49161823]],[[-87.43249881]],3,0.6914600550964187,
14,2,car,van,356,717,445,700,361,255,0.98048055,[[12.79547224]],[[-84.59101244]],3,0.7063711911357341,
15,2,car,van,357,718,443,695,361,252,0.98117363,[[13.29299264]],[[-86.27341276]],3,0.6980609418282548,
16,2,car,van,352,721,444,697,369,253,0.9763852,[[13.1724195]],[[-88.03748403]],3,0.6856368563685636,
17,2,car,van,356,718,441,696,362,255,0.9822874,[[12.80532617]],[[-84.88734094]],3,0.7044198895027625,
18,2,car,van,334,728,450,721,394,271,0.99925107,[[8.08523286]],[[-84.27413386]],3,0.6878172588832487,
19,2,car,van,331,725,449,722,394,273,0.99893653,[[7.6388042]],[[-83.16424404]],3,0.6928934010152284,
20,2,car,van,341,720,440,705,379,265,0.9988129,[[10.62404092]],[[-84.00437658]],3,0.6992084432717678,
0,2,car,van,355,718,444,696,363,252,0.986651,[[13.32153937]],[[-86.86773377]],3,0.6942148760330579,
1,2,car,van,356,720,446,697,364,251,0.9813424,[[13.50450931]],[[-87.72736771]],3,0.6895604395604396,
2,2,car,van,349,717,443,697,368,254,0.9859856,[[12.99583974]],[[-87.1884563]],3,0.6902173913043478,
3,2,car,van,352,719,444,695,367,251,0.98687744,[[13.52981284]],[[-88.60041414]],3,0.6839237057220708,
4,2,car,van,357,716,446,697,359,251,0.9763643,[[13.41877532]],[[-86.23375612]],3,0.6991643454038997,
5,2,car,van,355,718,445,696,363,251,0.9827555,[[13.49161823]],[[-87.43249881]],3,0.6914600550964187,
6,2,car,van,354,720,443,697,366,254,0.9826344,[[12.99732295]],[[-86.6157962]],3,0.6939890710382514,
7,2,car,van,354,720,443,693,366,250,0.98107594,[[13.69964617]],[[-88.87926979]],3,0.6830601092896175,
8,2,car,van,350,719,446,695,369,249,0.9818381,[[13.89903545]],[[-90.31367511]],3,0.6747967479674797,
9,2,car,van,354,720,442,696,366,254,0.9823021,[[12.99732295]],[[-86.6157962]],3,0.6939890710382514,
10,2,car,van,350,720,444,699,370,255,0.97152954,[[12.80223224]],[[-87.18860737]],3,0.6891891891891891,
11,2,car,van,354,717,444,692,363,248,0.97865987,[[14.0033309]],[[-89.13509799]],3,0.6831955922865014,
12,2,car,van,349,720,444,698,371,254,0.9789437,[[12.97550655]],[[-88.03299612]],3,0.6846361185983828,
13,2,car,van,355,718,442,697,363,255,0.9835155,[[12.81299323]],[[-85.18174273]],3,0.7024793388429752,
14,2,car,van,356,719,444,695,363,251,0.9872646,[[13.49161823]],[[-87.43249881]],3,0.6914600550964187,
15,2,car,van,356,717,445,700,361,255,0.98048055,[[12.79547224]],[[-84.59101244]],3,0.7063711911357341,
16,2,car,van,357,718,443,695,361,252,0.98117363,[[13.29299264]],[[-86.27341276]],3,0.6980609418282548,
17,2,car,van,352,721,444,697,369,253,0.9763852,[[13.1724195]],[[-88.03748403]],3,0.6856368563685636,
18,2,car,van,356,718,441,696,362,255,0.9822874,[[12.80532617]],[[-84.88734094]],3,0.7044198895027625,
19,2,car,van,334,728,450,721,394,271,0.99925107,[[8.08523286]],[[-84.27413386]],3,0.6878172588832487,
20,2,car,van,331,725,449,722,394,273,0.99893653,[[7.6388042]],[[-83.16424404]],3,0.6928934010152284,
21,2,car,van,341,720,440,705,379,265,0.9988129,[[10.62404092]],[[-84.00437658]],3,0.6992084432717678,
0,2,car,van,352,717,444,694,365,250,0.9881751,[[13.68929513]],[[-88.58765586]],3,0.684931506849315,
1,2,car,van,355,718,444,696,363,252,0.986651,[[13.32153937]],[[-86.86773377]],3,0.6942148760330579,
2,2,car,van,356,720,446,697,364,251,0.9813424,[[13.50450931]],[[-87.72736771]],3,0.6895604395604396,
3,2,car,van,349,717,443,697,368,254,0.9859856,[[12.99583974]],[[-87.1884563]],3,0.6902173913043478,
4,2,car,van,352,719,444,695,367,251,0.98687744,[[13.52981284]],[[-88.60041414]],3,0.6839237057220708,
5,2,car,van,357,716,446,697,359,251,0.9763643,[[13.41877532]],[[-86.23375612]],3,0.6991643454038997,
6,2,car,van,355,718,445,696,363,251,0.9827555,[[13.49161823]],[[-87.43249881]],3,0.6914600550964187,
7,2,car,van,354,720,443,697,366,254,0.9826344,[[12.99732295]],[[-86.6157962]],3,0.6939890710382514,
8,2,car,van,354,720,443,693,366,250,0.98107594,[[13.69964617]],[[-88.87926979]],3,0.6830601092896175,
9,2,car,van,350,719,446,695,369,249,0.9818381,[[13.89903545]],[[-90.31367511]],3,0.6747967479674797,
10,2,car,van,354,720,442,696,366,254,0.9823021,[[12.99732295]],[[-86.6157962]],3,0.6939890710382514,
11,2,car,van,350,720,444,699,370,255,0.97152954,[[12.80223224]],[[-87.18860737]],3,0.6891891891891891,
12,2,car,van,354,717,444,692,363,248,0.97865987,[[14.0033309]],[[-89.13509799]],3,0.6831955922865014,
13,2,car,van,349,720,444,698,371,254,0.9789437,[[12.97550655]],[[-88.03299612]],3,0.6846361185983828,
14,2,car,van,355,718,442,697,363,255,0.9835155,[[12.81299323]],[[-85.18174273]],3,0.7024793388429752,
15,2,car,van,356,719,444,695,363,251,0.9872646,[[13.49161823]],[[-87.43249881]],3,0.6914600550964187,
16,2,car,van,356,717,445,700,361,255,0.98048055,[[12.79547224]],[[-84.59101244]],3,0.7063711911357341,
17,2,car,van,357,718,443,695,361,252,0.98117363,[[13.29299264]],[[-86.27341276]],3,0.6980609418282548,
18,2,car,van,352,721,444,697,369,253,0.9763852,[[13.1724195]],[[-88.03748403]],3,0.6856368563685636,
19,2,car,van,356,718,441,696,362,255,0.9822874,[[12.80532617]],[[-84.88734094]],3,0.7044198895027625,
20,2,car,van,334,728,450,721,394,271,0.99925107,[[8.08523286]],[[-84.27413386]],3,0.6878172588832487,
21,2,car,van,331,725,449,722,394,273,0.99893653,[[7.6388042]],[[-83.16424404]],3,0.6928934010152284,
22,2,car,van,341,720,440,705,379,265,0.9988129,[[10.62404092]],[[-84.00437658]],3,0.6992084432717678,
0,2,car,van,357,720,445,694,363,249,0.9793669,[[13.83252945]],[[-88.56618092]],3,0.6859504132231405,
1,2,car,van,352,717,444,694,365,250,0.9881751,[[13.68929513]],[[-88.58765586]],3,0.684931506849315,
2,2,car,van,355,718,444,696,363,252,0.986651,[[13.32153937]],[[-86.86773377]],3,0.6942148760330579,
3,2,car,van,356,720,446,697,364,251,0.9813424,[[13.50450931]],[[-87.72736771]],3,0.6895604395604396,
4,2,car,van,349,717,443,697,368,254,0.9859856,[[12.99583974]],[[-87.1884563]],3,0.6902173913043478,
5,2,car,van,352,719,444,695,367,251,0.98687744,[[13.52981284]],[[-88.60041414]],3,0.6839237057220708,
6,2,car,van,357,716,446,697,359,251,0.9763643,[[13.41877532]],[[-86.23375612]],3,0.6991643454038997,
7,2,car,van,355,718,445,696,363,251,0.9827555,[[13.49161823]],[[-87.43249881]],3,0.6914600550964187,
8,2,car,van,354,720,443,697,366,254,0.9826344,[[12.99732295]],[[-86.6157962]],3,0.6939890710382514,
9,2,car,van,354,720,443,693,366,250,0.98107594,[[13.69964617]],[[-88.87926979]],3,0.6830601092896175,
10,2,car,van,350,719,446,695,369,249,0.9818381,[[13.89903545]],[[-90.31367511]],3,0.6747967479674797,
11,2,car,van,354,720,442,696,366,254,0.9823021,[[12.99732295]],[[-86.6157962]],3,0.6939890710382514,
12,2,car,van,350,720,444,699,370,255,0.97152954,[[12.80223224]],[[-87.18860737]],3,0.6891891891891891,
13,2,car,van,354,717,444,692,363,248,0.97865987,[[14.0033309]],[[-89.13509799]],3,0.6831955922865014,
14,2,car,van,349,720,444,698,371,254,0.9789437,[[12.97550655]],[[-88.03299612]],3,0.6846361185983828,
15,2,car,van,355,718,442,697,363,255,0.9835155,[[12.81299323]],[[-85.18174273]],3,0.7024793388429752,
16,2,car,van,356,719,444,695,363,251,0.9872646,[[13.49161823]],[[-87.43249881]],3,0.6914600550964187,
17,2,car,van,356,717,445,700,361,255,0.98048055,[[12.79547224]],[[-84.59101244]],3,0.7063711911357341,
18,2,car,van,357,718,443,695,361,252,0.98117363,[[13.29299264]],[[-86.27341276]],3,0.6980609418282548,
19,2,car,van,352,721,444,697,369,253,0.9763852,[[13.1724195]],[[-88.03748403]],3,0.6856368563685636,
20,2,car,van,356,718,441,696,362,255,0.9822874,[[12.80532617]],[[-84.88734094]],3,0.7044198895027625,
21,2,car,van,334,728,450,721,394,271,0.99925107,[[8.08523286]],[[-84.27413386]],3,0.6878172588832487,
22,2,car,van,331,725,449,722,394,273,0.99893653,[[7.6388042]],[[-83.16424404]],3,0.6928934010152284,
23,2,car,van,341,720,440,705,379,265,0.9988129,[[10.62404092]],[[-84.00437658]],3,0.6992084432717678,
0,2,car,van,359,716,444,693,357,249,0.97837234,[[13.68912907]],[[-86.74932516]],3,0.6974789915966386,
1,2,car,van,357,720,445,694,363,249,0.9793669,[[13.83252945]],[[-88.56618092]],3,0.6859504132231405,
2,2,car,van,352,717,444,694,365,250,0.9881751,[[13.68929513]],[[-88.58765586]],3,0.684931506849315,
3,2,car,van,355,718,444,696,363,252,0.986651,[[13.32153937]],[[-86.86773377]],3,0.6942148760330579,
4,2,car,van,356,720,446,697,364,251,0.9813424,[[13.50450931]],[[-87.72736771]],3,0.6895604395604396,
5,2,car,van,349,717,443,697,368,254,0.9859856,[[12.99583974]],[[-87.1884563]],3,0.6902173913043478,
6,2,car,van,352,719,444,695,367,251,0.98687744,[[13.52981284]],[[-88.60041414]],3,0.6839237057220708,
7,2,car,van,357,716,446,697,359,251,0.9763643,[[13.41877532]],[[-86.23375612]],3,0.6991643454038997,
8,2,car,van,355,718,445,696,363,251,0.9827555,[[13.49161823]],[[-87.43249881]],3,0.6914600550964187,
9,2,car,van,354,720,443,697,366,254,0.9826344,[[12.99732295]],[[-86.6157962]],3,0.6939890710382514,
10,2,car,van,354,720,443,693,366,250,0.98107594,[[13.69964617]],[[-88.87926979]],3,0.6830601092896175,
11,2,car,van,350,719,446,695,369,249,0.9818381,[[13.89903545]],[[-90.31367511]],3,0.6747967479674797,
12,2,car,van,354,720,442,696,366,254,0.9823021,[[12.99732295]],[[-86.6157962]],3,0.6939890710382514,
13,2,car,van,350,720,444,699,370,255,0.97152954,[[12.80223224]],[[-87.18860737]],3,0.6891891891891891,
14,2,car,van,354,717,444,692,363,248,0.97865987,[[14.0033309]],[[-89.13509799]],3,0.6831955922865014,
15,2,car,van,349,720,444,698,371,254,0.9789437,[[12.97550655]],[[-88.03299612]],3,0.6846361185983828,
16,2,car,van,355,718,442,697,363,255,0.9835155,[[12.81299323]],[[-85.18174273]],3,0.7024793388429752,
17,2,car,van,356,719,444,695,363,251,0.9872646,[[13.49161823]],[[-87.43249881]],3,0.6914600550964187,
18,2,car,van,356,717,445,700,361,255,0.98048055,[[12.79547224]],[[-84.59101244]],3,0.7063711911357341,
19,2,car,van,357,718,443,695,361,252,0.98117363,[[13.29299264]],[[-86.27341276]],3,0.6980609418282548,
20,2,car,van,352,721,444,697,369,253,0.9763852,[[13.1724195]],[[-88.03748403]],3,0.6856368563685636,
21,2,car,van,356,718,441,696,362,255,0.9822874,[[12.80532617]],[[-84.88734094]],3,0.7044198895027625,
22,2,car,van,334,728,450,721,394,271,0.99925107,[[8.08523286]],[[-84.27413386]],3,0.6878172588832487,
23,2,car,van,331,725,449,722,394,273,0.99893653,[[7.6388042]],[[-83.16424404]],3,0.6928934010152284,
24,2,car,van,341,720,440,705,379,265,0.9988129,[[10.62404092]],[[-84.00437658]],3,0.6992084432717678,
0,2,car,van,357,718,443,695,361,252,0.98895496,[[13.29299264]],[[-86.27341276]],3,0.6980609418282548,
1,2,car,van,359,716,444,693,357,249,0.97837234,[[13.68912907]],[[-86.74932516]],3,0.6974789915966386,
2,2,car,van,357,720,445,694,363,249,0.9793669,[[13.83252945]],[[-88.56618092]],3,0.6859504132231405,
3,2,car,van,352,717,444,694,365,250,0.9881751,[[13.68929513]],[[-88.58765586]],3,0.684931506849315,
4,2,car,van,355,718,444,696,363,252,0.986651,[[13.32153937]],[[-86.86773377]],3,0.6942148760330579,
5,2,car,van,356,720,446,697,364,251,0.9813424,[[13.50450931]],[[-87.72736771]],3,0.6895604395604396,
6,2,car,van,349,717,443,697,368,254,0.9859856,[[12.99583974]],[[-87.1884563]],3,0.6902173913043478,
7,2,car,van,352,719,444,695,367,251,0.98687744,[[13.52981284]],[[-88.60041414]],3,0.6839237057220708,
8,2,car,van,357,716,446,697,359,251,0.9763643,[[13.41877532]],[[-86.23375612]],3,0.6991643454038997,
9,2,car,van,355,718,445,696,363,251,0.9827555,[[13.49161823]],[[-87.43249881]],3,0.6914600550964187,
10,2,car,van,354,720,443,697,366,254,0.9826344,[[12.99732295]],[[-86.6157962]],3,0.6939890710382514,
11,2,car,van,354,720,443,693,366,250,0.98107594,[[13.69964617]],[[-88.87926979]],3,0.6830601092896175,
12,2,car,van,350,719,446,695,369,249,0.9818381,[[13.89903545]],[[-90.31367511]],3,0.6747967479674797,
13,2,car,van,354,720,442,696,366,254,0.9823021,[[12.99732295]],[[-86.6157962]],3,0.6939890710382514,
14,2,car,van,350,720,444,699,370,255,0.97152954,[[12.80223224]],[[-87.18860737]],3,0.6891891891891891,
15,2,car,van,354,717,444,692,363,248,0.97865987,[[14.0033309]],[[-89.13509799]],3,0.6831955922865014,
16,2,car,van,349,720,444,698,371,254,0.9789437,[[12.97550655]],[[-88.03299612]],3,0.6846361185983828,
17,2,car,van,355,718,442,697,363,255,0.9835155,[[12.81299323]],[[-85.18174273]],3,0.7024793388429752,
18,2,car,van,356,719,444,695,363,251,0.9872646,[[13.49161823]],[[-87.43249881]],3,0.6914600550964187,
19,2,car,van,356,717,445,700,361,255,0.98048055,[[12.79547224]],[[-84.59101244]],3,0.7063711911357341,
20,2,car,van,357,718,443,695,361,252,0.98117363,[[13.29299264]],[[-86.27341276]],3,0.6980609418282548,
21,2,car,van,352,721,444,697,369,253,0.9763852,[[13.1724195]],[[-88.03748403]],3,0.6856368563685636,
22,2,car,van,356,718,441,696,362,255,0.9822874,[[12.80532617]],[[-84.88734094]],3,0.7044198895027625,
23,2,car,van,334,728,450,721,394,271,0.99925107,[[8.08523286]],[[-84.27413386]],3,0.6878172588832487,
24,2,car,van,331,725,449,722,394,273,0.99893653,[[7.6388042]],[[-83.16424404]],3,0.6928934010152284,
25,2,car,van,341,720,440,705,379,265,0.9988129,[[10.62404092]],[[-84.00437658]],3,0.6992084432717678,
0,2,car,van,351,721,446,694,370,248,0.9709657,[[14.08636989]],[[-91.17128691]],3,0.6702702702702703,
1,2,car,van,357,718,443,695,361,252,0.98895496,[[13.29299264]],[[-86.27341276]],3,0.6980609418282548,
2,2,car,van,359,716,444,693,357,249,0.97837234,[[13.68912907]],[[-86.74932516]],3,0.6974789915966386,
3,2,car,van,357,720,445,694,363,249,0.9793669,[[13.83252945]],[[-88.56618092]],3,0.6859504132231405,
4,2,car,van,352,717,444,694,365,250,0.9881751,[[13.68929513]],[[-88.58765586]],3,0.684931506849315,
5,2,car,van,355,718,444,696,363,252,0.986651,[[13.32153937]],[[-86.86773377]],3,0.6942148760330579,
6,2,car,van,356,720,446,697,364,251,0.9813424,[[13.50450931]],[[-87.72736771]],3,0.6895604395604396,
7,2,car,van,349,717,443,697,368,254,0.9859856,[[12.99583974]],[[-87.1884563]],3,0.6902173913043478,
8,2,car,van,352,719,444,695,367,251,0.98687744,[[13.52981284]],[[-88.60041414]],3,0.6839237057220708,
9,2,car,van,357,716,446,697,359,251,0.9763643,[[13.41877532]],[[-86.23375612]],3,0.6991643454038997,
10,2,car,van,355,718,445,696,363,251,0.9827555,[[13.49161823]],[[-87.43249881]],3,0.6914600550964187,
11,2,car,van,354,720,443,697,366,254,0.9826344,[[12.99732295]],[[-86.6157962]],3,0.6939890710382514,
12,2,car,van,354,720,443,693,366,250,0.98107594,[[13.69964617]],[[-88.87926979]],3,0.6830601092896175,
13,2,car,van,350,719,446,695,369,249,0.9818381,[[13.89903545]],[[-90.31367511]],3,0.6747967479674797,
14,2,car,van,354,720,442,696,366,254,0.9823021,[[12.99732295]],[[-86.6157962]],3,0.6939890710382514,
15,2,car,van,350,720,444,699,370,255,0.97152954,[[12.80223224]],[[-87.18860737]],3,0.6891891891891891,
16,2,car,van,354,717,444,692,363,248,0.97865987,[[14.0033309]],[[-89.13509799]],3,0.6831955922865014,
17,2,car,van,349,720,444,698,371,254,0.9789437,[[12.97550655]],[[-88.03299612]],3,0.6846361185983828,
18,2,car,van,355,718,442,697,363,255,0.9835155,[[12.81299323]],[[-85.18174273]],3,0.7024793388429752,
19,2,car,van,356,719,444,695,363,251,0.9872646,[[13.49161823]],[[-87.43249881]],3,0.6914600550964187,
20,2,car,van,356,717,445,700,361,255,0.98048055,[[12.79547224]],[[-84.59101244]],3,0.7063711911357341,
21,2,car,van,357,718,443,695,361,252,0.98117363,[[13.29299264]],[[-86.27341276]],3,0.6980609418282548,
22,2,car,van,352,721,444,697,369,253,0.9763852,[[13.1724195]],[[-88.03748403]],3,0.6856368563685636,
23,2,car,van,356,718,441,696,362,255,0.9822874,[[12.80532617]],[[-84.88734094]],3,0.7044198895027625,
24,2,car,van,334,728,450,721,394,271,0.99925107,[[8.08523286]],[[-84.27413386]],3,0.6878172588832487,
25,2,car,van,331,725,449,722,394,273,0.99893653,[[7.6388042]],[[-83.16424404]],3,0.6928934010152284,
26,2,car,van,341,720,440,705,379,265,0.9988129,[[10.62404092]],[[-84.00437658]],3,0.6992084432717678,
0,2,car,van,356,718,442,697,362,255,0.97505856,[[12.80532617]],[[-84.88734094]],3,0.7044198895027625,
1,2,car,van,351,721,446,694,370,248,0.9709657,[[14.08636989]],[[-91.17128691]],3,0.6702702702702703,
2,2,car,van,357,718,443,695,361,252,0.98895496,[[13.29299264]],[[-86.27341276]],3,0.6980609418282548,
3,2,car,van,359,716,444,693,357,249,0.97837234,[[13.68912907]],[[-86.74932516]],3,0.6974789915966386,
4,2,car,van,357,720,445,694,363,249,0.9793669,[[13.83252945]],[[-88.56618092]],3,0.6859504132231405,
5,2,car,van,352,717,444,694,365,250,0.9881751,[[13.68929513]],[[-88.58765586]],3,0.684931506849315,
6,2,car,van,355,718,444,696,363,252,0.986651,[[13.32153937]],[[-86.86773377]],3,0.6942148760330579,
7,2,car,van,356,720,446,697,364,251,0.9813424,[[13.50450931]],[[-87.72736771]],3,0.6895604395604396,
8,2,car,van,349,717,443,697,368,254,0.9859856,[[12.99583974]],[[-87.1884563]],3,0.6902173913043478,
9,2,car,van,352,719,444,695,367,251,0.98687744,[[13.52981284]],[[-88.60041414]],3,0.6839237057220708,
10,2,car,van,357,716,446,697,359,251,0.9763643,[[13.41877532]],[[-86.23375612]],3,0.6991643454038997,
11,2,car,van,355,718,445,696,363,251,0.9827555,[[13.49161823]],[[-87.43249881]],3,0.6914600550964187,
12,2,car,van,354,720,443,697,366,254,0.9826344,[[12.99732295]],[[-86.6157962]],3,0.6939890710382514,
13,2,car,van,354,720,443,693,366,250,0.98107594,[[13.69964617]],[[-88.87926979]],3,0.6830601092896175,
14,2,car,van,350,719,446,695,369,249,0.9818381,[[13.89903545]],[[-90.31367511]],3,0.6747967479674797,
15,2,car,van,354,720,442,696,366,254,0.9823021,[[12.99732295]],[[-86.6157962]],3,0.6939890710382514,
16,2,car,van,350,720,444,699,370,255,0.97152954,[[12.80223224]],[[-87.18860737]],3,0.6891891891891891,
17,2,car,van,354,717,444,692,363,248,0.97865987,[[14.0033309]],[[-89.13509799]],3,0.6831955922865014,
18,2,car,van,349,720,444,698,371,254,0.9789437,[[12.97550655]],[[-88.03299612]],3,0.6846361185983828,
19,2,car,van,355,718,442,697,363,255,0.9835155,[[12.81299323]],[[-85.18174273]],3,0.7024793388429752,
20,2,car,van,356,719,444,695,363,251,0.9872646,[[13.49161823]],[[-87.43249881]],3,0.6914600550964187,
21,2,car,van,356,717,445,700,361,255,0.98048055,[[12.79547224]],[[-84.59101244]],3,0.7063711911357341,
22,2,car,van,357,718,443,695,361,252,0.98117363,[[13.29299264]],[[-86.27341276]],3,0.6980609418282548,
23,2,car,van,352,721,444,697,369,253,0.9763852,[[13.1724195]],[[-88.03748403]],3,0.6856368563685636,
24,2,car,van,356,718,441,696,362,255,0.9822874,[[12.80532617]],[[-84.88734094]],3,0.7044198895027625,
25,2,car,van,334,728,450,721,394,271,0.99925107,[[8.08523286]],[[-84.27413386]],3,0.6878172588832487,
26,2,car,van,331,725,449,722,394,273,0.99893653,[[7.6388042]],[[-83.16424404]],3,0.6928934010152284,
27,2,car,van,341,720,440,705,379,265,0.9988129,[[10.62404092]],[[-84.00437658]],3,0.6992084432717678,
0,2,car,van,353,719,446,695,366,249,0.9726562,[[13.87590236]],[[-89.44859821]],3,0.680327868852459,
1,2,car,van,356,718,442,697,362,255,0.97505856,[[12.80532617]],[[-84.88734094]],3,0.7044198895027625,
2,2,car,van,351,721,446,694,370,248,0.9709657,[[14.08636989]],[[-91.17128691]],3,0.6702702702702703,
3,2,car,van,357,718,443,695,361,252,0.98895496,[[13.29299264]],[[-86.27341276]],3,0.6980609418282548,
4,2,car,van,359,716,444,693,357,249,0.97837234,[[13.68912907]],[[-86.74932516]],3,0.6974789915966386,
5,2,car,van,357,720,445,694,363,249,0.9793669,[[13.83252945]],[[-88.56618092]],3,0.6859504132231405,
6,2,car,van,352,717,444,694,365,250,0.9881751,[[13.68929513]],[[-88.58765586]],3,0.684931506849315,
7,2,car,van,355,718,444,696,363,252,0.986651,[[13.32153937]],[[-86.86773377]],3,0.6942148760330579,
8,2,car,van,356,720,446,697,364,251,0.9813424,[[13.50450931]],[[-87.72736771]],3,0.6895604395604396,
9,2,car,van,349,717,443,697,368,254,0.9859856,[[12.99583974]],[[-87.1884563]],3,0.6902173913043478,
10,2,car,van,352,719,444,695,367,251,0.98687744,[[13.52981284]],[[-88.60041414]],3,0.6839237057220708,
11,2,car,van,357,716,446,697,359,251,0.9763643,[[13.41877532]],[[-86.23375612]],3,0.6991643454038997,
12,2,car,van,355,718,445,696,363,251,0.9827555,[[13.49161823]],[[-87.43249881]],3,0.6914600550964187,
13,2,car,van,354,720,443,697,366,254,0.9826344,[[12.99732295]],[[-86.6157962]],3,0.6939890710382514,
14,2,car,van,354,720,443,693,366,250,0.98107594,[[13.69964617]],[[-88.87926979]],3,0.6830601092896175,
15,2,car,van,350,719,446,695,369,249,0.9818381,[[13.89903545]],[[-90.31367511]],3,0.6747967479674797,
16,2,car,van,354,720,442,696,366,254,0.9823021,[[12.99732295]],[[-86.6157962]],3,0.6939890710382514,
17,2,car,van,350,720,444,699,370,255,0.97152954,[[12.80223224]],[[-87.18860737]],3,0.6891891891891891,
18,2,car,van,354,717,444,692,363,248,0.97865987,[[14.0033309]],[[-89.13509799]],3,0.6831955922865014,
19,2,car,van,349,720,444,698,371,254,0.9789437,[[12.97550655]],[[-88.03299612]],3,0.6846361185983828,
20,2,car,van,355,718,442,697,363,255,0.9835155,[[12.81299323]],[[-85.18174273]],3,0.7024793388429752,
21,2,car,van,356,719,444,695,363,251,0.9872646,[[13.49161823]],[[-87.43249881]],3,0.6914600550964187,
22,2,car,van,356,717,445,700,361,255,0.98048055,[[12.79547224]],[[-84.59101244]],3,0.7063711911357341,
23,2,car,van,357,718,443,695,361,252,0.98117363,[[13.29299264]],[[-86.27341276]],3,0.6980609418282548,
24,2,car,van,352,721,444,697,369,253,0.9763852,[[13.1724195]],[[-88.03748403]],3,0.6856368563685636,
25,2,car,van,356,718,441,696,362,255,0.9822874,[[12.80532617]],[[-84.88734094]],3,0.7044198895027625,
26,2,car,van,334,728,450,721,394,271,0.99925107,[[8.08523286]],[[-84.27413386]],3,0.6878172588832487,
27,2,car,van,331,725,449,722,394,273,0.99893653,[[7.6388042]],[[-83.16424404]],3,0.6928934010152284,
28,2,car,van,341,720,440,705,379,265,0.9988129,[[10.62404092]],[[-84.00437658]],3,0.6992084432717678,
0,2,car,van,351,721,445,699,370,254,0.97839665,[[12.9847507]],[[-87.75340956]],3,0.6864864864864865,
1,2,car,van,353,719,446,695,366,249,0.9726562,[[13.87590236]],[[-89.44859821]],3,0.680327868852459,
2,2,car,van,356,718,442,697,362,255,0.97505856,[[12.80532617]],[[-84.88734094]],3,0.7044198895027625,
3,2,car,van,351,721,446,694,370,248,0.9709657,[[14.08636989]],[[-91.17128691]],3,0.6702702702702703,
4,2,car,van,357,718,443,695,361,252,0.98895496,[[13.29299264]],[[-86.27341276]],3,0.6980609418282548,
5,2,car,van,359,716,444,693,357,249,0.97837234,[[13.68912907]],[[-86.74932516]],3,0.6974789915966386,
6,2,car,van,357,720,445,694,363,249,0.9793669,[[13.83252945]],[[-88.56618092]],3,0.6859504132231405,
7,2,car,van,352,717,444,694,365,250,0.9881751,[[13.68929513]],[[-88.58765586]],3,0.684931506849315,
8,2,car,van,355,718,444,696,363,252,0.986651,[[13.32153937]],[[-86.86773377]],3,0.6942148760330579,
9,2,car,van,356,720,446,697,364,251,0.9813424,[[13.50450931]],[[-87.72736771]],3,0.6895604395604396,
10,2,car,van,349,717,443,697,368,254,0.9859856,[[12.99583974]],[[-87.1884563]],3,0.6902173913043478,
11,2,car,van,352,719,444,695,367,251,0.98687744,[[13.52981284]],[[-88.60041414]],3,0.6839237057220708,
12,2,car,van,357,716,446,697,359,251,0.9763643,[[13.41877532]],[[-86.23375612]],3,0.6991643454038997,
13,2,car,van,355,718,445,696,363,251,0.9827555,[[13.49161823]],[[-87.43249881]],3,0.6914600550964187,
14,2,car,van,354,720,443,697,366,254,0.9826344,[[12.99732295]],[[-86.6157962]],3,0.6939890710382514,
15,2,car,van,354,720,443,693,366,250,0.98107594,[[13.69964617]],[[-88.87926979]],3,0.6830601092896175,
16,2,car,van,350,719,446,695,369,249,0.9818381,[[13.89903545]],[[-90.31367511]],3,0.6747967479674797,
17,2,car,van,354,720,442,696,366,254,0.9823021,[[12.99732295]],[[-86.6157962]],3,0.6939890710382514,
18,2,car,van,350,720,444,699,370,255,0.97152954,[[12.80223224]],[[-87.18860737]],3,0.6891891891891891,
19,2,car,van,354,717,444,692,363,248,0.97865987,[[14.0033309]],[[-89.13509799]],3,0.6831955922865014,
20,2,car,van,349,720,444,698,371,254,0.9789437,[[12.97550655]],[[-88.03299612]],3,0.6846361185983828,
21,2,car,van,355,718,442,697,363,255,0.9835155,[[12.81299323]],[[-85.18174273]],3,0.7024793388429752,
22,2,car,van,356,719,444,695,363,251,0.9872646,[[13.49161823]],[[-87.43249881]],3,0.6914600550964187,
23,2,car,van,356,717,445,700,361,255,0.98048055,[[12.79547224]],[[-84.59101244]],3,0.7063711911357341,
24,2,car,van,357,718,443,695,361,252,0.98117363,[[13.29299264]],[[-86.27341276]],3,0.6980609418282548,
25,2,car,van,352,721,444,697,369,253,0.9763852,[[13.1724195]],[[-88.03748403]],3,0.6856368563685636,
26,2,car,van,356,718,441,696,362,255,0.9822874,[[12.80532617]],[[-84.88734094]],3,0.7044198895027625,
27,2,car,van,334,728,450,721,394,271,0.99925107,[[8.08523286]],[[-84.27413386]],3,0.6878172588832487,
28,2,car,van,331,725,449,722,394,273,0.99893653,[[7.6388042]],[[-83.16424404]],3,0.6928934010152284,
29,2,car,van,341,720,440,705,379,265,0.9988129,[[10.62404092]],[[-84.00437658]],3,0.6992084432717678,
0,2,car,van,346,724,462,708,378,246,0.98077375,[[14.43933385]],[[-94.54269717]],3,0.6507936507936508,
1,2,car,van,351,721,445,699,370,254,0.97839665,[[12.9847507]],[[-87.75340956]],3,0.6864864864864865,
2,2,car,van,353,719,446,695,366,249,0.9726562,[[13.87590236]],[[-89.44859821]],3,0.680327868852459,
3,2,car,van,356,718,442,697,362,255,0.97505856,[[12.80532617]],[[-84.88734094]],3,0.7044198895027625,
4,2,car,van,351,721,446,694,370,248,0.9709657,[[14.08636989]],[[-91.17128691]],3,0.6702702702702703,
5,2,car,van,357,718,443,695,361,252,0.98895496,[[13.29299264]],[[-86.27341276]],3,0.6980609418282548,
6,2,car,van,359,716,444,693,357,249,0.97837234,[[13.68912907]],[[-86.74932516]],3,0.6974789915966386,
7,2,car,van,357,720,445,694,363,249,0.9793669,[[13.83252945]],[[-88.56618092]],3,0.6859504132231405,
8,2,car,van,352,717,444,694,365,250,0.9881751,[[13.68929513]],[[-88.58765586]],3,0.684931506849315,
9,2,car,van,355,718,444,696,363,252,0.986651,[[13.32153937]],[[-86.86773377]],3,0.6942148760330579,
10,2,car,van,356,720,446,697,364,251,0.9813424,[[13.50450931]],[[-87.72736771]],3,0.6895604395604396,
11,2,car,van,349,717,443,697,368,254,0.9859856,[[12.99583974]],[[-87.1884563]],3,0.6902173913043478,
12,2,car,van,352,719,444,695,367,251,0.98687744,[[13.52981284]],[[-88.60041414]],3,0.6839237057220708,
13,2,car,van,357,716,446,697,359,251,0.9763643,[[13.41877532]],[[-86.23375612]],3,0.6991643454038997,
14,2,car,van,355,718,445,696,363,251,0.9827555,[[13.49161823]],[[-87.43249881]],3,0.6914600550964187,
15,2,car,van,354,720,443,697,366,254,0.9826344,[[12.99732295]],[[-86.6157962]],3,0.6939890710382514,
16,2,car,van,354,720,443,693,366,250,0.98107594,[[13.69964617]],[[-88.87926979]],3,0.6830601092896175,
17,2,car,van,350,719,446,695,369,249,0.9818381,[[13.89903545]],[[-90.31367511]],3,0.6747967479674797,
18,2,car,van,354,720,442,696,366,254,0.9823021,[[12.99732295]],[[-86.6157962]],3,0.6939890710382514,
19,2,car,van,350,720,444,699,370,255,0.97152954,[[12.80223224]],[[-87.18860737]],3,0.6891891891891891,
20,2,car,van,354,717,444,692,363,248,0.97865987,[[14.0033309]],[[-89.13509799]],3,0.6831955922865014,
21,2,car,van,349,720,444,698,371,254,0.9789437,[[12.97550655]],[[-88.03299612]],3,0.6846361185983828,
22,2,car,van,355,718,442,697,363,255,0.9835155,[[12.81299323]],[[-85.18174273]],3,0.7024793388429752,
23,2,car,van,356,719,444,695,363,251,0.9872646,[[13.49161823]],[[-87.43249881]],3,0.6914600550964187,
24,2,car,van,356,717,445,700,361,255,0.98048055,[[12.79547224]],[[-84.59101244]],3,0.7063711911357341,
25,2,car,van,357,718,443,695,361,252,0.98117363,[[13.29299264]],[[-86.27341276]],3,0.6980609418282548,
26,2,car,van,352,721,444,697,369,253,0.9763852,[[13.1724195]],[[-88.03748403]],3,0.6856368563685636,
27,2,car,van,356,718,441,696,362,255,0.9822874,[[12.80532617]],[[-84.88734094]],3,0.7044198895027625,
28,2,car,van,334,728,450,721,394,271,0.99925107,[[8.08523286]],[[-84.27413386]],3,0.6878172588832487,
29,2,car,van,331,725,449,722,394,273,0.99893653,[[7.6388042]],[[-83.16424404]],3,0.6928934010152284,
30,2,car,van,341,720,440,705,379,265,0.9988129,[[10.62404092]],[[-84.00437658]],3,0.6992084432717678,
0,2,car,van,352,722,445,693,370,248,0.9812132,[[14.08636989]],[[-91.17128691]],3,0.6702702702702703,
1,2,car,van,346,724,462,708,378,246,0.98077375,[[14.43933385]],[[-94.54269717]],3,0.6507936507936508,
2,2,car,van,351,721,445,699,370,254,0.97839665,[[12.9847507]],[[-87.75340956]],3,0.6864864864864865,
3,2,car,van,353,719,446,695,366,249,0.9726562,[[13.87590236]],[[-89.44859821]],3,0.680327868852459,
4,2,car,van,356,718,442,697,362,255,0.97505856,[[12.80532617]],[[-84.88734094]],3,0.7044198895027625,
5,2,car,van,351,721,446,694,370,248,0.9709657,[[14.08636989]],[[-91.17128691]],3,0.6702702702702703,
6,2,car,van,357,718,443,695,361,252,0.98895496,[[13.29299264]],[[-86.27341276]],3,0.6980609418282548,
7,2,car,van,359,716,444,693,357,249,0.97837234,[[13.68912907]],[[-86.74932516]],3,0.6974789915966386,
8,2,car,van,357,720,445,694,363,249,0.9793669,[[13.83252945]],[[-88.56618092]],3,0.6859504132231405,
9,2,car,van,352,717,444,694,365,250,0.9881751,[[13.68929513]],[[-88.58765586]],3,0.684931506849315,
10,2,car,van,355,718,444,696,363,252,0.986651,[[13.32153937]],[[-86.86773377]],3,0.6942148760330579,
11,2,car,van,356,720,446,697,364,251,0.9813424,[[13.50450931]],[[-87.72736771]],3,0.6895604395604396,
12,2,car,van,349,717,443,697,368,254,0.9859856,[[12.99583974]],[[-87.1884563]],3,0.6902173913043478,
13,2,car,van,352,719,444,695,367,251,0.98687744,[[13.52981284]],[[-88.60041414]],3,0.6839237057220708,
14,2,car,van,357,716,446,697,359,251,0.9763643,[[13.41877532]],[[-86.23375612]],3,0.6991643454038997,
15,2,car,van,355,718,445,696,363,251,0.9827555,[[13.49161823]],[[-87.43249881]],3,0.6914600550964187,
16,2,car,van,354,720,443,697,366,254,0.9826344,[[12.99732295]],[[-86.6157962]],3,0.6939890710382514,
17,2,car,van,354,720,443,693,366,250,0.98107594,[[13.69964617]],[[-88.87926979]],3,0.6830601092896175,
18,2,car,van,350,719,446,695,369,249,0.9818381,[[13.89903545]],[[-90.31367511]],3,0.6747967479674797,
19,2,car,van,354,720,442,696,366,254,0.9823021,[[12.99732295]],[[-86.6157962]],3,0.6939890710382514,
20,2,car,van,350,720,444,699,370,255,0.97152954,[[12.80223224]],[[-87.18860737]],3,0.6891891891891891,
21,2,car,van,354,717,444,692,363,248,0.97865987,[[14.0033309]],[[-89.13509799]],3,0.6831955922865014,
22,2,car,van,349,720,444,698,371,254,0.9789437,[[12.97550655]],[[-88.03299612]],3,0.6846361185983828,
23,2,car,van,355,718,442,697,363,255,0.9835155,[[12.81299323]],[[-85.18174273]],3,0.7024793388429752,
24,2,car,van,356,719,444,695,363,251,0.9872646,[[13.49161823]],[[-87.43249881]],3,0.6914600550964187,
25,2,car,van,356,717,445,700,361,255,0.98048055,[[12.79547224]],[[-84.59101244]],3,0.7063711911357341,
26,2,car,van,357,718,443,695,361,252,0.98117363,[[13.29299264]],[[-86.27341276]],3,0.6980609418282548,
27,2,car,van,352,721,444,697,369,253,0.9763852,[[13.1724195]],[[-88.03748403]],3,0.6856368563685636,
28,2,car,van,356,718,441,696,362,255,0.9822874,[[12.80532617]],[[-84.88734094]],3,0.7044198895027625,
29,2,car,van,334,728,450,721,394,271,0.99925107,[[8.08523286]],[[-84.27413386]],3,0.6878172588832487,
30,2,car,van,331,725,449,722,394,273,0.99893653,[[7.6388042]],[[-83.16424404]],3,0.6928934010152284,
31,2,car,van,341,720,440,705,379,265,0.9988129,[[10.62404092]],[[-84.00437658]],3,0.6992084432717678,
0,2,car,van,355,717,443,699,362,256,0.9844455,[[12.63826016]],[[-84.3287104]],3,0.7071823204419889,
1,2,car,van,352,722,445,693,370,248,0.9812132,[[14.08636989]],[[-91.17128691]],3,0.6702702702702703,
2,2,car,van,346,724,462,708,378,246,0.98077375,[[14.43933385]],[[-94.54269717]],3,0.6507936507936508,
3,2,car,van,351,721,445,699,370,254,0.97839665,[[12.9847507]],[[-87.75340956]],3,0.6864864864864865,
4,2,car,van,353,719,446,695,366,249,0.9726562,[[13.87590236]],[[-89.44859821]],3,0.680327868852459,
5,2,car,van,356,718,442,697,362,255,0.97505856,[[12.80532617]],[[-84.88734094]],3,0.7044198895027625,
6,2,car,van,351,721,446,694,370,248,0.9709657,[[14.08636989]],[[-91.17128691]],3,0.6702702702702703,
7,2,car,van,357,718,443,695,361,252,0.98895496,[[13.29299264]],[[-86.27341276]],3,0.6980609418282548,
8,2,car,van,359,716,444,693,357,249,0.97837234,[[13.68912907]],[[-86.74932516]],3,0.6974789915966386,
9,2,car,van,357,720,445,694,363,249,0.9793669,[[13.83252945]],[[-88.56618092]],3,0.6859504132231405,
10,2,car,van,352,717,444,694,365,250,0.9881751,[[13.68929513]],[[-88.58765586]],3,0.684931506849315,
11,2,car,van,355,718,444,696,363,252,0.986651,[[13.32153937]],[[-86.86773377]],3,0.6942148760330579,
12,2,car,van,356,720,446,697,364,251,0.9813424,[[13.50450931]],[[-87.72736771]],3,0.6895604395604396,
13,2,car,van,349,717,443,697,368,254,0.9859856,[[12.99583974]],[[-87.1884563]],3,0.6902173913043478,
14,2,car,van,352,719,444,695,367,251,0.98687744,[[13.52981284]],[[-88.60041414]],3,0.6839237057220708,
15,2,car,van,357,716,446,697,359,251,0.9763643,[[13.41877532]],[[-86.23375612]],3,0.6991643454038997,
16,2,car,van,355,718,445,696,363,251,0.9827555,[[13.49161823]],[[-87.43249881]],3,0.6914600550964187,
17,2,car,van,354,720,443,697,366,254,0.9826344,[[12.99732295]],[[-86.6157962]],3,0.6939890710382514,
18,2,car,van,354,720,443,693,366,250,0.98107594,[[13.69964617]],[[-88.87926979]],3,0.6830601092896175,
19,2,car,van,350,719,446,695,369,249,0.9818381,[[13.89903545]],[[-90.31367511]],3,0.6747967479674797,
20,2,car,van,354,720,442,696,366,254,0.9823021,[[12.99732295]],[[-86.6157962]],3,0.6939890710382514,
21,2,car,van,350,720,444,699,370,255,0.97152954,[[12.80223224]],[[-87.18860737]],3,0.6891891891891891,
22,2,car,van,354,717,444,692,363,248,0.97865987,[[14.0033309]],[[-89.13509799]],3,0.6831955922865014,
23,2,car,van,349,720,444,698,371,254,0.9789437,[[12.97550655]],[[-88.03299612]],3,0.6846361185983828,
24,2,car,van,355,718,442,697,363,255,0.9835155,[[12.81299323]],[[-85.18174273]],3,0.7024793388429752,
25,2,car,van,356,719,444,695,363,251,0.9872646,[[13.49161823]],[[-87.43249881]],3,0.6914600550964187,
26,2,car,van,356,717,445,700,361,255,0.98048055,[[12.79547224]],[[-84.59101244]],3,0.7063711911357341,
27,2,car,van,357,718,443,695,361,252,0.98117363,[[13.29299264]],[[-86.27341276]],3,0.6980609418282548,
28,2,car,van,352,721,444,697,369,253,0.9763852,[[13.1724195]],[[-88.03748403]],3,0.6856368563685636,
29,2,car,van,356,718,441,696,362,255,0.9822874,[[12.80532617]],[[-84.88734094]],3,0.7044198895027625,
30,2,car,van,334,728,450,721,394,271,0.99925107,[[8.08523286]],[[-84.27413386]],3,0.6878172588832487,
31,2,car,van,331,725,449,722,394,273,0.99893653,[[7.6388042]],[[-83.16424404]],3,0.6928934010152284,
32,2,car,van,341,720,440,705,379,265,0.9988129,[[10.62404092]],[[-84.00437658]],3,0.6992084432717678,
0,2,car,van,354,721,447,691,367,244,0.9798042,[[14.78014871]],[[-92.60927844]],3,0.6648501362397821,
1,2,car,van,355,717,443,699,362,256,0.9844455,[[12.63826016]],[[-84.3287104]],3,0.7071823204419889,
2,2,car,van,352,722,445,693,370,248,0.9812132,[[14.08636989]],[[-91.17128691]],3,0.6702702702702703,
3,2,car,van,346,724,462,708,378,246,0.98077375,[[14.43933385]],[[-94.54269717]],3,0.6507936507936508,
4,2,car,van,351,721,445,699,370,254,0.97839665,[[12.9847507]],[[-87.75340956]],3,0.6864864864864865,
5,2,car,van,353,719,446,695,366,249,0.9726562,[[13.87590236]],[[-89.44859821]],3,0.680327868852459,
6,2,car,van,356,718,442,697,362,255,0.97505856,[[12.80532617]],[[-84.88734094]],3,0.7044198895027625,
7,2,car,van,351,721,446,694,370,248,0.9709657,[[14.08636989]],[[-91.17128691]],3,0.6702702702702703,
8,2,car,van,357,718,443,695,361,252,0.98895496,[[13.29299264]],[[-86.27341276]],3,0.6980609418282548,
9,2,car,van,359,716,444,693,357,249,0.97837234,[[13.68912907]],[[-86.74932516]],3,0.6974789915966386,
10,2,car,van,357,720,445,694,363,249,0.9793669,[[13.83252945]],[[-88.56618092]],3,0.6859504132231405,
11,2,car,van,352,717,444,694,365,250,0.9881751,[[13.68929513]],[[-88.58765586]],3,0.684931506849315,
12,2,car,van,355,718,444,696,363,252,0.986651,[[13.32153937]],[[-86.86773377]],3,0.6942148760330579,
13,2,car,van,356,720,446,697,364,251,0.9813424,[[13.50450931]],[[-87.72736771]],3,0.6895604395604396,
14,2,car,van,349,717,443,697,368,254,0.9859856,[[12.99583974]],[[-87.1884563]],3,0.6902173913043478,
15,2,car,van,352,719,444,695,367,251,0.98687744,[[13.52981284]],[[-88.60041414]],3,0.6839237057220708,
16,2,car,van,357,716,446,697,359,251,0.9763643,[[13.41877532]],[[-86.23375612]],3,0.6991643454038997,
17,2,car,van,355,718,445,696,363,251,0.9827555,[[13.49161823]],[[-87.43249881]],3,0.6914600550964187,
18,2,car,van,354,720,443,697,366,254,0.9826344,[[12.99732295]],[[-86.6157962]],3,0.6939890710382514,
19,2,car,van,354,720,443,693,366,250,0.98107594,[[13.69964617]],[[-88.87926979]],3,0.6830601092896175,
20,2,car,van,350,719,446,695,369,249,0.9818381,[[13.89903545]],[[-90.31367511]],3,0.6747967479674797,
21,2,car,van,354,720,442,696,366,254,0.9823021,[[12.99732295]],[[-86.6157962]],3,0.6939890710382514,
22,2,car,van,350,720,444,699,370,255,0.97152954,[[12.80223224]],[[-87.18860737]],3,0.6891891891891891,
23,2,car,van,354,717,444,692,363,248,0.97865987,[[14.0033309]],[[-89.13509799]],3,0.6831955922865014,
24,2,car,van,349,720,444,698,371,254,0.9789437,[[12.97550655]],[[-88.03299612]],3,0.6846361185983828,
25,2,car,van,355,718,442,697,363,255,0.9835155,[[12.81299323]],[[-85.18174273]],3,0.7024793388429752,
26,2,car,van,356,719,444,695,363,251,0.9872646,[[13.49161823]],[[-87.43249881]],3,0.6914600550964187,
27,2,car,van,356,717,445,700,361,255,0.98048055,[[12.79547224]],[[-84.59101244]],3,0.7063711911357341,
28,2,car,van,357,718,443,695,361,252,0.98117363,[[13.29299264]],[[-86.27341276]],3,0.6980609418282548,
29,2,car,van,352,721,444,697,369,253,0.9763852,[[13.1724195]],[[-88.03748403]],3,0.6856368563685636,
30,2,car,van,356,718,441,696,362,255,0.9822874,[[12.80532617]],[[-84.88734094]],3,0.7044198895027625,
31,2,car,van,334,728,450,721,394,271,0.99925107,[[8.08523286]],[[-84.27413386]],3,0.6878172588832487,
32,2,car,van,331,725,449,722,394,273,0.99893653,[[7.6388042]],[[-83.16424404]],3,0.6928934010152284,
33,2,car,van,341,720,440,705,379,265,0.9988129,[[10.62404092]],[[-84.00437658]],3,0.6992084432717678,
0,2,car,van,358,721,442,699,363,257,0.9873583,[[12.47552185]],[[-84.06466875]],3,0.7079889807162535,
1,2,car,van,354,721,447,691,367,244,0.9798042,[[14.78014871]],[[-92.60927844]],3,0.6648501362397821,
2,2,car,van,355,717,443,699,362,256,0.9844455,[[12.63826016]],[[-84.3287104]],3,0.7071823204419889,
3,2,car,van,352,722,445,693,370,248,0.9812132,[[14.08636989]],[[-91.17128691]],3,0.6702702702702703,
4,2,car,van,346,724,462,708,378,246,0.98077375,[[14.43933385]],[[-94.54269717]],3,0.6507936507936508,
5,2,car,van,351,721,445,699,370,254,0.97839665,[[12.9847507]],[[-87.75340956]],3,0.6864864864864865,
6,2,car,van,353,719,446,695,366,249,0.9726562,[[13.87590236]],[[-89.44859821]],3,0.680327868852459,
7,2,car,van,356,718,442,697,362,255,0.97505856,[[12.80532617]],[[-84.88734094]],3,0.7044198895027625,
8,2,car,van,351,721,446,694,370,248,0.9709657,[[14.08636989]],[[-91.17128691]],3,0.6702702702702703,
9,2,car,van,357,718,443,695,361,252,0.98895496,[[13.29299264]],[[-86.27341276]],3,0.6980609418282548,
10,2,car,van,359,716,444,693,357,249,0.97837234,[[13.68912907]],[[-86.74932516]],3,0.6974789915966386,
11,2,car,van,357,720,445,694,363,249,0.9793669,[[13.83252945]],[[-88.56618092]],3,0.6859504132231405,
12,2,car,van,352,717,444,694,365,250,0.9881751,[[13.68929513]],[[-88.58765586]],3,0.684931506849315,
13,2,car,van,355,718,444,696,363,252,0.986651,[[13.32153937]],[[-86.86773377]],3,0.6942148760330579,
14,2,car,van,356,720,446,697,364,251,0.9813424,[[13.50450931]],[[-87.72736771]],3,0.6895604395604396,
15,2,car,van,349,717,443,697,368,254,0.9859856,[[12.99583974]],[[-87.1884563]],3,0.6902173913043478,
16,2,car,van,352,719,444,695,367,251,0.98687744,[[13.52981284]],[[-88.60041414]],3,0.6839237057220708,
17,2,car,van,357,716,446,697,359,251,0.9763643,[[13.41877532]],[[-86.23375612]],3,0.6991643454038997,
18,2,car,van,355,718,445,696,363,251,0.9827555,[[13.49161823]],[[-87.43249881]],3,0.6914600550964187,
19,2,car,van,354,720,443,697,366,254,0.9826344,[[12.99732295]],[[-86.6157962]],3,0.6939890710382514,
20,2,car,van,354,720,443,693,366,250,0.98107594,[[13.69964617]],[[-88.87926979]],3,0.6830601092896175,
21,2,car,van,350,719,446,695,369,249,0.9818381,[[13.89903545]],[[-90.31367511]],3,0.6747967479674797,
22,2,car,van,354,720,442,696,366,254,0.9823021,[[12.99732295]],[[-86.6157962]],3,0.6939890710382514,
23,2,car,van,350,720,444,699,370,255,0.97152954,[[12.80223224]],[[-87.18860737]],3,0.6891891891891891,
24,2,car,van,354,717,444,692,363,248,0.97865987,[[14.0033309]],[[-89.13509799]],3,0.6831955922865014,
25,2,car,van,349,720,444,698,371,254,0.9789437,[[12.97550655]],[[-88.03299612]],3,0.6846361185983828,
26,2,car,van,355,718,442,697,363,255,0.9835155,[[12.81299323]],[[-85.18174273]],3,0.7024793388429752,
27,2,car,van,356,719,444,695,363,251,0.9872646,[[13.49161823]],[[-87.43249881]],3,0.6914600550964187,
28,2,car,van,356,717,445,700,361,255,0.98048055,[[12.79547224]],[[-84.59101244]],3,0.7063711911357341,
29,2,car,van,357,718,443,695,361,252,0.98117363,[[13.29299264]],[[-86.27341276]],3,0.6980609418282548,
30,2,car,van,352,721,444,697,369,253,0.9763852,[[13.1724195]],[[-88.03748403]],3,0.6856368563685636,
31,2,car,van,356,718,441,696,362,255,0.9822874,[[12.80532617]],[[-84.88734094]],3,0.7044198895027625,
32,2,car,van,334,728,450,721,394,271,0.99925107,[[8.08523286]],[[-84.27413386]],3,0.6878172588832487,
33,2,car,van,331,725,449,722,394,273,0.99893653,[[7.6388042]],[[-83.16424404]],3,0.6928934010152284,
34,2,car,van,341,720,440,705,379,265,0.9988129,[[10.62404092]],[[-84.00437658]],3,0.6992084432717678,
0,2,car,van,353,719,444,698,366,254,0.9766162,[[12.99732295]],[[-86.6157962]],3,0.6939890710382514,
1,2,car,van,358,721,442,699,363,257,0.9873583,[[12.47552185]],[[-84.06466875]],3,0.7079889807162535,
2,2,car,van,354,721,447,691,367,244,0.9798042,[[14.78014871]],[[-92.60927844]],3,0.6648501362397821,
3,2,car,van,355,717,443,699,362,256,0.9844455,[[12.63826016]],[[-84.3287104]],3,0.7071823204419889,
4,2,car,van,352,722,445,693,370,248,0.9812132,[[14.08636989]],[[-91.17128691]],3,0.6702702702702703,
5,2,car,van,346,724,462,708,378,246,0.98077375,[[14.43933385]],[[-94.54269717]],3,0.6507936507936508,
6,2,car,van,351,721,445,699,370,254,0.97839665,[[12.9847507]],[[-87.75340956]],3,0.6864864864864865,
7,2,car,van,353,719,446,695,366,249,0.9726562,[[13.87590236]],[[-89.44859821]],3,0.680327868852459,
8,2,car,van,356,718,442,697,362,255,0.97505856,[[12.80532617]],[[-84.88734094]],3,0.7044198895027625,
9,2,car,van,351,721,446,694,370,248,0.9709657,[[14.08636989]],[[-91.17128691]],3,0.6702702702702703,
10,2,car,van,357,718,443,695,361,252,0.98895496,[[13.29299264]],[[-86.27341276]],3,0.6980609418282548,
11,2,car,van,359,716,444,693,357,249,0.97837234,[[13.68912907]],[[-86.74932516]],3,0.6974789915966386,
12,2,car,van,357,720,445,694,363,249,0.9793669,[[13.83252945]],[[-88.56618092]],3,0.6859504132231405,
13,2,car,van,352,717,444,694,365,250,0.9881751,[[13.68929513]],[[-88.58765586]],3,0.684931506849315,
14,2,car,van,355,718,444,696,363,252,0.986651,[[13.32153937]],[[-86.86773377]],3,0.6942148760330579,
15,2,car,van,356,720,446,697,364,251,0.9813424,[[13.50450931]],[[-87.72736771]],3,0.6895604395604396,
16,2,car,van,349,717,443,697,368,254,0.9859856,[[12.99583974]],[[-87.1884563]],3,0.6902173913043478,
17,2,car,van,352,719,444,695,367,251,0.98687744,[[13.52981284]],[[-88.60041414]],3,0.6839237057220708,
18,2,car,van,357,716,446,697,359,251,0.9763643,[[13.41877532]],[[-86.23375612]],3,0.6991643454038997,
19,2,car,van,355,718,445,696,363,251,0.9827555,[[13.49161823]],[[-87.43249881]],3,0.6914600550964187,
20,2,car,van,354,720,443,697,366,254,0.9826344,[[12.99732295]],[[-86.6157962]],3,0.6939890710382514,
21,2,car,van,354,720,443,693,366,250,0.98107594,[[13.69964617]],[[-88.87926979]],3,0.6830601092896175,
22,2,car,van,350,719,446,695,369,249,0.9818381,[[13.89903545]],[[-90.31367511]],3,0.6747967479674797,
23,2,car,van,354,720,442,696,366,254,0.9823021,[[12.99732295]],[[-86.6157962]],3,0.6939890710382514,
24,2,car,van,350,720,444,699,370,255,0.97152954,[[12.80223224]],[[-87.18860737]],3,0.6891891891891891,
25,2,car,van,354,717,444,692,363,248,0.97865987,[[14.0033309]],[[-89.13509799]],3,0.6831955922865014,
26,2,car,van,349,720,444,698,371,254,0.9789437,[[12.97550655]],[[-88.03299612]],3,0.6846361185983828,
27,2,car,van,355,718,442,697,363,255,0.9835155,[[12.81299323]],[[-85.18174273]],3,0.7024793388429752,
28,2,car,van,356,719,444,695,363,251,0.9872646,[[13.49161823]],[[-87.43249881]],3,0.6914600550964187,
29,2,car,van,356,717,445,700,361,255,0.98048055,[[12.79547224]],[[-84.59101244]],3,0.7063711911357341,
30,2,car,van,357,718,443,695,361,252,0.98117363,[[13.29299264]],[[-86.27341276]],3,0.6980609418282548,
31,2,car,van,352,721,444,697,369,253,0.9763852,[[13.1724195]],[[-88.03748403]],3,0.6856368563685636,
32,2,car,van,356,718,441,696,362,255,0.9822874,[[12.80532617]],[[-84.88734094]],3,0.7044198895027625,
33,2,car,van,334,728,450,721,394,271,0.99925107,[[8.08523286]],[[-84.27413386]],3,0.6878172588832487,
34,2,car,van,331,725,449,722,394,273,0.99893653,[[7.6388042]],[[-83.16424404]],3,0.6928934010152284,
35,2,car,van,341,720,440,705,379,265,0.9988129,[[10.62404092]],[[-84.00437658]],3,0.6992084432717678,
0,2,car,van,354,718,444,694,364,250,0.96606976,[[13.67671825]],[[-88.29411521]],3,0.6868131868131868,
1,2,car,van,353,719,444,698,366,254,0.9766162,[[12.99732295]],[[-86.6157962]],3,0.6939890710382514,
2,2,car,van,358,721,442,699,363,257,0.9873583,[[12.47552185]],[[-84.06466875]],3,0.7079889807162535,
3,2,car,van,354,721,447,691,367,244,0.9798042,[[14.78014871]],[[-92.60927844]],3,0.6648501362397821,
4,2,car,van,355,717,443,699,362,256,0.9844455,[[12.63826016]],[[-84.3287104]],3,0.7071823204419889,
5,2,car,van,352,722,445,693,370,248,0.9812132,[[14.08636989]],[[-91.17128691]],3,0.6702702702702703,
6,2,car,van,346,724,462,708,378,246,0.98077375,[[14.43933385]],[[-94.54269717]],3,0.6507936507936508,
7,2,car,van,351,721,445,699,370,254,0.97839665,[[12.9847507]],[[-87.75340956]],3,0.6864864864864865,
8,2,car,van,353,719,446,695,366,249,0.9726562,[[13.87590236]],[[-89.44859821]],3,0.680327868852459,
9,2,car,van,356,718,442,697,362,255,0.97505856,[[12.80532617]],[[-84.88734094]],3,0.7044198895027625,
10,2,car,van,351,721,446,694,370,248,0.9709657,[[14.08636989]],[[-91.17128691]],3,0.6702702702702703,
11,2,car,van,357,718,443,695,361,252,0.98895496,[[13.29299264]],[[-86.27341276]],3,0.6980609418282548,
12,2,car,van,359,716,444,693,357,249,0.97837234,[[13.68912907]],[[-86.74932516]],3,0.6974789915966386,
13,2,car,van,357,720,445,694,363,249,0.9793669,[[13.83252945]],[[-88.56618092]],3,0.6859504132231405,
14,2,car,van,352,717,444,694,365,250,0.9881751,[[13.68929513]],[[-88.58765586]],3,0.684931506849315,
15,2,car,van,355,718,444,696,363,252,0.986651,[[13.32153937]],[[-86.86773377]],3,0.6942148760330579,
16,2,car,van,356,720,446,697,364,251,0.9813424,[[13.50450931]],[[-87.72736771]],3,0.6895604395604396,
17,2,car,van,349,717,443,697,368,254,0.9859856,[[12.99583974]],[[-87.1884563]],3,0.6902173913043478,
18,2,car,van,352,719,444,695,367,251,0.98687744,[[13.52981284]],[[-88.60041414]],3,0.6839237057220708,
19,2,car,van,357,716,446,697,359,251,0.9763643,[[13.41877532]],[[-86.23375612]],3,0.6991643454038997,
20,2,car,van,355,718,445,696,363,251,0.9827555,[[13.49161823]],[[-87.43249881]],3,0.6914600550964187,
21,2,car,van,354,720,443,697,366,254,0.9826344,[[12.99732295]],[[-86.6157962]],3,0.6939890710382514,
22,2,car,van,354,720,443,693,366,250,0.98107594,[[13.69964617]],[[-88.87926979]],3,0.6830601092896175,
23,2,car,van,350,719,446,695,369,249,0.9818381,[[13.89903545]],[[-90.31367511]],3,0.6747967479674797,
24,2,car,van,354,720,442,696,366,254,0.9823021,[[12.99732295]],[[-86.6157962]],3,0.6939890710382514,
25,2,car,van,350,720,444,699,370,255,0.97152954,[[12.80223224]],[[-87.18860737]],3,0.6891891891891891,
26,2,car,van,354,717,444,692,363,248,0.97865987,[[14.0033309]],[[-89.13509799]],3,0.6831955922865014,
27,2,car,van,349,720,444,698,371,254,0.9789437,[[12.97550655]],[[-88.03299612]],3,0.6846361185983828,
28,2,car,van,355,718,442,697,363,255,0.9835155,[[12.81299323]],[[-85.18174273]],3,0.7024793388429752,
29,2,car,van,356,719,444,695,363,251,0.9872646,[[13.49161823]],[[-87.43249881]],3,0.6914600550964187,
30,2,car,van,356,717,445,700,361,255,0.98048055,[[12.79547224]],[[-84.59101244]],3,0.7063711911357341,
31,2,car,van,357,718,443,695,361,252,0.98117363,[[13.29299264]],[[-86.27341276]],3,0.6980609418282548,
32,2,car,van,352,721,444,697,369,253,0.9763852,[[13.1724195]],[[-88.03748403]],3,0.6856368563685636,
33,2,car,van,356,718,441,696,362,255,0.9822874,[[12.80532617]],[[-84.88734094]],3,0.7044198895027625,
34,2,car,van,334,728,450,721,394,271,0.99925107,[[8.08523286]],[[-84.27413386]],3,0.6878172588832487,
35,2,car,van,331,725,449,722,394,273,0.99893653,[[7.6388042]],[[-83.16424404]],3,0.6928934010152284,
36,2,car,van,341,720,440,705,379,265,0.9988129,[[10.62404092]],[[-84.00437658]],3,0.6992084432717678,
0,2,car,van,356,721,443,695,365,252,0.97901255,[[13.34136526]],[[-87.45434795]],3,0.6904109589041096,
1,2,car,van,354,718,444,694,364,250,0.96606976,[[13.67671825]],[[-88.29411521]],3,0.6868131868131868,
2,2,car,van,353,719,444,698,366,254,0.9766162,[[12.99732295]],[[-86.6157962]],3,0.6939890710382514,
3,2,car,van,358,721,442,699,363,257,0.9873583,[[12.47552185]],[[-84.06466875]],3,0.7079889807162535,
4,2,car,van,354,721,447,691,367,244,0.9798042,[[14.78014871]],[[-92.60927844]],3,0.6648501362397821,
5,2,car,van,355,717,443,699,362,256,0.9844455,[[12.63826016]],[[-84.3287104]],3,0.7071823204419889,
6,2,car,van,352,722,445,693,370,248,0.9812132,[[14.08636989]],[[-91.17128691]],3,0.6702702702702703,
7,2,car,van,346,724,462,708,378,246,0.98077375,[[14.43933385]],[[-94.54269717]],3,0.6507936507936508,
8,2,car,van,351,721,445,699,370,254,0.97839665,[[12.9847507]],[[-87.75340956]],3,0.6864864864864865,
9,2,car,van,353,719,446,695,366,249,0.9726562,[[13.87590236]],[[-89.44859821]],3,0.680327868852459,
10,2,car,van,356,718,442,697,362,255,0.97505856,[[12.80532617]],[[-84.88734094]],3,0.7044198895027625,
11,2,car,van,351,721,446,694,370,248,0.9709657,[[14.08636989]],[[-91.17128691]],3,0.6702702702702703,
12,2,car,van,357,718,443,695,361,252,0.98895496,[[13.29299264]],[[-86.27341276]],3,0.6980609418282548,
13,2,car,van,359,716,444,693,357,249,0.97837234,[[13.68912907]],[[-86.74932516]],3,0.6974789915966386,
14,2,car,van,357,720,445,694,363,249,0.9793669,[[13.83252945]],[[-88.56618092]],3,0.6859504132231405,
15,2,car,van,352,717,444,694,365,250,0.9881751,[[13.68929513]],[[-88.58765586]],3,0.684931506849315,
16,2,car,van,355,718,444,696,363,252,0.986651,[[13.32153937]],[[-86.86773377]],3,0.6942148760330579,
17,2,car,van,356,720,446,697,364,251,0.9813424,[[13.50450931]],[[-87.72736771]],3,0.6895604395604396,
18,2,car,van,349,717,443,697,368,254,0.9859856,[[12.99583974]],[[-87.1884563]],3,0.6902173913043478,
19,2,car,van,352,719,444,695,367,251,0.98687744,[[13.52981284]],[[-88.60041414]],3,0.6839237057220708,
20,2,car,van,357,716,446,697,359,251,0.9763643,[[13.41877532]],[[-86.23375612]],3,0.6991643454038997,
21,2,car,van,355,718,445,696,363,251,0.9827555,[[13.49161823]],[[-87.43249881]],3,0.6914600550964187,
22,2,car,van,354,720,443,697,366,254,0.9826344,[[12.99732295]],[[-86.6157962]],3,0.6939890710382514,
23,2,car,van,354,720,443,693,366,250,0.98107594,[[13.69964617]],[[-88.87926979]],3,0.6830601092896175,
24,2,car,van,350,719,446,695,369,249,0.9818381,[[13.89903545]],[[-90.31367511]],3,0.6747967479674797,
25,2,car,van,354,720,442,696,366,254,0.9823021,[[12.99732295]],[[-86.6157962]],3,0.6939890710382514,
26,2,car,van,350,720,444,699,370,255,0.97152954,[[12.80223224]],[[-87.18860737]],3,0.6891891891891891,
27,2,car,van,354,717,444,692,363,248,0.97865987,[[14.0033309]],[[-89.13509799]],3,0.6831955922865014,
28,2,car,van,349,720,444,698,371,254,0.9789437,[[12.97550655]],[[-88.03299612]],3,0.6846361185983828,
29,2,car,van,355,718,442,697,363,255,0.9835155,[[12.81299323]],[[-85.18174273]],3,0.7024793388429752,
30,2,car,van,356,719,444,695,363,251,0.9872646,[[13.49161823]],[[-87.43249881]],3,0.6914600550964187,
31,2,car,van,356,717,445,700,361,255,0.98048055,[[12.79547224]],[[-84.59101244]],3,0.7063711911357341,
32,2,car,van,357,718,443,695,361,252,0.98117363,[[13.29299264]],[[-86.27341276]],3,0.6980609418282548,
33,2,car,van,352,721,444,697,369,253,0.9763852,[[13.1724195]],[[-88.03748403]],3,0.6856368563685636,
34,2,car,van,356,718,441,696,362,255,0.9822874,[[12.80532617]],[[-84.88734094]],3,0.7044198895027625,
35,2,car,van,334,728,450,721,394,271,0.99925107,[[8.08523286]],[[-84.27413386]],3,0.6878172588832487,
36,2,car,van,331,725,449,722,394,273,0.99893653,[[7.6388042]],[[-83.16424404]],3,0.6928934010152284,
37,2,car,van,341,720,440,705,379,265,0.9988129,[[10.62404092]],[[-84.00437658]],3,0.6992084432717678,
0,2,car,van,354,719,445,699,365,254,0.9693228,[[12.99455903]],[[-86.32657609]],3,0.6958904109589041,
1,2,car,van,356,721,443,695,365,252,0.97901255,[[13.34136526]],[[-87.45434795]],3,0.6904109589041096,
2,2,car,van,354,718,444,694,364,250,0.96606976,[[13.67671825]],[[-88.29411521]],3,0.6868131868131868,
3,2,car,van,353,719,444,698,366,254,0.9766162,[[12.99732295]],[[-86.6157962]],3,0.6939890710382514,
4,2,car,van,358,721,442,699,363,257,0.9873583,[[12.47552185]],[[-84.06466875]],3,0.7079889807162535,
5,2,car,van,354,721,447,691,367,244,0.9798042,[[14.78014871]],[[-92.60927844]],3,0.6648501362397821,
6,2,car,van,355,717,443,699,362,256,0.9844455,[[12.63826016]],[[-84.3287104]],3,0.7071823204419889,
7,2,car,van,352,722,445,693,370,248,0.9812132,[[14.08636989]],[[-91.17128691]],3,0.6702702702702703,
8,2,car,van,346,724,462,708,378,246,0.98077375,[[14.43933385]],[[-94.54269717]],3,0.6507936507936508,
9,2,car,van,351,721,445,699,370,254,0.97839665,[[12.9847507]],[[-87.75340956]],3,0.6864864864864865,
10,2,car,van,353,719,446,695,366,249,0.9726562,[[13.87590236]],[[-89.44859821]],3,0.680327868852459,
11,2,car,van,356,718,442,697,362,255,0.97505856,[[12.80532617]],[[-84.88734094]],3,0.7044198895027625,
12,2,car,van,351,721,446,694,370,248,0.9709657,[[14.08636989]],[[-91.17128691]],3,0.6702702702702703,
13,2,car,van,357,718,443,695,361,252,0.98895496,[[13.29299264]],[[-86.27341276]],3,0.6980609418282548,
14,2,car,van,359,716,444,693,357,249,0.97837234,[[13.68912907]],[[-86.74932516]],3,0.6974789915966386,
15,2,car,van,357,720,445,694,363,249,0.9793669,[[13.83252945]],[[-88.56618092]],3,0.6859504132231405,
16,2,car,van,352,717,444,694,365,250,0.9881751,[[13.68929513]],[[-88.58765586]],3,0.684931506849315,
17,2,car,van,355,718,444,696,363,252,0.986651,[[13.32153937]],[[-86.86773377]],3,0.6942148760330579,
18,2,car,van,356,720,446,697,364,251,0.9813424,[[13.50450931]],[[-87.72736771]],3,0.6895604395604396,
19,2,car,van,349,717,443,697,368,254,0.9859856,[[12.99583974]],[[-87.1884563]],3,0.6902173913043478,
20,2,car,van,352,719,444,695,367,251,0.98687744,[[13.52981284]],[[-88.60041414]],3,0.6839237057220708,
21,2,car,van,357,716,446,697,359,251,0.9763643,[[13.41877532]],[[-86.23375612]],3,0.6991643454038997,
22,2,car,van,355,718,445,696,363,251,0.9827555,[[13.49161823]],[[-87.43249881]],3,0.6914600550964187,
23,2,car,van,354,720,443,697,366,254,0.9826344,[[12.99732295]],[[-86.6157962]],3,0.6939890710382514,
24,2,car,van,354,720,443,693,366,250,0.98107594,[[13.69964617]],[[-88.87926979]],3,0.6830601092896175,
25,2,car,van,350,719,446,695,369,249,0.9818381,[[13.89903545]],[[-90.31367511]],3,0.6747967479674797,
26,2,car,van,354,720,442,696,366,254,0.9823021,[[12.99732295]],[[-86.6157962]],3,0.6939890710382514,
27,2,car,van,350,720,444,699,370,255,0.97152954,[[12.80223224]],[[-87.18860737]],3,0.6891891891891891,
28,2,car,van,354,717,444,692,363,248,0.97865987,[[14.0033309]],[[-89.13509799]],3,0.6831955922865014,
29,2,car,van,349,720,444,698,371,254,0.9789437,[[12.97550655]],[[-88.03299612]],3,0.6846361185983828,
30,2,car,van,355,718,442,697,363,255,0.9835155,[[12.81299323]],[[-85.18174273]],3,0.7024793388429752,
31,2,car,van,356,719,444,695,363,251,0.9872646,[[13.49161823]],[[-87.43249881]],3,0.6914600550964187,
32,2,car,van,356,717,445,700,361,255,0.98048055,[[12.79547224]],[[-84.59101244]],3,0.7063711911357341,
33,2,car,van,357,718,443,695,361,252,0.98117363,[[13.29299264]],[[-86.27341276]],3,0.6980609418282548,
34,2,car,van,352,721,444,697,369,253,0.9763852,[[13.1724195]],[[-88.03748403]],3,0.6856368563685636,
35,2,car,van,356,718,441,696,362,255,0.9822874,[[12.80532617]],[[-84.88734094]],3,0.7044198895027625,
36,2,car,van,334,728,450,721,394,271,0.99925107,[[8.08523286]],[[-84.27413386]],3,0.6878172588832487,
37,2,car,van,331,725,449,722,394,273,0.99893653,[[7.6388042]],[[-83.16424404]],3,0.6928934010152284,
38,2,car,van,341,720,440,705,379,265,0.9988129,[[10.62404092]],[[-84.00437658]],3,0.6992084432717678,
0,2,car,van,357,719,444,697,362,253,0.9792671,[[13.14037974]],[[-86.00875405]],3,0.6988950276243094,
1,2,car,van,354,719,445,699,365,254,0.9693228,[[12.99455903]],[[-86.32657609]],3,0.6958904109589041,
2,2,car,van,356,721,443,695,365,252,0.97901255,[[13.34136526]],[[-87.45434795]],3,0.6904109589041096,
3,2,car,van,354,718,444,694,364,250,0.96606976,[[13.67671825]],[[-88.29411521]],3,0.6868131868131868,
4,2,car,van,353,719,444,698,366,254,0.9766162,[[12.99732295]],[[-86.6157962]],3,0.6939890710382514,
5,2,car,van,358,721,442,699,363,257,0.9873583,[[12.47552185]],[[-84.06466875]],3,0.7079889807162535,
6,2,car,van,354,721,447,691,367,244,0.9798042,[[14.78014871]],[[-92.60927844]],3,0.6648501362397821,
7,2,car,van,355,717,443,699,362,256,0.9844455,[[12.63826016]],[[-84.3287104]],3,0.7071823204419889,
8,2,car,van,352,722,445,693,370,248,0.9812132,[[14.08636989]],[[-91.17128691]],3,0.6702702702702703,
9,2,car,van,346,724,462,708,378,246,0.98077375,[[14.43933385]],[[-94.54269717]],3,0.6507936507936508,
10,2,car,van,351,721,445,699,370,254,0.97839665,[[12.9847507]],[[-87.75340956]],3,0.6864864864864865,
11,2,car,van,353,719,446,695,366,249,0.9726562,[[13.87590236]],[[-89.44859821]],3,0.680327868852459,
12,2,car,van,356,718,442,697,362,255,0.97505856,[[12.80532617]],[[-84.88734094]],3,0.7044198895027625,
13,2,car,van,351,721,446,694,370,248,0.9709657,[[14.08636989]],[[-91.17128691]],3,0.6702702702702703,
14,2,car,van,357,718,443,695,361,252,0.98895496,[[13.29299264]],[[-86.27341276]],3,0.6980609418282548,
15,2,car,van,359,716,444,693,357,249,0.97837234,[[13.68912907]],[[-86.74932516]],3,0.6974789915966386,
16,2,car,van,357,720,445,694,363,249,0.9793669,[[13.83252945]],[[-88.56618092]],3,0.6859504132231405,
17,2,car,van,352,717,444,694,365,250,0.9881751,[[13.68929513]],[[-88.58765586]],3,0.684931506849315,
18,2,car,van,355,718,444,696,363,252,0.986651,[[13.32153937]],[[-86.86773377]],3,0.6942148760330579,
19,2,car,van,356,720,446,697,364,251,0.9813424,[[13.50450931]],[[-87.72736771]],3,0.6895604395604396,
20,2,car,van,349,717,443,697,368,254,0.9859856,[[12.99583974]],[[-87.1884563]],3,0.6902173913043478,
21,2,car,van,352,719,444,695,367,251,0.98687744,[[13.52981284]],[[-88.60041414]],3,0.6839237057220708,
22,2,car,van,357,716,446,697,359,251,0.9763643,[[13.41877532]],[[-86.23375612]],3,0.6991643454038997,
23,2,car,van,355,718,445,696,363,251,0.9827555,[[13.49161823]],[[-87.43249881]],3,0.6914600550964187,
24,2,car,van,354,720,443,697,366,254,0.9826344,[[12.99732295]],[[-86.6157962]],3,0.6939890710382514,
25,2,car,van,354,720,443,693,366,250,0.98107594,[[13.69964617]],[[-88.87926979]],3,0.6830601092896175,
26,2,car,van,350,719,446,695,369,249,0.9818381,[[13.89903545]],[[-90.31367511]],3,0.6747967479674797,
27,2,car,van,354,720,442,696,366,254,0.9823021,[[12.99732295]],[[-86.6157962]],3,0.6939890710382514,
28,2,car,van,350,720,444,699,370,255,0.97152954,[[12.80223224]],[[-87.18860737]],3,0.6891891891891891,
29,2,car,van,354,717,444,692,363,248,0.97865987,[[14.0033309]],[[-89.13509799]],3,0.6831955922865014,
30,2,car,van,349,720,444,698,371,254,0.9789437,[[12.97550655]],[[-88.03299612]],3,0.6846361185983828,
31,2,car,van,355,718,442,697,363,255,0.9835155,[[12.81299323]],[[-85.18174273]],3,0.7024793388429752,
32,2,car,van,356,719,444,695,363,251,0.9872646,[[13.49161823]],[[-87.43249881]],3,0.6914600550964187,
33,2,car,van,356,717,445,700,361,255,0.98048055,[[12.79547224]],[[-84.59101244]],3,0.7063711911357341,
34,2,car,van,357,718,443,695,361,252,0.98117363,[[13.29299264]],[[-86.27341276]],3,0.6980609418282548,
35,2,car,van,352,721,444,697,369,253,0.9763852,[[13.1724195]],[[-88.03748403]],3,0.6856368563685636,
36,2,car,van,356,718,441,696,362,255,0.9822874,[[12.80532617]],[[-84.88734094]],3,0.7044198895027625,
37,2,car,van,334,728,450,721,394,271,0.99925107,[[8.08523286]],[[-84.27413386]],3,0.6878172588832487,
38,2,car,van,331,725,449,722,394,273,0.99893653,[[7.6388042]],[[-83.16424404]],3,0.6928934010152284,
39,2,car,van,341,720,440,705,379,265,0.9988129,[[10.62404092]],[[-84.00437658]],3,0.6992084432717678,
0,2,car,van,353,721,445,697,368,252,0.9697111,[[13.35408872]],[[-88.31981889]],3,0.6847826086956522,
1,2,car,van,357,719,444,697,362,253,0.9792671,[[13.14037974]],[[-86.00875405]],3,0.6988950276243094,
2,2,car,van,354,719,445,699,365,254,0.9693228,[[12.99455903]],[[-86.32657609]],3,0.6958904109589041,
3,2,car,van,356,721,443,695,365,252,0.97901255,[[13.34136526]],[[-87.45434795]],3,0.6904109589041096,
4,2,car,van,354,718,444,694,364,250,0.96606976,[[13.67671825]],[[-88.29411521]],3,0.6868131868131868,
5,2,car,van,353,719,444,698,366,254,0.9766162,[[12.99732295]],[[-86.6157962]],3,0.6939890710382514,
6,2,car,van,358,721,442,699,363,257,0.9873583,[[12.47552185]],[[-84.06466875]],3,0.7079889807162535,
7,2,car,van,354,721,447,691,367,244,0.9798042,[[14.78014871]],[[-92.60927844]],3,0.6648501362397821,
8,2,car,van,355,717,443,699,362,256,0.9844455,[[12.63826016]],[[-84.3287104]],3,0.7071823204419889,
9,2,car,van,352,722,445,693,370,248,0.9812132,[[14.08636989]],[[-91.17128691]],3,0.6702702702702703,
10,2,car,van,346,724,462,708,378,246,0.98077375,[[14.43933385]],[[-94.54269717]],3,0.6507936507936508,
11,2,car,van,351,721,445,699,370,254,0.97839665,[[12.9847507]],[[-87.75340956]],3,0.6864864864864865,
12,2,car,van,353,719,446,695,366,249,0.9726562,[[13.87590236]],[[-89.44859821]],3,0.680327868852459,
13,2,car,van,356,718,442,697,362,255,0.97505856,[[12.80532617]],[[-84.88734094]],3,0.7044198895027625,
14,2,car,van,351,721,446,694,370,248,0.9709657,[[14.08636989]],[[-91.17128691]],3,0.6702702702702703,
15,2,car,van,357,718,443,695,361,252,0.98895496,[[13.29299264]],[[-86.27341276]],3,0.6980609418282548,
16,2,car,van,359,716,444,693,357,249,0.97837234,[[13.68912907]],[[-86.74932516]],3,0.6974789915966386,
17,2,car,van,357,720,445,694,363,249,0.9793669,[[13.83252945]],[[-88.56618092]],3,0.6859504132231405,
18,2,car,van,352,717,444,694,365,250,0.9881751,[[13.68929513]],[[-88.58765586]],3,0.684931506849315,
19,2,car,van,355,718,444,696,363,252,0.986651,[[13.32153937]],[[-86.86773377]],3,0.6942148760330579,
20,2,car,van,356,720,446,697,364,251,0.9813424,[[13.50450931]],[[-87.72736771]],3,0.6895604395604396,
21,2,car,van,349,717,443,697,368,254,0.9859856,[[12.99583974]],[[-87.1884563]],3,0.6902173913043478,
22,2,car,van,352,719,444,695,367,251,0.98687744,[[13.52981284]],[[-88.60041414]],3,0.6839237057220708,
23,2,car,van,357,716,446,697,359,251,0.9763643,[[13.41877532]],[[-86.23375612]],3,0.6991643454038997,
24,2,car,van,355,718,445,696,363,251,0.9827555,[[13.49161823]],[[-87.43249881]],3,0.6914600550964187,
25,2,car,van,354,720,443,697,366,254,0.9826344,[[12.99732295]],[[-86.6157962]],3,0.6939890710382514,
26,2,car,van,354,720,443,693,366,250,0.98107594,[[13.69964617]],[[-88.87926979]],3,0.6830601092896175,
27,2,car,van,350,719,446,695,369,249,0.9818381,[[13.89903545]],[[-90.31367511]],3,0.6747967479674797,
28,2,car,van,354,720,442,696,366,254,0.9823021,[[12.99732295]],[[-86.6157962]],3,0.6939890710382514,
29,2,car,van,350,720,444,699,370,255,0.97152954,[[12.80223224]],[[-87.18860737]],3,0.6891891891891891,
30,2,car,van,354,717,444,692,363,248,0.97865987,[[14.0033309]],[[-89.13509799]],3,0.6831955922865014,
31,2,car,van,349,720,444,698,371,254,0.9789437,[[12.97550655]],[[-88.03299612]],3,0.6846361185983828,
32,2,car,van,355,718,442,697,363,255,0.9835155,[[12.81299323]],[[-85.18174273]],3,0.7024793388429752,
33,2,car,van,356,719,444,695,363,251,0.9872646,[[13.49161823]],[[-87.43249881]],3,0.6914600550964187,
34,2,car,van,356,717,445,700,361,255,0.98048055,[[12.79547224]],[[-84.59101244]],3,0.7063711911357341,
35,2,car,van,357,718,443,695,361,252,0.98117363,[[13.29299264]],[[-86.27341276]],3,0.6980609418282548,
36,2,car,van,352,721,444,697,369,253,0.9763852,[[13.1724195]],[[-88.03748403]],3,0.6856368563685636,
37,2,car,van,356,718,441,696,362,255,0.9822874,[[12.80532617]],[[-84.88734094]],3,0.7044198895027625,
38,2,car,van,334,728,450,721,394,271,0.99925107,[[8.08523286]],[[-84.27413386]],3,0.6878172588832487,
39,2,car,van,331,725,449,722,394,273,0.99893653,[[7.6388042]],[[-83.16424404]],3,0.6928934010152284,
40,2,car,van,341,720,440,705,379,265,0.9988129,[[10.62404092]],[[-84.00437658]],3,0.6992084432717678,
0,2,car,van,357,720,443,695,363,252,0.9910357,[[13.32153937]],[[-86.86773377]],3,0.6942148760330579,
1,2,car,van,353,721,445,697,368,252,0.9697111,[[13.35408872]],[[-88.31981889]],3,0.6847826086956522,
2,2,car,van,357,719,444,697,362,253,0.9792671,[[13.14037974]],[[-86.00875405]],3,0.6988950276243094,
3,2,car,van,354,719,445,699,365,254,0.9693228,[[12.99455903]],[[-86.32657609]],3,0.6958904109589041,
4,2,car,van,356,721,443,695,365,252,0.97901255,[[13.34136526]],[[-87.45434795]],3,0.6904109589041096,
5,2,car,van,354,718,444,694,364,250,0.96606976,[[13.67671825]],[[-88.29411521]],3,0.6868131868131868,
6,2,car,van,353,719,444,698,366,254,0.9766162,[[12.99732295]],[[-86.6157962]],3,0.6939890710382514,
7,2,car,van,358,721,442,699,363,257,0.9873583,[[12.47552185]],[[-84.06466875]],3,0.7079889807162535,
8,2,car,van,354,721,447,691,367,244,0.9798042,[[14.78014871]],[[-92.60927844]],3,0.6648501362397821,
9,2,car,van,355,717,443,699,362,256,0.9844455,[[12.63826016]],[[-84.3287104]],3,0.7071823204419889,
10,2,car,van,352,722,445,693,370,248,0.9812132,[[14.08636989]],[[-91.17128691]],3,0.6702702702702703,
11,2,car,van,346,724,462,708,378,246,0.98077375,[[14.43933385]],[[-94.54269717]],3,0.6507936507936508,
12,2,car,van,351,721,445,699,370,254,0.97839665,[[12.9847507]],[[-87.75340956]],3,0.6864864864864865,
13,2,car,van,353,719,446,695,366,249,0.9726562,[[13.87590236]],[[-89.44859821]],3,0.680327868852459,
14,2,car,van,356,718,442,697,362,255,0.97505856,[[12.80532617]],[[-84.88734094]],3,0.7044198895027625,
15,2,car,van,351,721,446,694,370,248,0.9709657,[[14.08636989]],[[-91.17128691]],3,0.6702702702702703,
16,2,car,van,357,718,443,695,361,252,0.98895496,[[13.29299264]],[[-86.27341276]],3,0.6980609418282548,
17,2,car,van,359,716,444,693,357,249,0.97837234,[[13.68912907]],[[-86.74932516]],3,0.6974789915966386,
18,2,car,van,357,720,445,694,363,249,0.9793669,[[13.83252945]],[[-88.56618092]],3,0.6859504132231405,
19,2,car,van,352,717,444,694,365,250,0.9881751,[[13.68929513]],[[-88.58765586]],3,0.684931506849315,
20,2,car,van,355,718,444,696,363,252,0.986651,[[13.32153937]],[[-86.86773377]],3,0.6942148760330579,
21,2,car,van,356,720,446,697,364,251,0.9813424,[[13.50450931]],[[-87.72736771]],3,0.6895604395604396,
22,2,car,van,349,717,443,697,368,254,0.9859856,[[12.99583974]],[[-87.1884563]],3,0.6902173913043478,
23,2,car,van,352,719,444,695,367,251,0.98687744,[[13.52981284]],[[-88.60041414]],3,0.6839237057220708,
24,2,car,van,357,716,446,697,359,251,0.9763643,[[13.41877532]],[[-86.23375612]],3,0.6991643454038997,
25,2,car,van,355,718,445,696,363,251,0.9827555,[[13.49161823]],[[-87.43249881]],3,0.6914600550964187,
26,2,car,van,354,720,443,697,366,254,0.9826344,[[12.99732295]],[[-86.6157962]],3,0.6939890710382514,
27,2,car,van,354,720,443,693,366,250,0.98107594,[[13.69964617]],[[-88.87926979]],3,0.6830601092896175,
28,2,car,van,350,719,446,695,369,249,0.9818381,[[13.89903545]],[[-90.31367511]],3,0.6747967479674797,
29,2,car,van,354,720,442,696,366,254,0.9823021,[[12.99732295]],[[-86.6157962]],3,0.6939890710382514,
30,2,car,van,350,720,444,699,370,255,0.97152954,[[12.80223224]],[[-87.18860737]],3,0.6891891891891891,
31,2,car,van,354,717,444,692,363,248,0.97865987,[[14.0033309]],[[-89.13509799]],3,0.6831955922865014,
32,2,car,van,349,720,444,698,371,254,0.9789437,[[12.97550655]],[[-88.03299612]],3,0.6846361185983828,
33,2,car,van,355,718,442,697,363,255,0.9835155,[[12.81299323]],[[-85.18174273]],3,0.7024793388429752,
34,2,car,van,356,719,444,695,363,251,0.9872646,[[13.49161823]],[[-87.43249881]],3,0.6914600550964187,
35,2,car,van,356,717,445,700,361,255,0.98048055,[[12.79547224]],[[-84.59101244]],3,0.7063711911357341,
36,2,car,van,357,718,443,695,361,252,0.98117363,[[13.29299264]],[[-86.27341276]],3,0.6980609418282548,
37,2,car,van,352,721,444,697,369,253,0.9763852,[[13.1724195]],[[-88.03748403]],3,0.6856368563685636,
38,2,car,van,356,718,441,696,362,255,0.9822874,[[12.80532617]],[[-84.88734094]],3,0.7044198895027625,
39,2,car,van,334,728,450,721,394,271,0.99925107,[[8.08523286]],[[-84.27413386]],3,0.6878172588832487,
40,2,car,van,331,725,449,722,394,273,0.99893653,[[7.6388042]],[[-83.16424404]],3,0.6928934010152284,
41,2,car,van,341,720,440,705,379,265,0.9988129,[[10.62404092]],[[-84.00437658]],3,0.6992084432717678,
0,2,car,van,356,721,443,699,365,256,0.9829204,[[12.64899837]],[[-85.20434027]],3,0.7013698630136986,
1,2,car,van,357,720,443,695,363,252,0.9910357,[[13.32153937]],[[-86.86773377]],3,0.6942148760330579,
2,2,car,van,353,721,445,697,368,252,0.9697111,[[13.35408872]],[[-88.31981889]],3,0.6847826086956522,
3,2,car,van,357,719,444,697,362,253,0.9792671,[[13.14037974]],[[-86.00875405]],3,0.6988950276243094,
4,2,car,van,354,719,445,699,365,254,0.9693228,[[12.99455903]],[[-86.32657609]],3,0.6958904109589041,
5,2,car,van,356,721,443,695,365,252,0.97901255,[[13.34136526]],[[-87.45434795]],3,0.6904109589041096,
6,2,car,van,354,718,444,694,364,250,0.96606976,[[13.67671825]],[[-88.29411521]],3,0.6868131868131868,
7,2,car,van,353,719,444,698,366,254,0.9766162,[[12.99732295]],[[-86.6157962]],3,0.6939890710382514,
8,2,car,van,358,721,442,699,363,257,0.9873583,[[12.47552185]],[[-84.06466875]],3,0.7079889807162535,
9,2,car,van,354,721,447,691,367,244,0.9798042,[[14.78014871]],[[-92.60927844]],3,0.6648501362397821,
10,2,car,van,355,717,443,699,362,256,0.9844455,[[12.63826016]],[[-84.3287104]],3,0.7071823204419889,
11,2,car,van,352,722,445,693,370,248,0.9812132,[[14.08636989]],[[-91.17128691]],3,0.6702702702702703,
12,2,car,van,346,724,462,708,378,246,0.98077375,[[14.43933385]],[[-94.54269717]],3,0.6507936507936508,
13,2,car,van,351,721,445,699,370,254,0.97839665,[[12.9847507]],[[-87.75340956]],3,0.6864864864864865,
14,2,car,van,353,719,446,695,366,249,0.9726562,[[13.87590236]],[[-89.44859821]],3,0.680327868852459,
15,2,car,van,356,718,442,697,362,255,0.97505856,[[12.80532617]],[[-84.88734094]],3,0.7044198895027625,
16,2,car,van,351,721,446,694,370,248,0.9709657,[[14.08636989]],[[-91.17128691]],3,0.6702702702702703,
17,2,car,van,357,718,443,695,361,252,0.98895496,[[13.29299264]],[[-86.27341276]],3,0.6980609418282548,
18,2,car,van,359,716,444,693,357,249,0.97837234,[[13.68912907]],[[-86.74932516]],3,0.6974789915966386,
19,2,car,van,357,720,445,694,363,249,0.9793669,[[13.83252945]],[[-88.56618092]],3,0.6859504132231405,
20,2,car,van,352,717,444,694,365,250,0.9881751,[[13.68929513]],[[-88.58765586]],3,0.684931506849315,
21,2,car,van,355,718,444,696,363,252,0.986651,[[13.32153937]],[[-86.86773377]],3,0.6942148760330579,
22,2,car,van,356,720,446,697,364,251,0.9813424,[[13.50450931]],[[-87.72736771]],3,0.6895604395604396,
23,2,car,van,349,717,443,697,368,254,0.9859856,[[12.99583974]],[[-87.1884563]],3,0.6902173913043478,
24,2,car,van,352,719,444,695,367,251,0.98687744,[[13.52981284]],[[-88.60041414]],3,0.6839237057220708,
25,2,car,van,357,716,446,697,359,251,0.9763643,[[13.41877532]],[[-86.23375612]],3,0.6991643454038997,
26,2,car,van,355,718,445,696,363,251,0.9827555,[[13.49161823]],[[-87.43249881]],3,0.6914600550964187,
27,2,car,van,354,720,443,697,366,254,0.9826344,[[12.99732295]],[[-86.6157962]],3,0.6939890710382514,
28,2,car,van,354,720,443,693,366,250,0.98107594,[[13.69964617]],[[-88.87926979]],3,0.6830601092896175,
29,2,car,van,350,719,446,695,369,249,0.9818381,[[13.89903545]],[[-90.31367511]],3,0.6747967479674797,
30,2,car,van,354,720,442,696,366,254,0.9823021,[[12.99732295]],[[-86.6157962]],3,0.6939890710382514,
31,2,car,van,350,720,444,699,370,255,0.97152954,[[12.80223224]],[[-87.18860737]],3,0.6891891891891891,
32,2,car,van,354,717,444,692,363,248,0.97865987,[[14.0033309]],[[-89.13509799]],3,0.6831955922865014,
33,2,car,van,349,720,444,698,371,254,0.9789437,[[12.97550655]],[[-88.03299612]],3,0.6846361185983828,
34,2,car,van,355,718,442,697,363,255,0.9835155,[[12.81299323]],[[-85.18174273]],3,0.7024793388429752,
35,2,car,van,356,719,444,695,363,251,0.9872646,[[13.49161823]],[[-87.43249881]],3,0.6914600550964187,
36,2,car,van,356,717,445,700,361,255,0.98048055,[[12.79547224]],[[-84.59101244]],3,0.7063711911357341,
37,2,car,van,357,718,443,695,361,252,0.98117363,[[13.29299264]],[[-86.27341276]],3,0.6980609418282548,
38,2,car,van,352,721,444,697,369,253,0.9763852,[[13.1724195]],[[-88.03748403]],3,0.6856368563685636,
39,2,car,van,356,718,441,696,362,255,0.9822874,[[12.80532617]],[[-84.88734094]],3,0.7044198895027625,
40,2,car,van,334,728,450,721,394,271,0.99925107,[[8.08523286]],[[-84.27413386]],3,0.6878172588832487,
41,2,car,van,331,725,449,722,394,273,0.99893653,[[7.6388042]],[[-83.16424404]],3,0.6928934010152284,
42,2,car,van,341,720,440,705,379,265,0.9988129,[[10.62404092]],[[-84.00437658]],3,0.6992084432717678,
0,2,car,van,356,719,446,694,363,248,0.9840417,[[14.0033309]],[[-89.13509799]],3,0.6831955922865014,
1,2,car,van,356,721,443,699,365,256,0.9829204,[[12.64899837]],[[-85.20434027]],3,0.7013698630136986,
2,2,car,van,357,720,443,695,363,252,0.9910357,[[13.32153937]],[[-86.86773377]],3,0.6942148760330579,
3,2,car,van,353,721,445,697,368,252,0.9697111,[[13.35408872]],[[-88.31981889]],3,0.6847826086956522,
4,2,car,van,357,719,444,697,362,253,0.9792671,[[13.14037974]],[[-86.00875405]],3,0.6988950276243094,
5,2,car,van,354,719,445,699,365,254,0.9693228,[[12.99455903]],[[-86.32657609]],3,0.6958904109589041,
6,2,car,van,356,721,443,695,365,252,0.97901255,[[13.34136526]],[[-87.45434795]],3,0.6904109589041096,
7,2,car,van,354,718,444,694,364,250,0.96606976,[[13.67671825]],[[-88.29411521]],3,0.6868131868131868,
8,2,car,van,353,719,444,698,366,254,0.9766162,[[12.99732295]],[[-86.6157962]],3,0.6939890710382514,
9,2,car,van,358,721,442,699,363,257,0.9873583,[[12.47552185]],[[-84.06466875]],3,0.7079889807162535,
10,2,car,van,354,721,447,691,367,244,0.9798042,[[14.78014871]],[[-92.60927844]],3,0.6648501362397821,
11,2,car,van,355,717,443,699,362,256,0.9844455,[[12.63826016]],[[-84.3287104]],3,0.7071823204419889,
12,2,car,van,352,722,445,693,370,248,0.9812132,[[14.08636989]],[[-91.17128691]],3,0.6702702702702703,
13,2,car,van,346,724,462,708,378,246,0.98077375,[[14.43933385]],[[-94.54269717]],3,0.6507936507936508,
14,2,car,van,351,721,445,699,370,254,0.97839665,[[12.9847507]],[[-87.75340956]],3,0.6864864864864865,
15,2,car,van,353,719,446,695,366,249,0.9726562,[[13.87590236]],[[-89.44859821]],3,0.680327868852459,
16,2,car,van,356,718,442,697,362,255,0.97505856,[[12.80532617]],[[-84.88734094]],3,0.7044198895027625,
17,2,car,van,351,721,446,694,370,248,0.9709657,[[14.08636989]],[[-91.17128691]],3,0.6702702702702703,
18,2,car,van,357,718,443,695,361,252,0.98895496,[[13.29299264]],[[-86.27341276]],3,0.6980609418282548,
19,2,car,van,359,716,444,693,357,249,0.97837234,[[13.68912907]],[[-86.74932516]],3,0.6974789915966386,
20,2,car,van,357,720,445,694,363,249,0.9793669,[[13.83252945]],[[-88.56618092]],3,0.6859504132231405,
21,2,car,van,352,717,444,694,365,250,0.9881751,[[13.68929513]],[[-88.58765586]],3,0.684931506849315,
22,2,car,van,355,718,444,696,363,252,0.986651,[[13.32153937]],[[-86.86773377]],3,0.6942148760330579,
23,2,car,van,356,720,446,697,364,251,0.9813424,[[13.50450931]],[[-87.72736771]],3,0.6895604395604396,
24,2,car,van,349,717,443,697,368,254,0.9859856,[[12.99583974]],[[-87.1884563]],3,0.6902173913043478,
25,2,car,van,352,719,444,695,367,251,0.98687744,[[13.52981284]],[[-88.60041414]],3,0.6839237057220708,
26,2,car,van,357,716,446,697,359,251,0.9763643,[[13.41877532]],[[-86.23375612]],3,0.6991643454038997,
27,2,car,van,355,718,445,696,363,251,0.9827555,[[13.49161823]],[[-87.43249881]],3,0.6914600550964187,
28,2,car,van,354,720,443,697,366,254,0.9826344,[[12.99732295]],[[-86.6157962]],3,0.6939890710382514,
29,2,car,van,354,720,443,693,366,250,0.98107594,[[13.69964617]],[[-88.87926979]],3,0.6830601092896175,
30,2,car,van,350,719,446,695,369,249,0.9818381,[[13.89903545]],[[-90.31367511]],3,0.6747967479674797,
31,2,car,van,354,720,442,696,366,254,0.9823021,[[12.99732295]],[[-86.6157962]],3,0.6939890710382514,
32,2,car,van,350,720,444,699,370,255,0.97152954,[[12.80223224]],[[-87.18860737]],3,0.6891891891891891,
33,2,car,van,354,717,444,692,363,248,0.97865987,[[14.0033309]],[[-89.13509799]],3,0.6831955922865014,
34,2,car,van,349,720,444,698,371,254,0.9789437,[[12.97550655]],[[-88.03299612]],3,0.6846361185983828,
35,2,car,van,355,718,442,697,363,255,0.9835155,[[12.81299323]],[[-85.18174273]],3,0.7024793388429752,
36,2,car,van,356,719,444,695,363,251,0.9872646,[[13.49161823]],[[-87.43249881]],3,0.6914600550964187,
37,2,car,van,356,717,445,700,361,255,0.98048055,[[12.79547224]],[[-84.59101244]],3,0.7063711911357341,
38,2,car,van,357,718,443,695,361,252,0.98117363,[[13.29299264]],[[-86.27341276]],3,0.6980609418282548,
39,2,car,van,352,721,444,697,369,253,0.9763852,[[13.1724195]],[[-88.03748403]],3,0.6856368563685636,
40,2,car,van,356,718,441,696,362,255,0.9822874,[[12.80532617]],[[-84.88734094]],3,0.7044198895027625,
41,2,car,van,334,728,450,721,394,271,0.99925107,[[8.08523286]],[[-84.27413386]],3,0.6878172588832487,
42,2,car,van,331,725,449,722,394,273,0.99893653,[[7.6388042]],[[-83.16424404]],3,0.6928934010152284,
43,2,car,van,341,720,440,705,379,265,0.9988129,[[10.62404092]],[[-84.00437658]],3,0.6992084432717678,
0,2,car,van,351,719,443,693,368,250,0.98112077,[[13.71351832]],[[-89.45671752]],3,0.6793478260869565,
1,2,car,van,356,719,446,694,363,248,0.9840417,[[14.0033309]],[[-89.13509799]],3,0.6831955922865014,
2,2,car,van,356,721,443,699,365,256,0.9829204,[[12.64899837]],[[-85.20434027]],3,0.7013698630136986,
3,2,car,van,357,720,443,695,363,252,0.9910357,[[13.32153937]],[[-86.86773377]],3,0.6942148760330579,
4,2,car,van,353,721,445,697,368,252,0.9697111,[[13.35408872]],[[-88.31981889]],3,0.6847826086956522,
5,2,car,van,357,719,444,697,362,253,0.9792671,[[13.14037974]],[[-86.00875405]],3,0.6988950276243094,
6,2,car,van,354,719,445,699,365,254,0.9693228,[[12.99455903]],[[-86.32657609]],3,0.6958904109589041,
7,2,car,van,356,721,443,695,365,252,0.97901255,[[13.34136526]],[[-87.45434795]],3,0.6904109589041096,
8,2,car,van,354,718,444,694,364,250,0.96606976,[[13.67671825]],[[-88.29411521]],3,0.6868131868131868,
9,2,car,van,353,719,444,698,366,254,0.9766162,[[12.99732295]],[[-86.6157962]],3,0.6939890710382514,
10,2,car,van,358,721,442,699,363,257,0.9873583,[[12.47552185]],[[-84.06466875]],3,0.7079889807162535,
11,2,car,van,354,721,447,691,367,244,0.9798042,[[14.78014871]],[[-92.60927844]],3,0.6648501362397821,
12,2,car,van,355,717,443,699,362,256,0.9844455,[[12.63826016]],[[-84.3287104]],3,0.7071823204419889,
13,2,car,van,352,722,445,693,370,248,0.9812132,[[14.08636989]],[[-91.17128691]],3,0.6702702702702703,
14,2,car,van,346,724,462,708,378,246,0.98077375,[[14.43933385]],[[-94.54269717]],3,0.6507936507936508,
15,2,car,van,351,721,445,699,370,254,0.97839665,[[12.9847507]],[[-87.75340956]],3,0.6864864864864865,
16,2,car,van,353,719,446,695,366,249,0.9726562,[[13.87590236]],[[-89.44859821]],3,0.680327868852459,
17,2,car,van,356,718,442,697,362,255,0.97505856,[[12.80532617]],[[-84.88734094]],3,0.7044198895027625,
18,2,car,van,351,721,446,694,370,248,0.9709657,[[14.08636989]],[[-91.17128691]],3,0.6702702702702703,
19,2,car,van,357,718,443,695,361,252,0.98895496,[[13.29299264]],[[-86.27341276]],3,0.6980609418282548,
20,2,car,van,359,716,444,693,357,249,0.97837234,[[13.68912907]],[[-86.74932516]],3,0.6974789915966386,
21,2,car,van,357,720,445,694,363,249,0.9793669,[[13.83252945]],[[-88.56618092]],3,0.6859504132231405,
22,2,car,van,352,717,444,694,365,250,0.9881751,[[13.68929513]],[[-88.58765586]],3,0.684931506849315,
23,2,car,van,355,718,444,696,363,252,0.986651,[[13.32153937]],[[-86.86773377]],3,0.6942148760330579,
24,2,car,van,356,720,446,697,364,251,0.9813424,[[13.50450931]],[[-87.72736771]],3,0.6895604395604396,
25,2,car,van,349,717,443,697,368,254,0.9859856,[[12.99583974]],[[-87.1884563]],3,0.6902173913043478,
26,2,car,van,352,719,444,695,367,251,0.98687744,[[13.52981284]],[[-88.60041414]],3,0.6839237057220708,
27,2,car,van,357,716,446,697,359,251,0.9763643,[[13.41877532]],[[-86.23375612]],3,0.6991643454038997,
28,2,car,van,355,718,445,696,363,251,0.9827555,[[13.49161823]],[[-87.43249881]],3,0.6914600550964187,
29,2,car,van,354,720,443,697,366,254,0.9826344,[[12.99732295]],[[-86.6157962]],3,0.6939890710382514,
30,2,car,van,354,720,443,693,366,250,0.98107594,[[13.69964617]],[[-88.87926979]],3,0.6830601092896175,
31,2,car,van,350,719,446,695,369,249,0.9818381,[[13.89903545]],[[-90.31367511]],3,0.6747967479674797,
32,2,car,van,354,720,442,696,366,254,0.9823021,[[12.99732295]],[[-86.6157962]],3,0.6939890710382514,
33,2,car,van,350,720,444,699,370,255,0.97152954,[[12.80223224]],[[-87.18860737]],3,0.6891891891891891,
34,2,car,van,354,717,444,692,363,248,0.97865987,[[14.0033309]],[[-89.13509799]],3,0.6831955922865014,
35,2,car,van,349,720,444,698,371,254,0.9789437,[[12.97550655]],[[-88.03299612]],3,0.6846361185983828,
36,2,car,van,355,718,442,697,363,255,0.9835155,[[12.81299323]],[[-85.18174273]],3,0.7024793388429752,
37,2,car,van,356,719,444,695,363,251,0.9872646,[[13.49161823]],[[-87.43249881]],3,0.6914600550964187,
38,2,car,van,356,717,445,700,361,255,0.98048055,[[12.79547224]],[[-84.59101244]],3,0.7063711911357341,
39,2,car,van,357,718,443,695,361,252,0.98117363,[[13.29299264]],[[-86.27341276]],3,0.6980609418282548,
40,2,car,van,352,721,444,697,369,253,0.9763852,[[13.1724195]],[[-88.03748403]],3,0.6856368563685636,
41,2,car,van,356,718,441,696,362,255,0.9822874,[[12.80532617]],[[-84.88734094]],3,0.7044198895027625,
42,2,car,van,334,728,450,721,394,271,0.99925107,[[8.08523286]],[[-84.27413386]],3,0.6878172588832487,
43,2,car,van,331,725,449,722,394,273,0.99893653,[[7.6388042]],[[-83.16424404]],3,0.6928934010152284,
44,2,car,van,341,720,440,705,379,265,0.9988129,[[10.62404092]],[[-84.00437658]],3,0.6992084432717678,
0,2,car,van,355,717,445,696,362,251,0.97870356,[[13.47656188]],[[-87.1357032]],3,0.6933701657458563,
1,2,car,van,351,719,443,693,368,250,0.98112077,[[13.71351832]],[[-89.45671752]],3,0.6793478260869565,
2,2,car,van,356,719,446,694,363,248,0.9840417,[[14.0033309]],[[-89.13509799]],3,0.6831955922865014,
3,2,car,van,356,721,443,699,365,256,0.9829204,[[12.64899837]],[[-85.20434027]],3,0.7013698630136986,
4,2,car,van,357,720,443,695,363,252,0.9910357,[[13.32153937]],[[-86.86773377]],3,0.6942148760330579,
5,2,car,van,353,721,445,697,368,252,0.9697111,[[13.35408872]],[[-88.31981889]],3,0.6847826086956522,
6,2,car,van,357,719,444,697,362,253,0.9792671,[[13.14037974]],[[-86.00875405]],3,0.6988950276243094,
7,2,car,van,354,719,445,699,365,254,0.9693228,[[12.99455903]],[[-86.32657609]],3,0.6958904109589041,
8,2,car,van,356,721,443,695,365,252,0.97901255,[[13.34136526]],[[-87.45434795]],3,0.6904109589041096,
9,2,car,van,354,718,444,694,364,250,0.96606976,[[13.67671825]],[[-88.29411521]],3,0.6868131868131868,
10,2,car,van,353,719,444,698,366,254,0.9766162,[[12.99732295]],[[-86.6157962]],3,0.6939890710382514,
11,2,car,van,358,721,442,699,363,257,0.9873583,[[12.47552185]],[[-84.06466875]],3,0.7079889807162535,
12,2,car,van,354,721,447,691,367,244,0.9798042,[[14.78014871]],[[-92.60927844]],3,0.6648501362397821,
13,2,car,van,355,717,443,699,362,256,0.9844455,[[12.63826016]],[[-84.3287104]],3,0.7071823204419889,
14,2,car,van,352,722,445,693,370,248,0.9812132,[[14.08636989]],[[-91.17128691]],3,0.6702702702702703,
15,2,car,van,346,724,462,708,378,246,0.98077375,[[14.43933385]],[[-94.54269717]],3,0.6507936507936508,
16,2,car,van,351,721,445,699,370,254,0.97839665,[[12.9847507]],[[-87.75340956]],3,0.6864864864864865,
17,2,car,van,353,719,446,695,366,249,0.9726562,[[13.87590236]],[[-89.44859821]],3,0.680327868852459,
18,2,car,van,356,718,442,697,362,255,0.97505856,[[12.80532617]],[[-84.88734094]],3,0.7044198895027625,
19,2,car,van,351,721,446,694,370,248,0.9709657,[[14.08636989]],[[-91.17128691]],3,0.6702702702702703,
20,2,car,van,357,718,443,695,361,252,0.98895496,[[13.29299264]],[[-86.27341276]],3,0.6980609418282548,
21,2,car,van,359,716,444,693,357,249,0.97837234,[[13.68912907]],[[-86.74932516]],3,0.6974789915966386,
22,2,car,van,357,720,445,694,363,249,0.9793669,[[13.83252945]],[[-88.56618092]],3,0.6859504132231405,
23,2,car,van,352,717,444,694,365,250,0.9881751,[[13.68929513]],[[-88.58765586]],3,0.684931506849315,
24,2,car,van,355,718,444,696,363,252,0.986651,[[13.32153937]],[[-86.86773377]],3,0.6942148760330579,
25,2,car,van,356,720,446,697,364,251,0.9813424,[[13.50450931]],[[-87.72736771]],3,0.6895604395604396,
26,2,car,van,349,717,443,697,368,254,0.9859856,[[12.99583974]],[[-87.1884563]],3,0.6902173913043478,
27,2,car,van,352,719,444,695,367,251,0.98687744,[[13.52981284]],[[-88.60041414]],3,0.6839237057220708,
28,2,car,van,357,716,446,697,359,251,0.9763643,[[13.41877532]],[[-86.23375612]],3,0.6991643454038997,
29,2,car,van,355,718,445,696,363,251,0.9827555,[[13.49161823]],[[-87.43249881]],3,0.6914600550964187,
30,2,car,van,354,720,443,697,366,254,0.9826344,[[12.99732295]],[[-86.6157962]],3,0.6939890710382514,
31,2,car,van,354,720,443,693,366,250,0.98107594,[[13.69964617]],[[-88.87926979]],3,0.6830601092896175,
32,2,car,van,350,719,446,695,369,249,0.9818381,[[13.89903545]],[[-90.31367511]],3,0.6747967479674797,
33,2,car,van,354,720,442,696,366,254,0.9823021,[[12.99732295]],[[-86.6157962]],3,0.6939890710382514,
34,2,car,van,350,720,444,699,370,255,0.97152954,[[12.80223224]],[[-87.18860737]],3,0.6891891891891891,
35,2,car,van,354,717,444,692,363,248,0.97865987,[[14.0033309]],[[-89.13509799]],3,0.6831955922865014,
36,2,car,van,349,720,444,698,371,254,0.9789437,[[12.97550655]],[[-88.03299612]],3,0.6846361185983828,
37,2,car,van,355,718,442,697,363,255,0.9835155,[[12.81299323]],[[-85.18174273]],3,0.7024793388429752,
38,2,car,van,356,719,444,695,363,251,0.9872646,[[13.49161823]],[[-87.43249881]],3,0.6914600550964187,
39,2,car,van,356,717,445,700,361,255,0.98048055,[[12.79547224]],[[-84.59101244]],3,0.7063711911357341,
40,2,car,van,357,718,443,695,361,252,0.98117363,[[13.29299264]],[[-86.27341276]],3,0.6980609418282548,
41,2,car,van,352,721,444,697,369,253,0.9763852,[[13.1724195]],[[-88.03748403]],3,0.6856368563685636,
42,2,car,van,356,718,441,696,362,255,0.9822874,[[12.80532617]],[[-84.88734094]],3,0.7044198895027625,
43,2,car,van,334,728,450,721,394,271,0.99925107,[[8.08523286]],[[-84.27413386]],3,0.6878172588832487,
44,2,car,van,331,725,449,722,394,273,0.99893653,[[7.6388042]],[[-83.16424404]],3,0.6928934010152284,
45,2,car,van,341,720,440,705,379,265,0.9988129,[[10.62404092]],[[-84.00437658]],3,0.6992084432717678,
