,cid,label,left,right,top,bottom,width,height,score
0,2,car,4294967286,966,380,574,-4294966320,194,0.26321974
0,2,car,4294967270,1099,386,564,-4294966171,178,0.24828371
1,2,car,4294967286,966,380,574,-4294966320,194,0.26321974
0,2,car,14,1056,383,578,1042,195,0.2695259
1,2,car,4294967270,1099,386,564,-4294966171,178,0.24828371
2,2,car,4294967286,966,380,574,-4294966320,194,0.26321974
0,2,car,14,1056,383,578,1042,195,0.2695259
1,2,car,4294967270,1099,386,564,-4294966171,178,0.24828371
2,2,car,4294967286,966,380,574,-4294966320,194,0.26321974
0,2,car,13,1082,373,578,1069,205,0.5401667
1,2,car,14,1056,383,578,1042,195,0.2695259
2,2,car,4294967270,1099,386,564,-4294966171,178,0.24828371
3,2,car,4294967286,966,380,574,-4294966320,194,0.26321974
0,2,car,13,1082,373,578,1069,205,0.5401667
1,2,car,14,1056,383,578,1042,195,0.2695259
2,2,car,4294967270,1099,386,564,-4294966171,178,0.24828371
3,2,car,4294967286,966,380,574,-4294966320,194,0.26321974
0,2,car,4294967273,1061,378,575,-4294966212,197,0.31963575
1,2,car,13,1082,373,578,1069,205,0.5401667
2,2,car,14,1056,383,578,1042,195,0.2695259
3,2,car,4294967270,1099,386,564,-4294966171,178,0.24828371
4,2,car,4294967286,966,380,574,-4294966320,194,0.26321974
0,2,car,4294967273,1061,378,575,-4294966212,197,0.31963575
1,2,car,13,1082,373,578,1069,205,0.5401667
2,2,car,14,1056,383,578,1042,195,0.2695259
3,2,car,4294967270,1099,386,564,-4294966171,178,0.24828371
4,2,car,4294967286,966,380,574,-4294966320,194,0.26321974
0,2,car,4294967273,1061,378,575,-4294966212,197,0.31963575
1,2,car,13,1082,373,578,1069,205,0.5401667
2,2,car,14,1056,383,578,1042,195,0.2695259
3,2,car,4294967270,1099,386,564,-4294966171,178,0.24828371
4,2,car,4294967286,966,380,574,-4294966320,194,0.26321974
0,2,car,4294967275,1087,380,566,-4294966188,186,0.22077179
1,2,car,4294967273,1061,378,575,-4294966212,197,0.31963575
2,2,car,13,1082,373,578,1069,205,0.5401667
3,2,car,14,1056,383,578,1042,195,0.2695259
4,2,car,4294967270,1099,386,564,-4294966171,178,0.24828371
5,2,car,4294967286,966,380,574,-4294966320,194,0.26321974
0,2,car,4294967275,1087,380,566,-4294966188,186,0.22077179
1,2,car,4294967273,1061,378,575,-4294966212,197,0.31963575
2,2,car,13,1082,373,578,1069,205,0.5401667
3,2,car,14,1056,383,578,1042,195,0.2695259
4,2,car,4294967270,1099,386,564,-4294966171,178,0.24828371
5,2,car,4294967286,966,380,574,-4294966320,194,0.26321974
0,2,car,4294967275,1087,380,566,-4294966188,186,0.22077179
1,2,car,4294967273,1061,378,575,-4294966212,197,0.31963575
2,2,car,13,1082,373,578,1069,205,0.5401667
3,2,car,14,1056,383,578,1042,195,0.2695259
4,2,car,4294967270,1099,386,564,-4294966171,178,0.24828371
5,2,car,4294967286,966,380,574,-4294966320,194,0.26321974
0,2,car,4294967275,1087,380,566,-4294966188,186,0.22077179
1,2,car,4294967273,1061,378,575,-4294966212,197,0.31963575
2,2,car,13,1082,373,578,1069,205,0.5401667
3,2,car,14,1056,383,578,1042,195,0.2695259
4,2,car,4294967270,1099,386,564,-4294966171,178,0.24828371
5,2,car,4294967286,966,380,574,-4294966320,194,0.26321974
0,2,car,4294967275,1087,380,566,-4294966188,186,0.22077179
1,2,car,4294967273,1061,378,575,-4294966212,197,0.31963575
2,2,car,13,1082,373,578,1069,205,0.5401667
3,2,car,14,1056,383,578,1042,195,0.2695259
4,2,car,4294967270,1099,386,564,-4294966171,178,0.24828371
5,2,car,4294967286,966,380,574,-4294966320,194,0.26321974
0,2,car,4294967275,1087,380,566,-4294966188,186,0.22077179
1,2,car,4294967273,1061,378,575,-4294966212,197,0.31963575
2,2,car,13,1082,373,578,1069,205,0.5401667
3,2,car,14,1056,383,578,1042,195,0.2695259
4,2,car,4294967270,1099,386,564,-4294966171,178,0.24828371
5,2,car,4294967286,966,380,574,-4294966320,194,0.26321974
0,2,car,4294967294,1076,365,560,-4294966218,195,0.28676075
1,2,car,4294967275,1087,380,566,-4294966188,186,0.22077179
2,2,car,4294967273,1061,378,575,-4294966212,197,0.31963575
3,2,car,13,1082,373,578,1069,205,0.5401667
4,2,car,14,1056,383,578,1042,195,0.2695259
5,2,car,4294967270,1099,386,564,-4294966171,178,0.24828371
6,2,car,4294967286,966,380,574,-4294966320,194,0.26321974
0,2,car,4294967277,1090,365,555,-4294966187,190,0.21405561
1,2,car,4294967294,1076,365,560,-4294966218,195,0.28676075
2,2,car,4294967275,1087,380,566,-4294966188,186,0.22077179
3,2,car,4294967273,1061,378,575,-4294966212,197,0.31963575
4,2,car,13,1082,373,578,1069,205,0.5401667
5,2,car,14,1056,383,578,1042,195,0.2695259
6,2,car,4294967270,1099,386,564,-4294966171,178,0.24828371
7,2,car,4294967286,966,380,574,-4294966320,194,0.26321974
0,2,car,4294967277,1090,365,555,-4294966187,190,0.21405561
1,2,car,4294967294,1076,365,560,-4294966218,195,0.28676075
2,2,car,4294967275,1087,380,566,-4294966188,186,0.22077179
3,2,car,4294967273,1061,378,575,-4294966212,197,0.31963575
4,2,car,13,1082,373,578,1069,205,0.5401667
5,2,car,14,1056,383,578,1042,195,0.2695259
6,2,car,4294967270,1099,386,564,-4294966171,178,0.24828371
7,2,car,4294967286,966,380,574,-4294966320,194,0.26321974
0,2,car,4294967278,1089,361,549,-4294966189,188,0.28828707
1,2,car,4294967277,1090,365,555,-4294966187,190,0.21405561
2,2,car,4294967294,1076,365,560,-4294966218,195,0.28676075
3,2,car,4294967275,1087,380,566,-4294966188,186,0.22077179
4,2,car,4294967273,1061,378,575,-4294966212,197,0.31963575
5,2,car,13,1082,373,578,1069,205,0.5401667
6,2,car,14,1056,383,578,1042,195,0.2695259
7,2,car,4294967270,1099,386,564,-4294966171,178,0.24828371
8,2,car,4294967286,966,380,574,-4294966320,194,0.26321974
0,2,car,4294967278,1089,361,549,-4294966189,188,0.28828707
1,2,car,4294967277,1090,365,555,-4294966187,190,0.21405561
2,2,car,4294967294,1076,365,560,-4294966218,195,0.28676075
3,2,car,4294967275,1087,380,566,-4294966188,186,0.22077179
4,2,car,4294967273,1061,378,575,-4294966212,197,0.31963575
5,2,car,13,1082,373,578,1069,205,0.5401667
6,2,car,14,1056,383,578,1042,195,0.2695259
7,2,car,4294967270,1099,386,564,-4294966171,178,0.24828371
8,2,car,4294967286,966,380,574,-4294966320,194,0.26321974
0,2,car,4294967278,1089,361,549,-4294966189,188,0.28828707
1,2,car,4294967277,1090,365,555,-4294966187,190,0.21405561
2,2,car,4294967294,1076,365,560,-4294966218,195,0.28676075
3,2,car,4294967275,1087,380,566,-4294966188,186,0.22077179
4,2,car,4294967273,1061,378,575,-4294966212,197,0.31963575
5,2,car,13,1082,373,578,1069,205,0.5401667
6,2,car,14,1056,383,578,1042,195,0.2695259
7,2,car,4294967270,1099,386,564,-4294966171,178,0.24828371
8,2,car,4294967286,966,380,574,-4294966320,194,0.26321974
0,2,car,4294967271,1075,377,560,-4294966196,183,0.3504756
1,2,car,4294967278,1089,361,549,-4294966189,188,0.28828707
2,2,car,4294967277,1090,365,555,-4294966187,190,0.21405561
3,2,car,4294967294,1076,365,560,-4294966218,195,0.28676075
4,2,car,4294967275,1087,380,566,-4294966188,186,0.22077179
5,2,car,4294967273,1061,378,575,-4294966212,197,0.31963575
6,2,car,13,1082,373,578,1069,205,0.5401667
7,2,car,14,1056,383,578,1042,195,0.2695259
8,2,car,4294967270,1099,386,564,-4294966171,178,0.24828371
9,2,car,4294967286,966,380,574,-4294966320,194,0.26321974
0,2,car,4294967271,1075,377,560,-4294966196,183,0.3504756
1,2,car,4294967278,1089,361,549,-4294966189,188,0.28828707
2,2,car,4294967277,1090,365,555,-4294966187,190,0.21405561
3,2,car,4294967294,1076,365,560,-4294966218,195,0.28676075
4,2,car,4294967275,1087,380,566,-4294966188,186,0.22077179
5,2,car,4294967273,1061,378,575,-4294966212,197,0.31963575
6,2,car,13,1082,373,578,1069,205,0.5401667
7,2,car,14,1056,383,578,1042,195,0.2695259
8,2,car,4294967270,1099,386,564,-4294966171,178,0.24828371
9,2,car,4294967286,966,380,574,-4294966320,194,0.26321974
0,2,car,4294967271,1075,377,560,-4294966196,183,0.3504756
1,2,car,4294967278,1089,361,549,-4294966189,188,0.28828707
2,2,car,4294967277,1090,365,555,-4294966187,190,0.21405561
3,2,car,4294967294,1076,365,560,-4294966218,195,0.28676075
4,2,car,4294967275,1087,380,566,-4294966188,186,0.22077179
5,2,car,4294967273,1061,378,575,-4294966212,197,0.31963575
6,2,car,13,1082,373,578,1069,205,0.5401667
7,2,car,14,1056,383,578,1042,195,0.2695259
8,2,car,4294967270,1099,386,564,-4294966171,178,0.24828371
9,2,car,4294967286,966,380,574,-4294966320,194,0.26321974
0,2,car,4294967271,1075,377,560,-4294966196,183,0.3504756
1,2,car,4294967278,1089,361,549,-4294966189,188,0.28828707
2,2,car,4294967277,1090,365,555,-4294966187,190,0.21405561
3,2,car,4294967294,1076,365,560,-4294966218,195,0.28676075
4,2,car,4294967275,1087,380,566,-4294966188,186,0.22077179
5,2,car,4294967273,1061,378,575,-4294966212,197,0.31963575
6,2,car,13,1082,373,578,1069,205,0.5401667
7,2,car,14,1056,383,578,1042,195,0.2695259
8,2,car,4294967270,1099,386,564,-4294966171,178,0.24828371
9,2,car,4294967286,966,380,574,-4294966320,194,0.26321974
0,2,car,4294967271,1075,377,560,-4294966196,183,0.3504756
1,2,car,4294967278,1089,361,549,-4294966189,188,0.28828707
2,2,car,4294967277,1090,365,555,-4294966187,190,0.21405561
3,2,car,4294967294,1076,365,560,-4294966218,195,0.28676075
4,2,car,4294967275,1087,380,566,-4294966188,186,0.22077179
5,2,car,4294967273,1061,378,575,-4294966212,197,0.31963575
6,2,car,13,1082,373,578,1069,205,0.5401667
7,2,car,14,1056,383,578,1042,195,0.2695259
8,2,car,4294967270,1099,386,564,-4294966171,178,0.24828371
9,2,car,4294967286,966,380,574,-4294966320,194,0.26321974
0,2,car,4294967271,1075,377,560,-4294966196,183,0.3504756
1,2,car,4294967278,1089,361,549,-4294966189,188,0.28828707
2,2,car,4294967277,1090,365,555,-4294966187,190,0.21405561
3,2,car,4294967294,1076,365,560,-4294966218,195,0.28676075
4,2,car,4294967275,1087,380,566,-4294966188,186,0.22077179
5,2,car,4294967273,1061,378,575,-4294966212,197,0.31963575
6,2,car,13,1082,373,578,1069,205,0.5401667
7,2,car,14,1056,383,578,1042,195,0.2695259
8,2,car,4294967270,1099,386,564,-4294966171,178,0.24828371
9,2,car,4294967286,966,380,574,-4294966320,194,0.26321974
0,2,car,4294967271,1075,377,560,-4294966196,183,0.3504756
1,2,car,4294967278,1089,361,549,-4294966189,188,0.28828707
2,2,car,4294967277,1090,365,555,-4294966187,190,0.21405561
3,2,car,4294967294,1076,365,560,-4294966218,195,0.28676075
4,2,car,4294967275,1087,380,566,-4294966188,186,0.22077179
5,2,car,4294967273,1061,378,575,-4294966212,197,0.31963575
6,2,car,13,1082,373,578,1069,205,0.5401667
7,2,car,14,1056,383,578,1042,195,0.2695259
8,2,car,4294967270,1099,386,564,-4294966171,178,0.24828371
9,2,car,4294967286,966,380,574,-4294966320,194,0.26321974
0,2,car,4294967271,1075,377,560,-4294966196,183,0.3504756
1,2,car,4294967278,1089,361,549,-4294966189,188,0.28828707
2,2,car,4294967277,1090,365,555,-4294966187,190,0.21405561
3,2,car,4294967294,1076,365,560,-4294966218,195,0.28676075
4,2,car,4294967275,1087,380,566,-4294966188,186,0.22077179
5,2,car,4294967273,1061,378,575,-4294966212,197,0.31963575
6,2,car,13,1082,373,578,1069,205,0.5401667
7,2,car,14,1056,383,578,1042,195,0.2695259
8,2,car,4294967270,1099,386,564,-4294966171,178,0.24828371
9,2,car,4294967286,966,380,574,-4294966320,194,0.26321974
0,2,car,4294967271,1075,377,560,-4294966196,183,0.3504756
1,2,car,4294967278,1089,361,549,-4294966189,188,0.28828707
2,2,car,4294967277,1090,365,555,-4294966187,190,0.21405561
3,2,car,4294967294,1076,365,560,-4294966218,195,0.28676075
4,2,car,4294967275,1087,380,566,-4294966188,186,0.22077179
5,2,car,4294967273,1061,378,575,-4294966212,197,0.31963575
6,2,car,13,1082,373,578,1069,205,0.5401667
7,2,car,14,1056,383,578,1042,195,0.2695259
8,2,car,4294967270,1099,386,564,-4294966171,178,0.24828371
9,2,car,4294967286,966,380,574,-4294966320,194,0.26321974
0,2,car,4294967271,1075,377,560,-4294966196,183,0.3504756
1,2,car,4294967278,1089,361,549,-4294966189,188,0.28828707
2,2,car,4294967277,1090,365,555,-4294966187,190,0.21405561
3,2,car,4294967294,1076,365,560,-4294966218,195,0.28676075
4,2,car,4294967275,1087,380,566,-4294966188,186,0.22077179
5,2,car,4294967273,1061,378,575,-4294966212,197,0.31963575
6,2,car,13,1082,373,578,1069,205,0.5401667
7,2,car,14,1056,383,578,1042,195,0.2695259
8,2,car,4294967270,1099,386,564,-4294966171,178,0.24828371
9,2,car,4294967286,966,380,574,-4294966320,194,0.26321974
0,2,car,4294967271,1075,377,560,-4294966196,183,0.3504756
1,2,car,4294967278,1089,361,549,-4294966189,188,0.28828707
2,2,car,4294967277,1090,365,555,-4294966187,190,0.21405561
3,2,car,4294967294,1076,365,560,-4294966218,195,0.28676075
4,2,car,4294967275,1087,380,566,-4294966188,186,0.22077179
5,2,car,4294967273,1061,378,575,-4294966212,197,0.31963575
6,2,car,13,1082,373,578,1069,205,0.5401667
7,2,car,14,1056,383,578,1042,195,0.2695259
8,2,car,4294967270,1099,386,564,-4294966171,178,0.24828371
9,2,car,4294967286,966,380,574,-4294966320,194,0.26321974
0,2,car,4294967271,1075,377,560,-4294966196,183,0.3504756
1,2,car,4294967278,1089,361,549,-4294966189,188,0.28828707
2,2,car,4294967277,1090,365,555,-4294966187,190,0.21405561
3,2,car,4294967294,1076,365,560,-4294966218,195,0.28676075
4,2,car,4294967275,1087,380,566,-4294966188,186,0.22077179
5,2,car,4294967273,1061,378,575,-4294966212,197,0.31963575
6,2,car,13,1082,373,578,1069,205,0.5401667
7,2,car,14,1056,383,578,1042,195,0.2695259
8,2,car,4294967270,1099,386,564,-4294966171,178,0.24828371
9,2,car,4294967286,966,380,574,-4294966320,194,0.26321974
0,2,car,4294967271,1075,377,560,-4294966196,183,0.3504756
1,2,car,4294967278,1089,361,549,-4294966189,188,0.28828707
2,2,car,4294967277,1090,365,555,-4294966187,190,0.21405561
3,2,car,4294967294,1076,365,560,-4294966218,195,0.28676075
4,2,car,4294967275,1087,380,566,-4294966188,186,0.22077179
5,2,car,4294967273,1061,378,575,-4294966212,197,0.31963575
6,2,car,13,1082,373,578,1069,205,0.5401667
7,2,car,14,1056,383,578,1042,195,0.2695259
8,2,car,4294967270,1099,386,564,-4294966171,178,0.24828371
9,2,car,4294967286,966,380,574,-4294966320,194,0.26321974
0,2,car,4294967271,1075,377,560,-4294966196,183,0.3504756
1,2,car,4294967278,1089,361,549,-4294966189,188,0.28828707
2,2,car,4294967277,1090,365,555,-4294966187,190,0.21405561
3,2,car,4294967294,1076,365,560,-4294966218,195,0.28676075
4,2,car,4294967275,1087,380,566,-4294966188,186,0.22077179
5,2,car,4294967273,1061,378,575,-4294966212,197,0.31963575
6,2,car,13,1082,373,578,1069,205,0.5401667
7,2,car,14,1056,383,578,1042,195,0.2695259
8,2,car,4294967270,1099,386,564,-4294966171,178,0.24828371
9,2,car,4294967286,966,380,574,-4294966320,194,0.26321974
0,2,car,4294967271,1075,377,560,-4294966196,183,0.3504756
1,2,car,4294967278,1089,361,549,-4294966189,188,0.28828707
2,2,car,4294967277,1090,365,555,-4294966187,190,0.21405561
3,2,car,4294967294,1076,365,560,-4294966218,195,0.28676075
4,2,car,4294967275,1087,380,566,-4294966188,186,0.22077179
5,2,car,4294967273,1061,378,575,-4294966212,197,0.31963575
6,2,car,13,1082,373,578,1069,205,0.5401667
7,2,car,14,1056,383,578,1042,195,0.2695259
8,2,car,4294967270,1099,386,564,-4294966171,178,0.24828371
9,2,car,4294967286,966,380,574,-4294966320,194,0.26321974
0,2,car,4294967271,1075,377,560,-4294966196,183,0.3504756
1,2,car,4294967278,1089,361,549,-4294966189,188,0.28828707
2,2,car,4294967277,1090,365,555,-4294966187,190,0.21405561
3,2,car,4294967294,1076,365,560,-4294966218,195,0.28676075
4,2,car,4294967275,1087,380,566,-4294966188,186,0.22077179
5,2,car,4294967273,1061,378,575,-4294966212,197,0.31963575
6,2,car,13,1082,373,578,1069,205,0.5401667
7,2,car,14,1056,383,578,1042,195,0.2695259
8,2,car,4294967270,1099,386,564,-4294966171,178,0.24828371
9,2,car,4294967286,966,380,574,-4294966320,194,0.26321974
0,2,car,4294967271,1075,377,560,-4294966196,183,0.3504756
1,2,car,4294967278,1089,361,549,-4294966189,188,0.28828707
2,2,car,4294967277,1090,365,555,-4294966187,190,0.21405561
3,2,car,4294967294,1076,365,560,-4294966218,195,0.28676075
4,2,car,4294967275,1087,380,566,-4294966188,186,0.22077179
5,2,car,4294967273,1061,378,575,-4294966212,197,0.31963575
6,2,car,13,1082,373,578,1069,205,0.5401667
7,2,car,14,1056,383,578,1042,195,0.2695259
8,2,car,4294967270,1099,386,564,-4294966171,178,0.24828371
9,2,car,4294967286,966,380,574,-4294966320,194,0.26321974
0,2,car,4294967271,1075,377,560,-4294966196,183,0.3504756
1,2,car,4294967278,1089,361,549,-4294966189,188,0.28828707
2,2,car,4294967277,1090,365,555,-4294966187,190,0.21405561
3,2,car,4294967294,1076,365,560,-4294966218,195,0.28676075
4,2,car,4294967275,1087,380,566,-4294966188,186,0.22077179
5,2,car,4294967273,1061,378,575,-4294966212,197,0.31963575
6,2,car,13,1082,373,578,1069,205,0.5401667
7,2,car,14,1056,383,578,1042,195,0.2695259
8,2,car,4294967270,1099,386,564,-4294966171,178,0.24828371
9,2,car,4294967286,966,380,574,-4294966320,194,0.26321974
0,2,car,4294967271,1075,377,560,-4294966196,183,0.3504756
1,2,car,4294967278,1089,361,549,-4294966189,188,0.28828707
2,2,car,4294967277,1090,365,555,-4294966187,190,0.21405561
3,2,car,4294967294,1076,365,560,-4294966218,195,0.28676075
4,2,car,4294967275,1087,380,566,-4294966188,186,0.22077179
5,2,car,4294967273,1061,378,575,-4294966212,197,0.31963575
6,2,car,13,1082,373,578,1069,205,0.5401667
7,2,car,14,1056,383,578,1042,195,0.2695259
8,2,car,4294967270,1099,386,564,-4294966171,178,0.24828371
9,2,car,4294967286,966,380,574,-4294966320,194,0.26321974
0,2,car,4294967271,1075,377,560,-4294966196,183,0.3504756
1,2,car,4294967278,1089,361,549,-4294966189,188,0.28828707
2,2,car,4294967277,1090,365,555,-4294966187,190,0.21405561
3,2,car,4294967294,1076,365,560,-4294966218,195,0.28676075
4,2,car,4294967275,1087,380,566,-4294966188,186,0.22077179
5,2,car,4294967273,1061,378,575,-4294966212,197,0.31963575
6,2,car,13,1082,373,578,1069,205,0.5401667
7,2,car,14,1056,383,578,1042,195,0.2695259
8,2,car,4294967270,1099,386,564,-4294966171,178,0.24828371
9,2,car,4294967286,966,380,574,-4294966320,194,0.26321974
0,2,car,4294967271,1075,377,560,-4294966196,183,0.3504756
1,2,car,4294967278,1089,361,549,-4294966189,188,0.28828707
2,2,car,4294967277,1090,365,555,-4294966187,190,0.21405561
3,2,car,4294967294,1076,365,560,-4294966218,195,0.28676075
4,2,car,4294967275,1087,380,566,-4294966188,186,0.22077179
5,2,car,4294967273,1061,378,575,-4294966212,197,0.31963575
6,2,car,13,1082,373,578,1069,205,0.5401667
7,2,car,14,1056,383,578,1042,195,0.2695259
8,2,car,4294967270,1099,386,564,-4294966171,178,0.24828371
9,2,car,4294967286,966,380,574,-4294966320,194,0.26321974
0,2,car,4294967271,1075,377,560,-4294966196,183,0.3504756
1,2,car,4294967278,1089,361,549,-4294966189,188,0.28828707
2,2,car,4294967277,1090,365,555,-4294966187,190,0.21405561
3,2,car,4294967294,1076,365,560,-4294966218,195,0.28676075
4,2,car,4294967275,1087,380,566,-4294966188,186,0.22077179
5,2,car,4294967273,1061,378,575,-4294966212,197,0.31963575
6,2,car,13,1082,373,578,1069,205,0.5401667
7,2,car,14,1056,383,578,1042,195,0.2695259
8,2,car,4294967270,1099,386,564,-4294966171,178,0.24828371
9,2,car,4294967286,966,380,574,-4294966320,194,0.26321974
0,2,car,4294967271,1075,377,560,-4294966196,183,0.3504756
1,2,car,4294967278,1089,361,549,-4294966189,188,0.28828707
2,2,car,4294967277,1090,365,555,-4294966187,190,0.21405561
3,2,car,4294967294,1076,365,560,-4294966218,195,0.28676075
4,2,car,4294967275,1087,380,566,-4294966188,186,0.22077179
5,2,car,4294967273,1061,378,575,-4294966212,197,0.31963575
6,2,car,13,1082,373,578,1069,205,0.5401667
7,2,car,14,1056,383,578,1042,195,0.2695259
8,2,car,4294967270,1099,386,564,-4294966171,178,0.24828371
9,2,car,4294967286,966,380,574,-4294966320,194,0.26321974
0,2,car,4294967271,1075,377,560,-4294966196,183,0.3504756
1,2,car,4294967278,1089,361,549,-4294966189,188,0.28828707
2,2,car,4294967277,1090,365,555,-4294966187,190,0.21405561
3,2,car,4294967294,1076,365,560,-4294966218,195,0.28676075
4,2,car,4294967275,1087,380,566,-4294966188,186,0.22077179
5,2,car,4294967273,1061,378,575,-4294966212,197,0.31963575
6,2,car,13,1082,373,578,1069,205,0.5401667
7,2,car,14,1056,383,578,1042,195,0.2695259
8,2,car,4294967270,1099,386,564,-4294966171,178,0.24828371
9,2,car,4294967286,966,380,574,-4294966320,194,0.26321974
0,2,car,4294967271,1075,377,560,-4294966196,183,0.3504756
1,2,car,4294967278,1089,361,549,-4294966189,188,0.28828707
2,2,car,4294967277,1090,365,555,-4294966187,190,0.21405561
3,2,car,4294967294,1076,365,560,-4294966218,195,0.28676075
4,2,car,4294967275,1087,380,566,-4294966188,186,0.22077179
5,2,car,4294967273,1061,378,575,-4294966212,197,0.31963575
6,2,car,13,1082,373,578,1069,205,0.5401667
7,2,car,14,1056,383,578,1042,195,0.2695259
8,2,car,4294967270,1099,386,564,-4294966171,178,0.24828371
9,2,car,4294967286,966,380,574,-4294966320,194,0.26321974
0,2,car,4294967271,1075,377,560,-4294966196,183,0.3504756
1,2,car,4294967278,1089,361,549,-4294966189,188,0.28828707
2,2,car,4294967277,1090,365,555,-4294966187,190,0.21405561
3,2,car,4294967294,1076,365,560,-4294966218,195,0.28676075
4,2,car,4294967275,1087,380,566,-4294966188,186,0.22077179
5,2,car,4294967273,1061,378,575,-4294966212,197,0.31963575
6,2,car,13,1082,373,578,1069,205,0.5401667
7,2,car,14,1056,383,578,1042,195,0.2695259
8,2,car,4294967270,1099,386,564,-4294966171,178,0.24828371
9,2,car,4294967286,966,380,574,-4294966320,194,0.26321974
0,2,car,4294967271,1075,377,560,-4294966196,183,0.3504756
1,2,car,4294967278,1089,361,549,-4294966189,188,0.28828707
2,2,car,4294967277,1090,365,555,-4294966187,190,0.21405561
3,2,car,4294967294,1076,365,560,-4294966218,195,0.28676075
4,2,car,4294967275,1087,380,566,-4294966188,186,0.22077179
5,2,car,4294967273,1061,378,575,-4294966212,197,0.31963575
6,2,car,13,1082,373,578,1069,205,0.5401667
7,2,car,14,1056,383,578,1042,195,0.2695259
8,2,car,4294967270,1099,386,564,-4294966171,178,0.24828371
9,2,car,4294967286,966,380,574,-4294966320,194,0.26321974
0,2,car,4294967271,1075,377,560,-4294966196,183,0.3504756
1,2,car,4294967278,1089,361,549,-4294966189,188,0.28828707
2,2,car,4294967277,1090,365,555,-4294966187,190,0.21405561
3,2,car,4294967294,1076,365,560,-4294966218,195,0.28676075
4,2,car,4294967275,1087,380,566,-4294966188,186,0.22077179
5,2,car,4294967273,1061,378,575,-4294966212,197,0.31963575
6,2,car,13,1082,373,578,1069,205,0.5401667
7,2,car,14,1056,383,578,1042,195,0.2695259
8,2,car,4294967270,1099,386,564,-4294966171,178,0.24828371
9,2,car,4294967286,966,380,574,-4294966320,194,0.26321974
0,2,car,4294967271,1075,377,560,-4294966196,183,0.3504756
1,2,car,4294967278,1089,361,549,-4294966189,188,0.28828707
2,2,car,4294967277,1090,365,555,-4294966187,190,0.21405561
3,2,car,4294967294,1076,365,560,-4294966218,195,0.28676075
4,2,car,4294967275,1087,380,566,-4294966188,186,0.22077179
5,2,car,4294967273,1061,378,575,-4294966212,197,0.31963575
6,2,car,13,1082,373,578,1069,205,0.5401667
7,2,car,14,1056,383,578,1042,195,0.2695259
8,2,car,4294967270,1099,386,564,-4294966171,178,0.24828371
9,2,car,4294967286,966,380,574,-4294966320,194,0.26321974
0,2,car,4294967271,1075,377,560,-4294966196,183,0.3504756
1,2,car,4294967278,1089,361,549,-4294966189,188,0.28828707
2,2,car,4294967277,1090,365,555,-4294966187,190,0.21405561
3,2,car,4294967294,1076,365,560,-4294966218,195,0.28676075
4,2,car,4294967275,1087,380,566,-4294966188,186,0.22077179
5,2,car,4294967273,1061,378,575,-4294966212,197,0.31963575
6,2,car,13,1082,373,578,1069,205,0.5401667
7,2,car,14,1056,383,578,1042,195,0.2695259
8,2,car,4294967270,1099,386,564,-4294966171,178,0.24828371
9,2,car,4294967286,966,380,574,-4294966320,194,0.26321974
0,2,car,4294967271,1075,377,560,-4294966196,183,0.3504756
1,2,car,4294967278,1089,361,549,-4294966189,188,0.28828707
2,2,car,4294967277,1090,365,555,-4294966187,190,0.21405561
3,2,car,4294967294,1076,365,560,-4294966218,195,0.28676075
4,2,car,4294967275,1087,380,566,-4294966188,186,0.22077179
5,2,car,4294967273,1061,378,575,-4294966212,197,0.31963575
6,2,car,13,1082,373,578,1069,205,0.5401667
7,2,car,14,1056,383,578,1042,195,0.2695259
8,2,car,4294967270,1099,386,564,-4294966171,178,0.24828371
9,2,car,4294967286,966,380,574,-4294966320,194,0.26321974
0,2,car,4294967271,1075,377,560,-4294966196,183,0.3504756
1,2,car,4294967278,1089,361,549,-4294966189,188,0.28828707
2,2,car,4294967277,1090,365,555,-4294966187,190,0.21405561
3,2,car,4294967294,1076,365,560,-4294966218,195,0.28676075
4,2,car,4294967275,1087,380,566,-4294966188,186,0.22077179
5,2,car,4294967273,1061,378,575,-4294966212,197,0.31963575
6,2,car,13,1082,373,578,1069,205,0.5401667
7,2,car,14,1056,383,578,1042,195,0.2695259
8,2,car,4294967270,1099,386,564,-4294966171,178,0.24828371
9,2,car,4294967286,966,380,574,-4294966320,194,0.26321974
0,2,car,4294967271,1075,377,560,-4294966196,183,0.3504756
1,2,car,4294967278,1089,361,549,-4294966189,188,0.28828707
2,2,car,4294967277,1090,365,555,-4294966187,190,0.21405561
3,2,car,4294967294,1076,365,560,-4294966218,195,0.28676075
4,2,car,4294967275,1087,380,566,-4294966188,186,0.22077179
5,2,car,4294967273,1061,378,575,-4294966212,197,0.31963575
6,2,car,13,1082,373,578,1069,205,0.5401667
7,2,car,14,1056,383,578,1042,195,0.2695259
8,2,car,4294967270,1099,386,564,-4294966171,178,0.24828371
9,2,car,4294967286,966,380,574,-4294966320,194,0.26321974
0,2,car,4294967271,1075,377,560,-4294966196,183,0.3504756
1,2,car,4294967278,1089,361,549,-4294966189,188,0.28828707
2,2,car,4294967277,1090,365,555,-4294966187,190,0.21405561
3,2,car,4294967294,1076,365,560,-4294966218,195,0.28676075
4,2,car,4294967275,1087,380,566,-4294966188,186,0.22077179
5,2,car,4294967273,1061,378,575,-4294966212,197,0.31963575
6,2,car,13,1082,373,578,1069,205,0.5401667
7,2,car,14,1056,383,578,1042,195,0.2695259
8,2,car,4294967270,1099,386,564,-4294966171,178,0.24828371
9,2,car,4294967286,966,380,574,-4294966320,194,0.26321974
0,2,car,4294967271,1075,377,560,-4294966196,183,0.3504756
1,2,car,4294967278,1089,361,549,-4294966189,188,0.28828707
2,2,car,4294967277,1090,365,555,-4294966187,190,0.21405561
3,2,car,4294967294,1076,365,560,-4294966218,195,0.28676075
4,2,car,4294967275,1087,380,566,-4294966188,186,0.22077179
5,2,car,4294967273,1061,378,575,-4294966212,197,0.31963575
6,2,car,13,1082,373,578,1069,205,0.5401667
7,2,car,14,1056,383,578,1042,195,0.2695259
8,2,car,4294967270,1099,386,564,-4294966171,178,0.24828371
9,2,car,4294967286,966,380,574,-4294966320,194,0.26321974
0,2,car,4294967271,1075,377,560,-4294966196,183,0.3504756
1,2,car,4294967278,1089,361,549,-4294966189,188,0.28828707
2,2,car,4294967277,1090,365,555,-4294966187,190,0.21405561
3,2,car,4294967294,1076,365,560,-4294966218,195,0.28676075
4,2,car,4294967275,1087,380,566,-4294966188,186,0.22077179
5,2,car,4294967273,1061,378,575,-4294966212,197,0.31963575
6,2,car,13,1082,373,578,1069,205,0.5401667
7,2,car,14,1056,383,578,1042,195,0.2695259
8,2,car,4294967270,1099,386,564,-4294966171,178,0.24828371
9,2,car,4294967286,966,380,574,-4294966320,194,0.26321974
0,2,car,4294967271,1075,377,560,-4294966196,183,0.3504756
1,2,car,4294967278,1089,361,549,-4294966189,188,0.28828707
2,2,car,4294967277,1090,365,555,-4294966187,190,0.21405561
3,2,car,4294967294,1076,365,560,-4294966218,195,0.28676075
4,2,car,4294967275,1087,380,566,-4294966188,186,0.22077179
5,2,car,4294967273,1061,378,575,-4294966212,197,0.31963575
6,2,car,13,1082,373,578,1069,205,0.5401667
7,2,car,14,1056,383,578,1042,195,0.2695259
8,2,car,4294967270,1099,386,564,-4294966171,178,0.24828371
9,2,car,4294967286,966,380,574,-4294966320,194,0.26321974
0,2,car,4294967271,1075,377,560,-4294966196,183,0.3504756
1,2,car,4294967278,1089,361,549,-4294966189,188,0.28828707
2,2,car,4294967277,1090,365,555,-4294966187,190,0.21405561
3,2,car,4294967294,1076,365,560,-4294966218,195,0.28676075
4,2,car,4294967275,1087,380,566,-4294966188,186,0.22077179
5,2,car,4294967273,1061,378,575,-4294966212,197,0.31963575
6,2,car,13,1082,373,578,1069,205,0.5401667
7,2,car,14,1056,383,578,1042,195,0.2695259
8,2,car,4294967270,1099,386,564,-4294966171,178,0.24828371
9,2,car,4294967286,966,380,574,-4294966320,194,0.26321974
0,2,car,4294967271,1075,377,560,-4294966196,183,0.3504756
1,2,car,4294967278,1089,361,549,-4294966189,188,0.28828707
2,2,car,4294967277,1090,365,555,-4294966187,190,0.21405561
3,2,car,4294967294,1076,365,560,-4294966218,195,0.28676075
4,2,car,4294967275,1087,380,566,-4294966188,186,0.22077179
5,2,car,4294967273,1061,378,575,-4294966212,197,0.31963575
6,2,car,13,1082,373,578,1069,205,0.5401667
7,2,car,14,1056,383,578,1042,195,0.2695259
8,2,car,4294967270,1099,386,564,-4294966171,178,0.24828371
9,2,car,4294967286,966,380,574,-4294966320,194,0.26321974
0,2,car,4294967271,1075,377,560,-4294966196,183,0.3504756
1,2,car,4294967278,1089,361,549,-4294966189,188,0.28828707
2,2,car,4294967277,1090,365,555,-4294966187,190,0.21405561
3,2,car,4294967294,1076,365,560,-4294966218,195,0.28676075
4,2,car,4294967275,1087,380,566,-4294966188,186,0.22077179
5,2,car,4294967273,1061,378,575,-4294966212,197,0.31963575
6,2,car,13,1082,373,578,1069,205,0.5401667
7,2,car,14,1056,383,578,1042,195,0.2695259
8,2,car,4294967270,1099,386,564,-4294966171,178,0.24828371
9,2,car,4294967286,966,380,574,-4294966320,194,0.26321974
0,2,car,4294967271,1075,377,560,-4294966196,183,0.3504756
1,2,car,4294967278,1089,361,549,-4294966189,188,0.28828707
2,2,car,4294967277,1090,365,555,-4294966187,190,0.21405561
3,2,car,4294967294,1076,365,560,-4294966218,195,0.28676075
4,2,car,4294967275,1087,380,566,-4294966188,186,0.22077179
5,2,car,4294967273,1061,378,575,-4294966212,197,0.31963575
6,2,car,13,1082,373,578,1069,205,0.5401667
7,2,car,14,1056,383,578,1042,195,0.2695259
8,2,car,4294967270,1099,386,564,-4294966171,178,0.24828371
9,2,car,4294967286,966,380,574,-4294966320,194,0.26321974
0,2,car,4294967271,1075,377,560,-4294966196,183,0.3504756
1,2,car,4294967278,1089,361,549,-4294966189,188,0.28828707
2,2,car,4294967277,1090,365,555,-4294966187,190,0.21405561
3,2,car,4294967294,1076,365,560,-4294966218,195,0.28676075
4,2,car,4294967275,1087,380,566,-4294966188,186,0.22077179
5,2,car,4294967273,1061,378,575,-4294966212,197,0.31963575
6,2,car,13,1082,373,578,1069,205,0.5401667
7,2,car,14,1056,383,578,1042,195,0.2695259
8,2,car,4294967270,1099,386,564,-4294966171,178,0.24828371
9,2,car,4294967286,966,380,574,-4294966320,194,0.26321974
0,2,car,4294967271,1075,377,560,-4294966196,183,0.3504756
1,2,car,4294967278,1089,361,549,-4294966189,188,0.28828707
2,2,car,4294967277,1090,365,555,-4294966187,190,0.21405561
3,2,car,4294967294,1076,365,560,-4294966218,195,0.28676075
4,2,car,4294967275,1087,380,566,-4294966188,186,0.22077179
5,2,car,4294967273,1061,378,575,-4294966212,197,0.31963575
6,2,car,13,1082,373,578,1069,205,0.5401667
7,2,car,14,1056,383,578,1042,195,0.2695259
8,2,car,4294967270,1099,386,564,-4294966171,178,0.24828371
9,2,car,4294967286,966,380,574,-4294966320,194,0.26321974
0,2,car,4294967271,1075,377,560,-4294966196,183,0.3504756
1,2,car,4294967278,1089,361,549,-4294966189,188,0.28828707
2,2,car,4294967277,1090,365,555,-4294966187,190,0.21405561
3,2,car,4294967294,1076,365,560,-4294966218,195,0.28676075
4,2,car,4294967275,1087,380,566,-4294966188,186,0.22077179
5,2,car,4294967273,1061,378,575,-4294966212,197,0.31963575
6,2,car,13,1082,373,578,1069,205,0.5401667
7,2,car,14,1056,383,578,1042,195,0.2695259
8,2,car,4294967270,1099,386,564,-4294966171,178,0.24828371
9,2,car,4294967286,966,380,574,-4294966320,194,0.26321974
0,2,car,4294967271,1075,377,560,-4294966196,183,0.3504756
1,2,car,4294967278,1089,361,549,-4294966189,188,0.28828707
2,2,car,4294967277,1090,365,555,-4294966187,190,0.21405561
3,2,car,4294967294,1076,365,560,-4294966218,195,0.28676075
4,2,car,4294967275,1087,380,566,-4294966188,186,0.22077179
5,2,car,4294967273,1061,378,575,-4294966212,197,0.31963575
6,2,car,13,1082,373,578,1069,205,0.5401667
7,2,car,14,1056,383,578,1042,195,0.2695259
8,2,car,4294967270,1099,386,564,-4294966171,178,0.24828371
9,2,car,4294967286,966,380,574,-4294966320,194,0.26321974
0,2,car,4294967271,1075,377,560,-4294966196,183,0.3504756
1,2,car,4294967278,1089,361,549,-4294966189,188,0.28828707
2,2,car,4294967277,1090,365,555,-4294966187,190,0.21405561
3,2,car,4294967294,1076,365,560,-4294966218,195,0.28676075
4,2,car,4294967275,1087,380,566,-4294966188,186,0.22077179
5,2,car,4294967273,1061,378,575,-4294966212,197,0.31963575
6,2,car,13,1082,373,578,1069,205,0.5401667
7,2,car,14,1056,383,578,1042,195,0.2695259
8,2,car,4294967270,1099,386,564,-4294966171,178,0.24828371
9,2,car,4294967286,966,380,574,-4294966320,194,0.26321974
0,2,car,4294967271,1075,377,560,-4294966196,183,0.3504756
1,2,car,4294967278,1089,361,549,-4294966189,188,0.28828707
2,2,car,4294967277,1090,365,555,-4294966187,190,0.21405561
3,2,car,4294967294,1076,365,560,-4294966218,195,0.28676075
4,2,car,4294967275,1087,380,566,-4294966188,186,0.22077179
5,2,car,4294967273,1061,378,575,-4294966212,197,0.31963575
6,2,car,13,1082,373,578,1069,205,0.5401667
7,2,car,14,1056,383,578,1042,195,0.2695259
8,2,car,4294967270,1099,386,564,-4294966171,178,0.24828371
9,2,car,4294967286,966,380,574,-4294966320,194,0.26321974
0,2,car,4294967271,1075,377,560,-4294966196,183,0.3504756
1,2,car,4294967278,1089,361,549,-4294966189,188,0.28828707
2,2,car,4294967277,1090,365,555,-4294966187,190,0.21405561
3,2,car,4294967294,1076,365,560,-4294966218,195,0.28676075
4,2,car,4294967275,1087,380,566,-4294966188,186,0.22077179
5,2,car,4294967273,1061,378,575,-4294966212,197,0.31963575
6,2,car,13,1082,373,578,1069,205,0.5401667
7,2,car,14,1056,383,578,1042,195,0.2695259
8,2,car,4294967270,1099,386,564,-4294966171,178,0.24828371
9,2,car,4294967286,966,380,574,-4294966320,194,0.26321974
0,2,car,4294967271,1075,377,560,-4294966196,183,0.3504756
1,2,car,4294967278,1089,361,549,-4294966189,188,0.28828707
2,2,car,4294967277,1090,365,555,-4294966187,190,0.21405561
3,2,car,4294967294,1076,365,560,-4294966218,195,0.28676075
4,2,car,4294967275,1087,380,566,-4294966188,186,0.22077179
5,2,car,4294967273,1061,378,575,-4294966212,197,0.31963575
6,2,car,13,1082,373,578,1069,205,0.5401667
7,2,car,14,1056,383,578,1042,195,0.2695259
8,2,car,4294967270,1099,386,564,-4294966171,178,0.24828371
9,2,car,4294967286,966,380,574,-4294966320,194,0.26321974
0,2,car,4294967271,1075,377,560,-4294966196,183,0.3504756
1,2,car,4294967278,1089,361,549,-4294966189,188,0.28828707
2,2,car,4294967277,1090,365,555,-4294966187,190,0.21405561
3,2,car,4294967294,1076,365,560,-4294966218,195,0.28676075
4,2,car,4294967275,1087,380,566,-4294966188,186,0.22077179
5,2,car,4294967273,1061,378,575,-4294966212,197,0.31963575
6,2,car,13,1082,373,578,1069,205,0.5401667
7,2,car,14,1056,383,578,1042,195,0.2695259
8,2,car,4294967270,1099,386,564,-4294966171,178,0.24828371
9,2,car,4294967286,966,380,574,-4294966320,194,0.26321974
0,2,car,4294967271,1075,377,560,-4294966196,183,0.3504756
1,2,car,4294967278,1089,361,549,-4294966189,188,0.28828707
2,2,car,4294967277,1090,365,555,-4294966187,190,0.21405561
3,2,car,4294967294,1076,365,560,-4294966218,195,0.28676075
4,2,car,4294967275,1087,380,566,-4294966188,186,0.22077179
5,2,car,4294967273,1061,378,575,-4294966212,197,0.31963575
6,2,car,13,1082,373,578,1069,205,0.5401667
7,2,car,14,1056,383,578,1042,195,0.2695259
8,2,car,4294967270,1099,386,564,-4294966171,178,0.24828371
9,2,car,4294967286,966,380,574,-4294966320,194,0.26321974
0,2,car,4294967271,1075,377,560,-4294966196,183,0.3504756
1,2,car,4294967278,1089,361,549,-4294966189,188,0.28828707
2,2,car,4294967277,1090,365,555,-4294966187,190,0.21405561
3,2,car,4294967294,1076,365,560,-4294966218,195,0.28676075
4,2,car,4294967275,1087,380,566,-4294966188,186,0.22077179
5,2,car,4294967273,1061,378,575,-4294966212,197,0.31963575
6,2,car,13,1082,373,578,1069,205,0.5401667
7,2,car,14,1056,383,578,1042,195,0.2695259
8,2,car,4294967270,1099,386,564,-4294966171,178,0.24828371
9,2,car,4294967286,966,380,574,-4294966320,194,0.26321974
0,2,car,4294967271,1075,377,560,-4294966196,183,0.3504756
1,2,car,4294967278,1089,361,549,-4294966189,188,0.28828707
2,2,car,4294967277,1090,365,555,-4294966187,190,0.21405561
3,2,car,4294967294,1076,365,560,-4294966218,195,0.28676075
4,2,car,4294967275,1087,380,566,-4294966188,186,0.22077179
5,2,car,4294967273,1061,378,575,-4294966212,197,0.31963575
6,2,car,13,1082,373,578,1069,205,0.5401667
7,2,car,14,1056,383,578,1042,195,0.2695259
8,2,car,4294967270,1099,386,564,-4294966171,178,0.24828371
9,2,car,4294967286,966,380,574,-4294966320,194,0.26321974
0,2,car,4294967271,1075,377,560,-4294966196,183,0.3504756
1,2,car,4294967278,1089,361,549,-4294966189,188,0.28828707
2,2,car,4294967277,1090,365,555,-4294966187,190,0.21405561
3,2,car,4294967294,1076,365,560,-4294966218,195,0.28676075
4,2,car,4294967275,1087,380,566,-4294966188,186,0.22077179
5,2,car,4294967273,1061,378,575,-4294966212,197,0.31963575
6,2,car,13,1082,373,578,1069,205,0.5401667
7,2,car,14,1056,383,578,1042,195,0.2695259
8,2,car,4294967270,1099,386,564,-4294966171,178,0.24828371
9,2,car,4294967286,966,380,574,-4294966320,194,0.26321974
0,2,car,4294967271,1075,377,560,-4294966196,183,0.3504756
1,2,car,4294967278,1089,361,549,-4294966189,188,0.28828707
2,2,car,4294967277,1090,365,555,-4294966187,190,0.21405561
3,2,car,4294967294,1076,365,560,-4294966218,195,0.28676075
4,2,car,4294967275,1087,380,566,-4294966188,186,0.22077179
5,2,car,4294967273,1061,378,575,-4294966212,197,0.31963575
6,2,car,13,1082,373,578,1069,205,0.5401667
7,2,car,14,1056,383,578,1042,195,0.2695259
8,2,car,4294967270,1099,386,564,-4294966171,178,0.24828371
9,2,car,4294967286,966,380,574,-4294966320,194,0.26321974
0,2,car,4294967271,1075,377,560,-4294966196,183,0.3504756
1,2,car,4294967278,1089,361,549,-4294966189,188,0.28828707
2,2,car,4294967277,1090,365,555,-4294966187,190,0.21405561
3,2,car,4294967294,1076,365,560,-4294966218,195,0.28676075
4,2,car,4294967275,1087,380,566,-4294966188,186,0.22077179
5,2,car,4294967273,1061,378,575,-4294966212,197,0.31963575
6,2,car,13,1082,373,578,1069,205,0.5401667
7,2,car,14,1056,383,578,1042,195,0.2695259
8,2,car,4294967270,1099,386,564,-4294966171,178,0.24828371
9,2,car,4294967286,966,380,574,-4294966320,194,0.26321974
0,2,car,4294967271,1075,377,560,-4294966196,183,0.3504756
1,2,car,4294967278,1089,361,549,-4294966189,188,0.28828707
2,2,car,4294967277,1090,365,555,-4294966187,190,0.21405561
3,2,car,4294967294,1076,365,560,-4294966218,195,0.28676075
4,2,car,4294967275,1087,380,566,-4294966188,186,0.22077179
5,2,car,4294967273,1061,378,575,-4294966212,197,0.31963575
6,2,car,13,1082,373,578,1069,205,0.5401667
7,2,car,14,1056,383,578,1042,195,0.2695259
8,2,car,4294967270,1099,386,564,-4294966171,178,0.24828371
9,2,car,4294967286,966,380,574,-4294966320,194,0.26321974
0,2,car,4294967271,1075,377,560,-4294966196,183,0.3504756
1,2,car,4294967278,1089,361,549,-4294966189,188,0.28828707
2,2,car,4294967277,1090,365,555,-4294966187,190,0.21405561
3,2,car,4294967294,1076,365,560,-4294966218,195,0.28676075
4,2,car,4294967275,1087,380,566,-4294966188,186,0.22077179
5,2,car,4294967273,1061,378,575,-4294966212,197,0.31963575
6,2,car,13,1082,373,578,1069,205,0.5401667
7,2,car,14,1056,383,578,1042,195,0.2695259
8,2,car,4294967270,1099,386,564,-4294966171,178,0.24828371
9,2,car,4294967286,966,380,574,-4294966320,194,0.26321974
0,2,car,4294967271,1075,377,560,-4294966196,183,0.3504756
1,2,car,4294967278,1089,361,549,-4294966189,188,0.28828707
2,2,car,4294967277,1090,365,555,-4294966187,190,0.21405561
3,2,car,4294967294,1076,365,560,-4294966218,195,0.28676075
4,2,car,4294967275,1087,380,566,-4294966188,186,0.22077179
5,2,car,4294967273,1061,378,575,-4294966212,197,0.31963575
6,2,car,13,1082,373,578,1069,205,0.5401667
7,2,car,14,1056,383,578,1042,195,0.2695259
8,2,car,4294967270,1099,386,564,-4294966171,178,0.24828371
9,2,car,4294967286,966,380,574,-4294966320,194,0.26321974
0,2,car,4294967271,1075,377,560,-4294966196,183,0.3504756
1,2,car,4294967278,1089,361,549,-4294966189,188,0.28828707
2,2,car,4294967277,1090,365,555,-4294966187,190,0.21405561
3,2,car,4294967294,1076,365,560,-4294966218,195,0.28676075
4,2,car,4294967275,1087,380,566,-4294966188,186,0.22077179
5,2,car,4294967273,1061,378,575,-4294966212,197,0.31963575
6,2,car,13,1082,373,578,1069,205,0.5401667
7,2,car,14,1056,383,578,1042,195,0.2695259
8,2,car,4294967270,1099,386,564,-4294966171,178,0.24828371
9,2,car,4294967286,966,380,574,-4294966320,194,0.26321974
0,2,car,4294967271,1075,377,560,-4294966196,183,0.3504756
1,2,car,4294967278,1089,361,549,-4294966189,188,0.28828707
2,2,car,4294967277,1090,365,555,-4294966187,190,0.21405561
3,2,car,4294967294,1076,365,560,-4294966218,195,0.28676075
4,2,car,4294967275,1087,380,566,-4294966188,186,0.22077179
5,2,car,4294967273,1061,378,575,-4294966212,197,0.31963575
6,2,car,13,1082,373,578,1069,205,0.5401667
7,2,car,14,1056,383,578,1042,195,0.2695259
8,2,car,4294967270,1099,386,564,-4294966171,178,0.24828371
9,2,car,4294967286,966,380,574,-4294966320,194,0.26321974
0,2,car,4294967271,1075,377,560,-4294966196,183,0.3504756
1,2,car,4294967278,1089,361,549,-4294966189,188,0.28828707
2,2,car,4294967277,1090,365,555,-4294966187,190,0.21405561
3,2,car,4294967294,1076,365,560,-4294966218,195,0.28676075
4,2,car,4294967275,1087,380,566,-4294966188,186,0.22077179
5,2,car,4294967273,1061,378,575,-4294966212,197,0.31963575
6,2,car,13,1082,373,578,1069,205,0.5401667
7,2,car,14,1056,383,578,1042,195,0.2695259
8,2,car,4294967270,1099,386,564,-4294966171,178,0.24828371
9,2,car,4294967286,966,380,574,-4294966320,194,0.26321974
0,2,car,4294967271,1075,377,560,-4294966196,183,0.3504756
1,2,car,4294967278,1089,361,549,-4294966189,188,0.28828707
2,2,car,4294967277,1090,365,555,-4294966187,190,0.21405561
3,2,car,4294967294,1076,365,560,-4294966218,195,0.28676075
4,2,car,4294967275,1087,380,566,-4294966188,186,0.22077179
5,2,car,4294967273,1061,378,575,-4294966212,197,0.31963575
6,2,car,13,1082,373,578,1069,205,0.5401667
7,2,car,14,1056,383,578,1042,195,0.2695259
8,2,car,4294967270,1099,386,564,-4294966171,178,0.24828371
9,2,car,4294967286,966,380,574,-4294966320,194,0.26321974
0,2,car,4294967271,1075,377,560,-4294966196,183,0.3504756
1,2,car,4294967278,1089,361,549,-4294966189,188,0.28828707
2,2,car,4294967277,1090,365,555,-4294966187,190,0.21405561
3,2,car,4294967294,1076,365,560,-4294966218,195,0.28676075
4,2,car,4294967275,1087,380,566,-4294966188,186,0.22077179
5,2,car,4294967273,1061,378,575,-4294966212,197,0.31963575
6,2,car,13,1082,373,578,1069,205,0.5401667
7,2,car,14,1056,383,578,1042,195,0.2695259
8,2,car,4294967270,1099,386,564,-4294966171,178,0.24828371
9,2,car,4294967286,966,380,574,-4294966320,194,0.26321974
0,2,car,4294967271,1075,377,560,-4294966196,183,0.3504756
1,2,car,4294967278,1089,361,549,-4294966189,188,0.28828707
2,2,car,4294967277,1090,365,555,-4294966187,190,0.21405561
3,2,car,4294967294,1076,365,560,-4294966218,195,0.28676075
4,2,car,4294967275,1087,380,566,-4294966188,186,0.22077179
5,2,car,4294967273,1061,378,575,-4294966212,197,0.31963575
6,2,car,13,1082,373,578,1069,205,0.5401667
7,2,car,14,1056,383,578,1042,195,0.2695259
8,2,car,4294967270,1099,386,564,-4294966171,178,0.24828371
9,2,car,4294967286,966,380,574,-4294966320,194,0.26321974
0,2,car,4294967271,1075,377,560,-4294966196,183,0.3504756
1,2,car,4294967278,1089,361,549,-4294966189,188,0.28828707
2,2,car,4294967277,1090,365,555,-4294966187,190,0.21405561
3,2,car,4294967294,1076,365,560,-4294966218,195,0.28676075
4,2,car,4294967275,1087,380,566,-4294966188,186,0.22077179
5,2,car,4294967273,1061,378,575,-4294966212,197,0.31963575
6,2,car,13,1082,373,578,1069,205,0.5401667
7,2,car,14,1056,383,578,1042,195,0.2695259
8,2,car,4294967270,1099,386,564,-4294966171,178,0.24828371
9,2,car,4294967286,966,380,574,-4294966320,194,0.26321974
0,2,car,4294967271,1075,377,560,-4294966196,183,0.3504756
1,2,car,4294967278,1089,361,549,-4294966189,188,0.28828707
2,2,car,4294967277,1090,365,555,-4294966187,190,0.21405561
3,2,car,4294967294,1076,365,560,-4294966218,195,0.28676075
4,2,car,4294967275,1087,380,566,-4294966188,186,0.22077179
5,2,car,4294967273,1061,378,575,-4294966212,197,0.31963575
6,2,car,13,1082,373,578,1069,205,0.5401667
7,2,car,14,1056,383,578,1042,195,0.2695259
8,2,car,4294967270,1099,386,564,-4294966171,178,0.24828371
9,2,car,4294967286,966,380,574,-4294966320,194,0.26321974
0,2,car,4294967271,1075,377,560,-4294966196,183,0.3504756
1,2,car,4294967278,1089,361,549,-4294966189,188,0.28828707
2,2,car,4294967277,1090,365,555,-4294966187,190,0.21405561
3,2,car,4294967294,1076,365,560,-4294966218,195,0.28676075
4,2,car,4294967275,1087,380,566,-4294966188,186,0.22077179
5,2,car,4294967273,1061,378,575,-4294966212,197,0.31963575
6,2,car,13,1082,373,578,1069,205,0.5401667
7,2,car,14,1056,383,578,1042,195,0.2695259
8,2,car,4294967270,1099,386,564,-4294966171,178,0.24828371
9,2,car,4294967286,966,380,574,-4294966320,194,0.26321974
0,2,car,4294967271,1075,377,560,-4294966196,183,0.3504756
1,2,car,4294967278,1089,361,549,-4294966189,188,0.28828707
2,2,car,4294967277,1090,365,555,-4294966187,190,0.21405561
3,2,car,4294967294,1076,365,560,-4294966218,195,0.28676075
4,2,car,4294967275,1087,380,566,-4294966188,186,0.22077179
5,2,car,4294967273,1061,378,575,-4294966212,197,0.31963575
6,2,car,13,1082,373,578,1069,205,0.5401667
7,2,car,14,1056,383,578,1042,195,0.2695259
8,2,car,4294967270,1099,386,564,-4294966171,178,0.24828371
9,2,car,4294967286,966,380,574,-4294966320,194,0.26321974
0,2,car,4294967271,1075,377,560,-4294966196,183,0.3504756
1,2,car,4294967278,1089,361,549,-4294966189,188,0.28828707
2,2,car,4294967277,1090,365,555,-4294966187,190,0.21405561
3,2,car,4294967294,1076,365,560,-4294966218,195,0.28676075
4,2,car,4294967275,1087,380,566,-4294966188,186,0.22077179
5,2,car,4294967273,1061,378,575,-4294966212,197,0.31963575
6,2,car,13,1082,373,578,1069,205,0.5401667
7,2,car,14,1056,383,578,1042,195,0.2695259
8,2,car,4294967270,1099,386,564,-4294966171,178,0.24828371
9,2,car,4294967286,966,380,574,-4294966320,194,0.26321974
0,2,car,4294967271,1075,377,560,-4294966196,183,0.3504756
1,2,car,4294967278,1089,361,549,-4294966189,188,0.28828707
2,2,car,4294967277,1090,365,555,-4294966187,190,0.21405561
3,2,car,4294967294,1076,365,560,-4294966218,195,0.28676075
4,2,car,4294967275,1087,380,566,-4294966188,186,0.22077179
5,2,car,4294967273,1061,378,575,-4294966212,197,0.31963575
6,2,car,13,1082,373,578,1069,205,0.5401667
7,2,car,14,1056,383,578,1042,195,0.2695259
8,2,car,4294967270,1099,386,564,-4294966171,178,0.24828371
9,2,car,4294967286,966,380,574,-4294966320,194,0.26321974
0,2,car,4294967271,1075,377,560,-4294966196,183,0.3504756
1,2,car,4294967278,1089,361,549,-4294966189,188,0.28828707
2,2,car,4294967277,1090,365,555,-4294966187,190,0.21405561
3,2,car,4294967294,1076,365,560,-4294966218,195,0.28676075
4,2,car,4294967275,1087,380,566,-4294966188,186,0.22077179
5,2,car,4294967273,1061,378,575,-4294966212,197,0.31963575
6,2,car,13,1082,373,578,1069,205,0.5401667
7,2,car,14,1056,383,578,1042,195,0.2695259
8,2,car,4294967270,1099,386,564,-4294966171,178,0.24828371
9,2,car,4294967286,966,380,574,-4294966320,194,0.26321974
0,2,car,4294967271,1075,377,560,-4294966196,183,0.3504756
1,2,car,4294967278,1089,361,549,-4294966189,188,0.28828707
2,2,car,4294967277,1090,365,555,-4294966187,190,0.21405561
3,2,car,4294967294,1076,365,560,-4294966218,195,0.28676075
4,2,car,4294967275,1087,380,566,-4294966188,186,0.22077179
5,2,car,4294967273,1061,378,575,-4294966212,197,0.31963575
6,2,car,13,1082,373,578,1069,205,0.5401667
7,2,car,14,1056,383,578,1042,195,0.2695259
8,2,car,4294967270,1099,386,564,-4294966171,178,0.24828371
9,2,car,4294967286,966,380,574,-4294966320,194,0.26321974
0,2,car,4294967271,1075,377,560,-4294966196,183,0.3504756
1,2,car,4294967278,1089,361,549,-4294966189,188,0.28828707
2,2,car,4294967277,1090,365,555,-4294966187,190,0.21405561
3,2,car,4294967294,1076,365,560,-4294966218,195,0.28676075
4,2,car,4294967275,1087,380,566,-4294966188,186,0.22077179
5,2,car,4294967273,1061,378,575,-4294966212,197,0.31963575
6,2,car,13,1082,373,578,1069,205,0.5401667
7,2,car,14,1056,383,578,1042,195,0.2695259
8,2,car,4294967270,1099,386,564,-4294966171,178,0.24828371
9,2,car,4294967286,966,380,574,-4294966320,194,0.26321974
0,2,car,4294967271,1075,377,560,-4294966196,183,0.3504756
1,2,car,4294967278,1089,361,549,-4294966189,188,0.28828707
2,2,car,4294967277,1090,365,555,-4294966187,190,0.21405561
3,2,car,4294967294,1076,365,560,-4294966218,195,0.28676075
4,2,car,4294967275,1087,380,566,-4294966188,186,0.22077179
5,2,car,4294967273,1061,378,575,-4294966212,197,0.31963575
6,2,car,13,1082,373,578,1069,205,0.5401667
7,2,car,14,1056,383,578,1042,195,0.2695259
8,2,car,4294967270,1099,386,564,-4294966171,178,0.24828371
9,2,car,4294967286,966,380,574,-4294966320,194,0.26321974
0,2,car,4294967271,1075,377,560,-4294966196,183,0.3504756
1,2,car,4294967278,1089,361,549,-4294966189,188,0.28828707
2,2,car,4294967277,1090,365,555,-4294966187,190,0.21405561
3,2,car,4294967294,1076,365,560,-4294966218,195,0.28676075
4,2,car,4294967275,1087,380,566,-4294966188,186,0.22077179
5,2,car,4294967273,1061,378,575,-4294966212,197,0.31963575
6,2,car,13,1082,373,578,1069,205,0.5401667
7,2,car,14,1056,383,578,1042,195,0.2695259
8,2,car,4294967270,1099,386,564,-4294966171,178,0.24828371
9,2,car,4294967286,966,380,574,-4294966320,194,0.26321974
0,2,car,4294967271,1075,377,560,-4294966196,183,0.3504756
1,2,car,4294967278,1089,361,549,-4294966189,188,0.28828707
2,2,car,4294967277,1090,365,555,-4294966187,190,0.21405561
3,2,car,4294967294,1076,365,560,-4294966218,195,0.28676075
4,2,car,4294967275,1087,380,566,-4294966188,186,0.22077179
5,2,car,4294967273,1061,378,575,-4294966212,197,0.31963575
6,2,car,13,1082,373,578,1069,205,0.5401667
7,2,car,14,1056,383,578,1042,195,0.2695259
8,2,car,4294967270,1099,386,564,-4294966171,178,0.24828371
9,2,car,4294967286,966,380,574,-4294966320,194,0.26321974
0,2,car,4294967271,1075,377,560,-4294966196,183,0.3504756
1,2,car,4294967278,1089,361,549,-4294966189,188,0.28828707
2,2,car,4294967277,1090,365,555,-4294966187,190,0.21405561
3,2,car,4294967294,1076,365,560,-4294966218,195,0.28676075
4,2,car,4294967275,1087,380,566,-4294966188,186,0.22077179
5,2,car,4294967273,1061,378,575,-4294966212,197,0.31963575
6,2,car,13,1082,373,578,1069,205,0.5401667
7,2,car,14,1056,383,578,1042,195,0.2695259
8,2,car,4294967270,1099,386,564,-4294966171,178,0.24828371
9,2,car,4294967286,966,380,574,-4294966320,194,0.26321974
0,2,car,4294967271,1075,377,560,-4294966196,183,0.3504756
1,2,car,4294967278,1089,361,549,-4294966189,188,0.28828707
2,2,car,4294967277,1090,365,555,-4294966187,190,0.21405561
3,2,car,4294967294,1076,365,560,-4294966218,195,0.28676075
4,2,car,4294967275,1087,380,566,-4294966188,186,0.22077179
5,2,car,4294967273,1061,378,575,-4294966212,197,0.31963575
6,2,car,13,1082,373,578,1069,205,0.5401667
7,2,car,14,1056,383,578,1042,195,0.2695259
8,2,car,4294967270,1099,386,564,-4294966171,178,0.24828371
9,2,car,4294967286,966,380,574,-4294966320,194,0.26321974
0,2,car,4294967271,1075,377,560,-4294966196,183,0.3504756
1,2,car,4294967278,1089,361,549,-4294966189,188,0.28828707
2,2,car,4294967277,1090,365,555,-4294966187,190,0.21405561
3,2,car,4294967294,1076,365,560,-4294966218,195,0.28676075
4,2,car,4294967275,1087,380,566,-4294966188,186,0.22077179
5,2,car,4294967273,1061,378,575,-4294966212,197,0.31963575
6,2,car,13,1082,373,578,1069,205,0.5401667
7,2,car,14,1056,383,578,1042,195,0.2695259
8,2,car,4294967270,1099,386,564,-4294966171,178,0.24828371
9,2,car,4294967286,966,380,574,-4294966320,194,0.26321974
0,2,car,4294967271,1075,377,560,-4294966196,183,0.3504756
1,2,car,4294967278,1089,361,549,-4294966189,188,0.28828707
2,2,car,4294967277,1090,365,555,-4294966187,190,0.21405561
3,2,car,4294967294,1076,365,560,-4294966218,195,0.28676075
4,2,car,4294967275,1087,380,566,-4294966188,186,0.22077179
5,2,car,4294967273,1061,378,575,-4294966212,197,0.31963575
6,2,car,13,1082,373,578,1069,205,0.5401667
7,2,car,14,1056,383,578,1042,195,0.2695259
8,2,car,4294967270,1099,386,564,-4294966171,178,0.24828371
9,2,car,4294967286,966,380,574,-4294966320,194,0.26321974
0,2,car,4294967271,1075,377,560,-4294966196,183,0.3504756
1,2,car,4294967278,1089,361,549,-4294966189,188,0.28828707
2,2,car,4294967277,1090,365,555,-4294966187,190,0.21405561
3,2,car,4294967294,1076,365,560,-4294966218,195,0.28676075
4,2,car,4294967275,1087,380,566,-4294966188,186,0.22077179
5,2,car,4294967273,1061,378,575,-4294966212,197,0.31963575
6,2,car,13,1082,373,578,1069,205,0.5401667
7,2,car,14,1056,383,578,1042,195,0.2695259
8,2,car,4294967270,1099,386,564,-4294966171,178,0.24828371
9,2,car,4294967286,966,380,574,-4294966320,194,0.26321974
0,2,car,4294967271,1075,377,560,-4294966196,183,0.3504756
1,2,car,4294967278,1089,361,549,-4294966189,188,0.28828707
2,2,car,4294967277,1090,365,555,-4294966187,190,0.21405561
3,2,car,4294967294,1076,365,560,-4294966218,195,0.28676075
4,2,car,4294967275,1087,380,566,-4294966188,186,0.22077179
5,2,car,4294967273,1061,378,575,-4294966212,197,0.31963575
6,2,car,13,1082,373,578,1069,205,0.5401667
7,2,car,14,1056,383,578,1042,195,0.2695259
8,2,car,4294967270,1099,386,564,-4294966171,178,0.24828371
9,2,car,4294967286,966,380,574,-4294966320,194,0.26321974
0,2,car,4294967271,1075,377,560,-4294966196,183,0.3504756
1,2,car,4294967278,1089,361,549,-4294966189,188,0.28828707
2,2,car,4294967277,1090,365,555,-4294966187,190,0.21405561
3,2,car,4294967294,1076,365,560,-4294966218,195,0.28676075
4,2,car,4294967275,1087,380,566,-4294966188,186,0.22077179
5,2,car,4294967273,1061,378,575,-4294966212,197,0.31963575
6,2,car,13,1082,373,578,1069,205,0.5401667
7,2,car,14,1056,383,578,1042,195,0.2695259
8,2,car,4294967270,1099,386,564,-4294966171,178,0.24828371
9,2,car,4294967286,966,380,574,-4294966320,194,0.26321974
0,2,car,4294967271,1075,377,560,-4294966196,183,0.3504756
1,2,car,4294967278,1089,361,549,-4294966189,188,0.28828707
2,2,car,4294967277,1090,365,555,-4294966187,190,0.21405561
3,2,car,4294967294,1076,365,560,-4294966218,195,0.28676075
4,2,car,4294967275,1087,380,566,-4294966188,186,0.22077179
5,2,car,4294967273,1061,378,575,-4294966212,197,0.31963575
6,2,car,13,1082,373,578,1069,205,0.5401667
7,2,car,14,1056,383,578,1042,195,0.2695259
8,2,car,4294967270,1099,386,564,-4294966171,178,0.24828371
9,2,car,4294967286,966,380,574,-4294966320,194,0.26321974
0,2,car,502,594,508,564,92,56,0.87572163
1,2,car,4294967271,1075,377,560,-4294966196,183,0.3504756
2,2,car,4294967278,1089,361,549,-4294966189,188,0.28828707
3,2,car,4294967277,1090,365,555,-4294966187,190,0.21405561
4,2,car,4294967294,1076,365,560,-4294966218,195,0.28676075
5,2,car,4294967275,1087,380,566,-4294966188,186,0.22077179
6,2,car,4294967273,1061,378,575,-4294966212,197,0.31963575
7,2,car,13,1082,373,578,1069,205,0.5401667
8,2,car,14,1056,383,578,1042,195,0.2695259
9,2,car,4294967270,1099,386,564,-4294966171,178,0.24828371
10,2,car,4294967286,966,380,574,-4294966320,194,0.26321974
0,2,car,501,591,508,565,90,57,0.5544183
1,2,car,502,594,508,564,92,56,0.87572163
2,2,car,4294967271,1075,377,560,-4294966196,183,0.3504756
3,2,car,4294967278,1089,361,549,-4294966189,188,0.28828707
4,2,car,4294967277,1090,365,555,-4294966187,190,0.21405561
5,2,car,4294967294,1076,365,560,-4294966218,195,0.28676075
6,2,car,4294967275,1087,380,566,-4294966188,186,0.22077179
7,2,car,4294967273,1061,378,575,-4294966212,197,0.31963575
8,2,car,13,1082,373,578,1069,205,0.5401667
9,2,car,14,1056,383,578,1042,195,0.2695259
10,2,car,4294967270,1099,386,564,-4294966171,178,0.24828371
11,2,car,4294967286,966,380,574,-4294966320,194,0.26321974
0,2,car,502,592,508,565,90,57,0.76711863
1,2,car,501,591,508,565,90,57,0.5544183
2,2,car,502,594,508,564,92,56,0.87572163
3,2,car,4294967271,1075,377,560,-4294966196,183,0.3504756
4,2,car,4294967278,1089,361,549,-4294966189,188,0.28828707
5,2,car,4294967277,1090,365,555,-4294966187,190,0.21405561
6,2,car,4294967294,1076,365,560,-4294966218,195,0.28676075
7,2,car,4294967275,1087,380,566,-4294966188,186,0.22077179
8,2,car,4294967273,1061,378,575,-4294966212,197,0.31963575
9,2,car,13,1082,373,578,1069,205,0.5401667
10,2,car,14,1056,383,578,1042,195,0.2695259
11,2,car,4294967270,1099,386,564,-4294966171,178,0.24828371
12,2,car,4294967286,966,380,574,-4294966320,194,0.26321974
0,2,car,495,585,509,566,90,57,0.8718345
1,2,car,502,592,508,565,90,57,0.76711863
2,2,car,501,591,508,565,90,57,0.5544183
3,2,car,502,594,508,564,92,56,0.87572163
4,2,car,4294967271,1075,377,560,-4294966196,183,0.3504756
5,2,car,4294967278,1089,361,549,-4294966189,188,0.28828707
6,2,car,4294967277,1090,365,555,-4294966187,190,0.21405561
7,2,car,4294967294,1076,365,560,-4294966218,195,0.28676075
8,2,car,4294967275,1087,380,566,-4294966188,186,0.22077179
9,2,car,4294967273,1061,378,575,-4294966212,197,0.31963575
10,2,car,13,1082,373,578,1069,205,0.5401667
11,2,car,14,1056,383,578,1042,195,0.2695259
12,2,car,4294967270,1099,386,564,-4294966171,178,0.24828371
13,2,car,4294967286,966,380,574,-4294966320,194,0.26321974
0,2,car,507,594,508,565,87,57,0.7380539
1,2,car,495,585,509,566,90,57,0.8718345
2,2,car,502,592,508,565,90,57,0.76711863
3,2,car,501,591,508,565,90,57,0.5544183
4,2,car,502,594,508,564,92,56,0.87572163
5,2,car,4294967271,1075,377,560,-4294966196,183,0.3504756
6,2,car,4294967278,1089,361,549,-4294966189,188,0.28828707
7,2,car,4294967277,1090,365,555,-4294966187,190,0.21405561
8,2,car,4294967294,1076,365,560,-4294966218,195,0.28676075
9,2,car,4294967275,1087,380,566,-4294966188,186,0.22077179
10,2,car,4294967273,1061,378,575,-4294966212,197,0.31963575
11,2,car,13,1082,373,578,1069,205,0.5401667
12,2,car,14,1056,383,578,1042,195,0.2695259
13,2,car,4294967270,1099,386,564,-4294966171,178,0.24828371
14,2,car,4294967286,966,380,574,-4294966320,194,0.26321974
0,2,car,507,593,509,566,86,57,0.7786368
1,2,car,507,594,508,565,87,57,0.7380539
2,2,car,495,585,509,566,90,57,0.8718345
3,2,car,502,592,508,565,90,57,0.76711863
4,2,car,501,591,508,565,90,57,0.5544183
5,2,car,502,594,508,564,92,56,0.87572163
6,2,car,4294967271,1075,377,560,-4294966196,183,0.3504756
7,2,car,4294967278,1089,361,549,-4294966189,188,0.28828707
8,2,car,4294967277,1090,365,555,-4294966187,190,0.21405561
9,2,car,4294967294,1076,365,560,-4294966218,195,0.28676075
10,2,car,4294967275,1087,380,566,-4294966188,186,0.22077179
11,2,car,4294967273,1061,378,575,-4294966212,197,0.31963575
12,2,car,13,1082,373,578,1069,205,0.5401667
13,2,car,14,1056,383,578,1042,195,0.2695259
14,2,car,4294967270,1099,386,564,-4294966171,178,0.24828371
15,2,car,4294967286,966,380,574,-4294966320,194,0.26321974
0,2,car,506,594,506,566,88,60,0.76903325
1,2,car,507,593,509,566,86,57,0.7786368
2,2,car,507,594,508,565,87,57,0.7380539
3,2,car,495,585,509,566,90,57,0.8718345
4,2,car,502,592,508,565,90,57,0.76711863
5,2,car,501,591,508,565,90,57,0.5544183
6,2,car,502,594,508,564,92,56,0.87572163
7,2,car,4294967271,1075,377,560,-4294966196,183,0.3504756
8,2,car,4294967278,1089,361,549,-4294966189,188,0.28828707
9,2,car,4294967277,1090,365,555,-4294966187,190,0.21405561
10,2,car,4294967294,1076,365,560,-4294966218,195,0.28676075
11,2,car,4294967275,1087,380,566,-4294966188,186,0.22077179
12,2,car,4294967273,1061,378,575,-4294966212,197,0.31963575
13,2,car,13,1082,373,578,1069,205,0.5401667
14,2,car,14,1056,383,578,1042,195,0.2695259
15,2,car,4294967270,1099,386,564,-4294966171,178,0.24828371
16,2,car,4294967286,966,380,574,-4294966320,194,0.26321974
0,2,car,502,593,510,565,91,55,0.89309627
1,2,car,506,594,506,566,88,60,0.76903325
2,2,car,507,593,509,566,86,57,0.7786368
3,2,car,507,594,508,565,87,57,0.7380539
4,2,car,495,585,509,566,90,57,0.8718345
5,2,car,502,592,508,565,90,57,0.76711863
6,2,car,501,591,508,565,90,57,0.5544183
7,2,car,502,594,508,564,92,56,0.87572163
8,2,car,4294967271,1075,377,560,-4294966196,183,0.3504756
9,2,car,4294967278,1089,361,549,-4294966189,188,0.28828707
10,2,car,4294967277,1090,365,555,-4294966187,190,0.21405561
11,2,car,4294967294,1076,365,560,-4294966218,195,0.28676075
12,2,car,4294967275,1087,380,566,-4294966188,186,0.22077179
13,2,car,4294967273,1061,378,575,-4294966212,197,0.31963575
14,2,car,13,1082,373,578,1069,205,0.5401667
15,2,car,14,1056,383,578,1042,195,0.2695259
16,2,car,4294967270,1099,386,564,-4294966171,178,0.24828371
17,2,car,4294967286,966,380,574,-4294966320,194,0.26321974
0,2,car,501,591,509,564,90,55,0.88262093
1,2,car,502,593,510,565,91,55,0.89309627
2,2,car,506,594,506,566,88,60,0.76903325
3,2,car,507,593,509,566,86,57,0.7786368
4,2,car,507,594,508,565,87,57,0.7380539
5,2,car,495,585,509,566,90,57,0.8718345
6,2,car,502,592,508,565,90,57,0.76711863
7,2,car,501,591,508,565,90,57,0.5544183
8,2,car,502,594,508,564,92,56,0.87572163
9,2,car,4294967271,1075,377,560,-4294966196,183,0.3504756
10,2,car,4294967278,1089,361,549,-4294966189,188,0.28828707
11,2,car,4294967277,1090,365,555,-4294966187,190,0.21405561
12,2,car,4294967294,1076,365,560,-4294966218,195,0.28676075
13,2,car,4294967275,1087,380,566,-4294966188,186,0.22077179
14,2,car,4294967273,1061,378,575,-4294966212,197,0.31963575
15,2,car,13,1082,373,578,1069,205,0.5401667
16,2,car,14,1056,383,578,1042,195,0.2695259
17,2,car,4294967270,1099,386,564,-4294966171,178,0.24828371
18,2,car,4294967286,966,380,574,-4294966320,194,0.26321974
0,2,car,501,590,510,567,89,57,0.72163993
1,2,car,501,591,509,564,90,55,0.88262093
2,2,car,502,593,510,565,91,55,0.89309627
3,2,car,506,594,506,566,88,60,0.76903325
4,2,car,507,593,509,566,86,57,0.7786368
5,2,car,507,594,508,565,87,57,0.7380539
6,2,car,495,585,509,566,90,57,0.8718345
7,2,car,502,592,508,565,90,57,0.76711863
8,2,car,501,591,508,565,90,57,0.5544183
9,2,car,502,594,508,564,92,56,0.87572163
10,2,car,4294967271,1075,377,560,-4294966196,183,0.3504756
11,2,car,4294967278,1089,361,549,-4294966189,188,0.28828707
12,2,car,4294967277,1090,365,555,-4294966187,190,0.21405561
13,2,car,4294967294,1076,365,560,-4294966218,195,0.28676075
14,2,car,4294967275,1087,380,566,-4294966188,186,0.22077179
15,2,car,4294967273,1061,378,575,-4294966212,197,0.31963575
16,2,car,13,1082,373,578,1069,205,0.5401667
17,2,car,14,1056,383,578,1042,195,0.2695259
18,2,car,4294967270,1099,386,564,-4294966171,178,0.24828371
19,2,car,4294967286,966,380,574,-4294966320,194,0.26321974
0,2,car,514,598,507,564,84,57,0.31927696
1,2,car,501,590,510,567,89,57,0.72163993
2,2,car,501,591,509,564,90,55,0.88262093
3,2,car,502,593,510,565,91,55,0.89309627
4,2,car,506,594,506,566,88,60,0.76903325
5,2,car,507,593,509,566,86,57,0.7786368
6,2,car,507,594,508,565,87,57,0.7380539
7,2,car,495,585,509,566,90,57,0.8718345
8,2,car,502,592,508,565,90,57,0.76711863
9,2,car,501,591,508,565,90,57,0.5544183
10,2,car,502,594,508,564,92,56,0.87572163
11,2,car,4294967271,1075,377,560,-4294966196,183,0.3504756
12,2,car,4294967278,1089,361,549,-4294966189,188,0.28828707
13,2,car,4294967277,1090,365,555,-4294966187,190,0.21405561
14,2,car,4294967294,1076,365,560,-4294966218,195,0.28676075
15,2,car,4294967275,1087,380,566,-4294966188,186,0.22077179
16,2,car,4294967273,1061,378,575,-4294966212,197,0.31963575
17,2,car,13,1082,373,578,1069,205,0.5401667
18,2,car,14,1056,383,578,1042,195,0.2695259
19,2,car,4294967270,1099,386,564,-4294966171,178,0.24828371
20,2,car,4294967286,966,380,574,-4294966320,194,0.26321974
0,2,car,515,598,504,560,83,56,0.4257941
1,2,car,514,598,507,564,84,57,0.31927696
2,2,car,501,590,510,567,89,57,0.72163993
3,2,car,501,591,509,564,90,55,0.88262093
4,2,car,502,593,510,565,91,55,0.89309627
5,2,car,506,594,506,566,88,60,0.76903325
6,2,car,507,593,509,566,86,57,0.7786368
7,2,car,507,594,508,565,87,57,0.7380539
8,2,car,495,585,509,566,90,57,0.8718345
9,2,car,502,592,508,565,90,57,0.76711863
10,2,car,501,591,508,565,90,57,0.5544183
11,2,car,502,594,508,564,92,56,0.87572163
12,2,car,4294967271,1075,377,560,-4294966196,183,0.3504756
13,2,car,4294967278,1089,361,549,-4294966189,188,0.28828707
14,2,car,4294967277,1090,365,555,-4294966187,190,0.21405561
15,2,car,4294967294,1076,365,560,-4294966218,195,0.28676075
16,2,car,4294967275,1087,380,566,-4294966188,186,0.22077179
17,2,car,4294967273,1061,378,575,-4294966212,197,0.31963575
18,2,car,13,1082,373,578,1069,205,0.5401667
19,2,car,14,1056,383,578,1042,195,0.2695259
20,2,car,4294967270,1099,386,564,-4294966171,178,0.24828371
21,2,car,4294967286,966,380,574,-4294966320,194,0.26321974
0,2,car,502,592,510,565,90,55,0.89384234
1,2,car,515,598,504,560,83,56,0.4257941
2,2,car,514,598,507,564,84,57,0.31927696
3,2,car,501,590,510,567,89,57,0.72163993
4,2,car,501,591,509,564,90,55,0.88262093
5,2,car,502,593,510,565,91,55,0.89309627
6,2,car,506,594,506,566,88,60,0.76903325
7,2,car,507,593,509,566,86,57,0.7786368
8,2,car,507,594,508,565,87,57,0.7380539
9,2,car,495,585,509,566,90,57,0.8718345
10,2,car,502,592,508,565,90,57,0.76711863
11,2,car,501,591,508,565,90,57,0.5544183
12,2,car,502,594,508,564,92,56,0.87572163
13,2,car,4294967271,1075,377,560,-4294966196,183,0.3504756
14,2,car,4294967278,1089,361,549,-4294966189,188,0.28828707
15,2,car,4294967277,1090,365,555,-4294966187,190,0.21405561
16,2,car,4294967294,1076,365,560,-4294966218,195,0.28676075
17,2,car,4294967275,1087,380,566,-4294966188,186,0.22077179
18,2,car,4294967273,1061,378,575,-4294966212,197,0.31963575
19,2,car,13,1082,373,578,1069,205,0.5401667
20,2,car,14,1056,383,578,1042,195,0.2695259
21,2,car,4294967270,1099,386,564,-4294966171,178,0.24828371
22,2,car,4294967286,966,380,574,-4294966320,194,0.26321974
0,2,car,502,594,510,565,92,55,0.9285165
1,2,car,502,592,510,565,90,55,0.89384234
2,2,car,515,598,504,560,83,56,0.4257941
3,2,car,514,598,507,564,84,57,0.31927696
4,2,car,501,590,510,567,89,57,0.72163993
5,2,car,501,591,509,564,90,55,0.88262093
6,2,car,502,593,510,565,91,55,0.89309627
7,2,car,506,594,506,566,88,60,0.76903325
8,2,car,507,593,509,566,86,57,0.7786368
9,2,car,507,594,508,565,87,57,0.7380539
10,2,car,495,585,509,566,90,57,0.8718345
11,2,car,502,592,508,565,90,57,0.76711863
12,2,car,501,591,508,565,90,57,0.5544183
13,2,car,502,594,508,564,92,56,0.87572163
14,2,car,4294967271,1075,377,560,-4294966196,183,0.3504756
15,2,car,4294967278,1089,361,549,-4294966189,188,0.28828707
16,2,car,4294967277,1090,365,555,-4294966187,190,0.21405561
17,2,car,4294967294,1076,365,560,-4294966218,195,0.28676075
18,2,car,4294967275,1087,380,566,-4294966188,186,0.22077179
19,2,car,4294967273,1061,378,575,-4294966212,197,0.31963575
20,2,car,13,1082,373,578,1069,205,0.5401667
21,2,car,14,1056,383,578,1042,195,0.2695259
22,2,car,4294967270,1099,386,564,-4294966171,178,0.24828371
23,2,car,4294967286,966,380,574,-4294966320,194,0.26321974
0,2,car,504,593,510,564,89,54,0.8912073
1,2,car,502,594,510,565,92,55,0.9285165
2,2,car,502,592,510,565,90,55,0.89384234
3,2,car,515,598,504,560,83,56,0.4257941
4,2,car,514,598,507,564,84,57,0.31927696
5,2,car,501,590,510,567,89,57,0.72163993
6,2,car,501,591,509,564,90,55,0.88262093
7,2,car,502,593,510,565,91,55,0.89309627
8,2,car,506,594,506,566,88,60,0.76903325
9,2,car,507,593,509,566,86,57,0.7786368
10,2,car,507,594,508,565,87,57,0.7380539
11,2,car,495,585,509,566,90,57,0.8718345
12,2,car,502,592,508,565,90,57,0.76711863
13,2,car,501,591,508,565,90,57,0.5544183
14,2,car,502,594,508,564,92,56,0.87572163
15,2,car,4294967271,1075,377,560,-4294966196,183,0.3504756
16,2,car,4294967278,1089,361,549,-4294966189,188,0.28828707
17,2,car,4294967277,1090,365,555,-4294966187,190,0.21405561
18,2,car,4294967294,1076,365,560,-4294966218,195,0.28676075
19,2,car,4294967275,1087,380,566,-4294966188,186,0.22077179
20,2,car,4294967273,1061,378,575,-4294966212,197,0.31963575
21,2,car,13,1082,373,578,1069,205,0.5401667
22,2,car,14,1056,383,578,1042,195,0.2695259
23,2,car,4294967270,1099,386,564,-4294966171,178,0.24828371
24,2,car,4294967286,966,380,574,-4294966320,194,0.26321974
0,2,car,502,595,509,565,93,56,0.9387687
1,2,car,504,593,510,564,89,54,0.8912073
2,2,car,502,594,510,565,92,55,0.9285165
3,2,car,502,592,510,565,90,55,0.89384234
4,2,car,515,598,504,560,83,56,0.4257941
5,2,car,514,598,507,564,84,57,0.31927696
6,2,car,501,590,510,567,89,57,0.72163993
7,2,car,501,591,509,564,90,55,0.88262093
8,2,car,502,593,510,565,91,55,0.89309627
9,2,car,506,594,506,566,88,60,0.76903325
10,2,car,507,593,509,566,86,57,0.7786368
11,2,car,507,594,508,565,87,57,0.7380539
12,2,car,495,585,509,566,90,57,0.8718345
13,2,car,502,592,508,565,90,57,0.76711863
14,2,car,501,591,508,565,90,57,0.5544183
15,2,car,502,594,508,564,92,56,0.87572163
16,2,car,4294967271,1075,377,560,-4294966196,183,0.3504756
17,2,car,4294967278,1089,361,549,-4294966189,188,0.28828707
18,2,car,4294967277,1090,365,555,-4294966187,190,0.21405561
19,2,car,4294967294,1076,365,560,-4294966218,195,0.28676075
20,2,car,4294967275,1087,380,566,-4294966188,186,0.22077179
21,2,car,4294967273,1061,378,575,-4294966212,197,0.31963575
22,2,car,13,1082,373,578,1069,205,0.5401667
23,2,car,14,1056,383,578,1042,195,0.2695259
24,2,car,4294967270,1099,386,564,-4294966171,178,0.24828371
25,2,car,4294967286,966,380,574,-4294966320,194,0.26321974
0,2,car,497,583,508,566,86,58,0.8351104
1,2,car,502,595,509,565,93,56,0.9387687
2,2,car,504,593,510,564,89,54,0.8912073
3,2,car,502,594,510,565,92,55,0.9285165
4,2,car,502,592,510,565,90,55,0.89384234
5,2,car,515,598,504,560,83,56,0.4257941
6,2,car,514,598,507,564,84,57,0.31927696
7,2,car,501,590,510,567,89,57,0.72163993
8,2,car,501,591,509,564,90,55,0.88262093
9,2,car,502,593,510,565,91,55,0.89309627
10,2,car,506,594,506,566,88,60,0.76903325
11,2,car,507,593,509,566,86,57,0.7786368
12,2,car,507,594,508,565,87,57,0.7380539
13,2,car,495,585,509,566,90,57,0.8718345
14,2,car,502,592,508,565,90,57,0.76711863
15,2,car,501,591,508,565,90,57,0.5544183
16,2,car,502,594,508,564,92,56,0.87572163
17,2,car,4294967271,1075,377,560,-4294966196,183,0.3504756
18,2,car,4294967278,1089,361,549,-4294966189,188,0.28828707
19,2,car,4294967277,1090,365,555,-4294966187,190,0.21405561
20,2,car,4294967294,1076,365,560,-4294966218,195,0.28676075
21,2,car,4294967275,1087,380,566,-4294966188,186,0.22077179
22,2,car,4294967273,1061,378,575,-4294966212,197,0.31963575
23,2,car,13,1082,373,578,1069,205,0.5401667
24,2,car,14,1056,383,578,1042,195,0.2695259
25,2,car,4294967270,1099,386,564,-4294966171,178,0.24828371
26,2,car,4294967286,966,380,574,-4294966320,194,0.26321974
0,2,car,504,593,510,564,89,54,0.9110706
1,2,car,497,583,508,566,86,58,0.8351104
2,2,car,502,595,509,565,93,56,0.9387687
3,2,car,504,593,510,564,89,54,0.8912073
4,2,car,502,594,510,565,92,55,0.9285165
5,2,car,502,592,510,565,90,55,0.89384234
6,2,car,515,598,504,560,83,56,0.4257941
7,2,car,514,598,507,564,84,57,0.31927696
8,2,car,501,590,510,567,89,57,0.72163993
9,2,car,501,591,509,564,90,55,0.88262093
10,2,car,502,593,510,565,91,55,0.89309627
11,2,car,506,594,506,566,88,60,0.76903325
12,2,car,507,593,509,566,86,57,0.7786368
13,2,car,507,594,508,565,87,57,0.7380539
14,2,car,495,585,509,566,90,57,0.8718345
15,2,car,502,592,508,565,90,57,0.76711863
16,2,car,501,591,508,565,90,57,0.5544183
17,2,car,502,594,508,564,92,56,0.87572163
18,2,car,4294967271,1075,377,560,-4294966196,183,0.3504756
19,2,car,4294967278,1089,361,549,-4294966189,188,0.28828707
20,2,car,4294967277,1090,365,555,-4294966187,190,0.21405561
21,2,car,4294967294,1076,365,560,-4294966218,195,0.28676075
22,2,car,4294967275,1087,380,566,-4294966188,186,0.22077179
23,2,car,4294967273,1061,378,575,-4294966212,197,0.31963575
24,2,car,13,1082,373,578,1069,205,0.5401667
25,2,car,14,1056,383,578,1042,195,0.2695259
26,2,car,4294967270,1099,386,564,-4294966171,178,0.24828371
27,2,car,4294967286,966,380,574,-4294966320,194,0.26321974
0,2,car,514,598,507,564,84,57,0.8401219
1,2,car,504,593,510,564,89,54,0.9110706
2,2,car,497,583,508,566,86,58,0.8351104
3,2,car,502,595,509,565,93,56,0.9387687
4,2,car,504,593,510,564,89,54,0.8912073
5,2,car,502,594,510,565,92,55,0.9285165
6,2,car,502,592,510,565,90,55,0.89384234
7,2,car,515,598,504,560,83,56,0.4257941
8,2,car,514,598,507,564,84,57,0.31927696
9,2,car,501,590,510,567,89,57,0.72163993
10,2,car,501,591,509,564,90,55,0.88262093
11,2,car,502,593,510,565,91,55,0.89309627
12,2,car,506,594,506,566,88,60,0.76903325
13,2,car,507,593,509,566,86,57,0.7786368
14,2,car,507,594,508,565,87,57,0.7380539
15,2,car,495,585,509,566,90,57,0.8718345
16,2,car,502,592,508,565,90,57,0.76711863
17,2,car,501,591,508,565,90,57,0.5544183
18,2,car,502,594,508,564,92,56,0.87572163
19,2,car,4294967271,1075,377,560,-4294966196,183,0.3504756
20,2,car,4294967278,1089,361,549,-4294966189,188,0.28828707
21,2,car,4294967277,1090,365,555,-4294966187,190,0.21405561
22,2,car,4294967294,1076,365,560,-4294966218,195,0.28676075
23,2,car,4294967275,1087,380,566,-4294966188,186,0.22077179
24,2,car,4294967273,1061,378,575,-4294966212,197,0.31963575
25,2,car,13,1082,373,578,1069,205,0.5401667
26,2,car,14,1056,383,578,1042,195,0.2695259
27,2,car,4294967270,1099,386,564,-4294966171,178,0.24828371
28,2,car,4294967286,966,380,574,-4294966320,194,0.26321974
0,2,car,516,598,504,561,82,57,0.8511085
1,2,car,514,598,507,564,84,57,0.8401219
2,2,car,504,593,510,564,89,54,0.9110706
3,2,car,497,583,508,566,86,58,0.8351104
4,2,car,502,595,509,565,93,56,0.9387687
5,2,car,504,593,510,564,89,54,0.8912073
6,2,car,502,594,510,565,92,55,0.9285165
7,2,car,502,592,510,565,90,55,0.89384234
8,2,car,515,598,504,560,83,56,0.4257941
9,2,car,514,598,507,564,84,57,0.31927696
10,2,car,501,590,510,567,89,57,0.72163993
11,2,car,501,591,509,564,90,55,0.88262093
12,2,car,502,593,510,565,91,55,0.89309627
13,2,car,506,594,506,566,88,60,0.76903325
14,2,car,507,593,509,566,86,57,0.7786368
15,2,car,507,594,508,565,87,57,0.7380539
16,2,car,495,585,509,566,90,57,0.8718345
17,2,car,502,592,508,565,90,57,0.76711863
18,2,car,501,591,508,565,90,57,0.5544183
19,2,car,502,594,508,564,92,56,0.87572163
20,2,car,4294967271,1075,377,560,-4294966196,183,0.3504756
21,2,car,4294967278,1089,361,549,-4294966189,188,0.28828707
22,2,car,4294967277,1090,365,555,-4294966187,190,0.21405561
23,2,car,4294967294,1076,365,560,-4294966218,195,0.28676075
24,2,car,4294967275,1087,380,566,-4294966188,186,0.22077179
25,2,car,4294967273,1061,378,575,-4294966212,197,0.31963575
26,2,car,13,1082,373,578,1069,205,0.5401667
27,2,car,14,1056,383,578,1042,195,0.2695259
28,2,car,4294967270,1099,386,564,-4294966171,178,0.24828371
29,2,car,4294967286,966,380,574,-4294966320,194,0.26321974
0,2,car,498,589,509,564,91,55,0.87746143
1,2,car,516,598,504,561,82,57,0.8511085
2,2,car,514,598,507,564,84,57,0.8401219
3,2,car,504,593,510,564,89,54,0.9110706
4,2,car,497,583,508,566,86,58,0.8351104
5,2,car,502,595,509,565,93,56,0.9387687
6,2,car,504,593,510,564,89,54,0.8912073
7,2,car,502,594,510,565,92,55,0.9285165
8,2,car,502,592,510,565,90,55,0.89384234
9,2,car,515,598,504,560,83,56,0.4257941
10,2,car,514,598,507,564,84,57,0.31927696
11,2,car,501,590,510,567,89,57,0.72163993
12,2,car,501,591,509,564,90,55,0.88262093
13,2,car,502,593,510,565,91,55,0.89309627
14,2,car,506,594,506,566,88,60,0.76903325
15,2,car,507,593,509,566,86,57,0.7786368
16,2,car,507,594,508,565,87,57,0.7380539
17,2,car,495,585,509,566,90,57,0.8718345
18,2,car,502,592,508,565,90,57,0.76711863
19,2,car,501,591,508,565,90,57,0.5544183
20,2,car,502,594,508,564,92,56,0.87572163
21,2,car,4294967271,1075,377,560,-4294966196,183,0.3504756
22,2,car,4294967278,1089,361,549,-4294966189,188,0.28828707
23,2,car,4294967277,1090,365,555,-4294966187,190,0.21405561
24,2,car,4294967294,1076,365,560,-4294966218,195,0.28676075
25,2,car,4294967275,1087,380,566,-4294966188,186,0.22077179
26,2,car,4294967273,1061,378,575,-4294966212,197,0.31963575
27,2,car,13,1082,373,578,1069,205,0.5401667
28,2,car,14,1056,383,578,1042,195,0.2695259
29,2,car,4294967270,1099,386,564,-4294966171,178,0.24828371
30,2,car,4294967286,966,380,574,-4294966320,194,0.26321974
0,2,car,491,574,495,555,83,60,0.8099735
1,2,car,498,589,509,564,91,55,0.87746143
2,2,car,516,598,504,561,82,57,0.8511085
3,2,car,514,598,507,564,84,57,0.8401219
4,2,car,504,593,510,564,89,54,0.9110706
5,2,car,497,583,508,566,86,58,0.8351104
6,2,car,502,595,509,565,93,56,0.9387687
7,2,car,504,593,510,564,89,54,0.8912073
8,2,car,502,594,510,565,92,55,0.9285165
9,2,car,502,592,510,565,90,55,0.89384234
10,2,car,515,598,504,560,83,56,0.4257941
11,2,car,514,598,507,564,84,57,0.31927696
12,2,car,501,590,510,567,89,57,0.72163993
13,2,car,501,591,509,564,90,55,0.88262093
14,2,car,502,593,510,565,91,55,0.89309627
15,2,car,506,594,506,566,88,60,0.76903325
16,2,car,507,593,509,566,86,57,0.7786368
17,2,car,507,594,508,565,87,57,0.7380539
18,2,car,495,585,509,566,90,57,0.8718345
19,2,car,502,592,508,565,90,57,0.76711863
20,2,car,501,591,508,565,90,57,0.5544183
21,2,car,502,594,508,564,92,56,0.87572163
22,2,car,4294967271,1075,377,560,-4294966196,183,0.3504756
23,2,car,4294967278,1089,361,549,-4294966189,188,0.28828707
24,2,car,4294967277,1090,365,555,-4294966187,190,0.21405561
25,2,car,4294967294,1076,365,560,-4294966218,195,0.28676075
26,2,car,4294967275,1087,380,566,-4294966188,186,0.22077179
27,2,car,4294967273,1061,378,575,-4294966212,197,0.31963575
28,2,car,13,1082,373,578,1069,205,0.5401667
29,2,car,14,1056,383,578,1042,195,0.2695259
30,2,car,4294967270,1099,386,564,-4294966171,178,0.24828371
31,2,car,4294967286,966,380,574,-4294966320,194,0.26321974
0,2,car,502,590,509,564,88,55,0.8253944
1,2,car,491,574,495,555,83,60,0.8099735
2,2,car,498,589,509,564,91,55,0.87746143
3,2,car,516,598,504,561,82,57,0.8511085
4,2,car,514,598,507,564,84,57,0.8401219
5,2,car,504,593,510,564,89,54,0.9110706
6,2,car,497,583,508,566,86,58,0.8351104
7,2,car,502,595,509,565,93,56,0.9387687
8,2,car,504,593,510,564,89,54,0.8912073
9,2,car,502,594,510,565,92,55,0.9285165
10,2,car,502,592,510,565,90,55,0.89384234
11,2,car,515,598,504,560,83,56,0.4257941
12,2,car,514,598,507,564,84,57,0.31927696
13,2,car,501,590,510,567,89,57,0.72163993
14,2,car,501,591,509,564,90,55,0.88262093
15,2,car,502,593,510,565,91,55,0.89309627
16,2,car,506,594,506,566,88,60,0.76903325
17,2,car,507,593,509,566,86,57,0.7786368
18,2,car,507,594,508,565,87,57,0.7380539
19,2,car,495,585,509,566,90,57,0.8718345
20,2,car,502,592,508,565,90,57,0.76711863
21,2,car,501,591,508,565,90,57,0.5544183
22,2,car,502,594,508,564,92,56,0.87572163
23,2,car,4294967271,1075,377,560,-4294966196,183,0.3504756
24,2,car,4294967278,1089,361,549,-4294966189,188,0.28828707
25,2,car,4294967277,1090,365,555,-4294966187,190,0.21405561
26,2,car,4294967294,1076,365,560,-4294966218,195,0.28676075
27,2,car,4294967275,1087,380,566,-4294966188,186,0.22077179
28,2,car,4294967273,1061,378,575,-4294966212,197,0.31963575
29,2,car,13,1082,373,578,1069,205,0.5401667
30,2,car,14,1056,383,578,1042,195,0.2695259
31,2,car,4294967270,1099,386,564,-4294966171,178,0.24828371
32,2,car,4294967286,966,380,574,-4294966320,194,0.26321974
0,2,car,502,590,508,564,88,56,0.7944646
1,2,car,502,590,509,564,88,55,0.8253944
2,2,car,491,574,495,555,83,60,0.8099735
3,2,car,498,589,509,564,91,55,0.87746143
4,2,car,516,598,504,561,82,57,0.8511085
5,2,car,514,598,507,564,84,57,0.8401219
6,2,car,504,593,510,564,89,54,0.9110706
7,2,car,497,583,508,566,86,58,0.8351104
8,2,car,502,595,509,565,93,56,0.9387687
9,2,car,504,593,510,564,89,54,0.8912073
10,2,car,502,594,510,565,92,55,0.9285165
11,2,car,502,592,510,565,90,55,0.89384234
12,2,car,515,598,504,560,83,56,0.4257941
13,2,car,514,598,507,564,84,57,0.31927696
14,2,car,501,590,510,567,89,57,0.72163993
15,2,car,501,591,509,564,90,55,0.88262093
16,2,car,502,593,510,565,91,55,0.89309627
17,2,car,506,594,506,566,88,60,0.76903325
18,2,car,507,593,509,566,86,57,0.7786368
19,2,car,507,594,508,565,87,57,0.7380539
20,2,car,495,585,509,566,90,57,0.8718345
21,2,car,502,592,508,565,90,57,0.76711863
22,2,car,501,591,508,565,90,57,0.5544183
23,2,car,502,594,508,564,92,56,0.87572163
24,2,car,4294967271,1075,377,560,-4294966196,183,0.3504756
25,2,car,4294967278,1089,361,549,-4294966189,188,0.28828707
26,2,car,4294967277,1090,365,555,-4294966187,190,0.21405561
27,2,car,4294967294,1076,365,560,-4294966218,195,0.28676075
28,2,car,4294967275,1087,380,566,-4294966188,186,0.22077179
29,2,car,4294967273,1061,378,575,-4294966212,197,0.31963575
30,2,car,13,1082,373,578,1069,205,0.5401667
31,2,car,14,1056,383,578,1042,195,0.2695259
32,2,car,4294967270,1099,386,564,-4294966171,178,0.24828371
33,2,car,4294967286,966,380,574,-4294966320,194,0.26321974
0,2,car,517,600,504,563,83,59,0.8491415
1,2,car,502,590,508,564,88,56,0.7944646
2,2,car,502,590,509,564,88,55,0.8253944
3,2,car,491,574,495,555,83,60,0.8099735
4,2,car,498,589,509,564,91,55,0.87746143
5,2,car,516,598,504,561,82,57,0.8511085
6,2,car,514,598,507,564,84,57,0.8401219
7,2,car,504,593,510,564,89,54,0.9110706
8,2,car,497,583,508,566,86,58,0.8351104
9,2,car,502,595,509,565,93,56,0.9387687
10,2,car,504,593,510,564,89,54,0.8912073
11,2,car,502,594,510,565,92,55,0.9285165
12,2,car,502,592,510,565,90,55,0.89384234
13,2,car,515,598,504,560,83,56,0.4257941
14,2,car,514,598,507,564,84,57,0.31927696
15,2,car,501,590,510,567,89,57,0.72163993
16,2,car,501,591,509,564,90,55,0.88262093
17,2,car,502,593,510,565,91,55,0.89309627
18,2,car,506,594,506,566,88,60,0.76903325
19,2,car,507,593,509,566,86,57,0.7786368
20,2,car,507,594,508,565,87,57,0.7380539
21,2,car,495,585,509,566,90,57,0.8718345
22,2,car,502,592,508,565,90,57,0.76711863
23,2,car,501,591,508,565,90,57,0.5544183
24,2,car,502,594,508,564,92,56,0.87572163
25,2,car,4294967271,1075,377,560,-4294966196,183,0.3504756
26,2,car,4294967278,1089,361,549,-4294966189,188,0.28828707
27,2,car,4294967277,1090,365,555,-4294966187,190,0.21405561
28,2,car,4294967294,1076,365,560,-4294966218,195,0.28676075
29,2,car,4294967275,1087,380,566,-4294966188,186,0.22077179
30,2,car,4294967273,1061,378,575,-4294966212,197,0.31963575
31,2,car,13,1082,373,578,1069,205,0.5401667
32,2,car,14,1056,383,578,1042,195,0.2695259
33,2,car,4294967270,1099,386,564,-4294966171,178,0.24828371
34,2,car,4294967286,966,380,574,-4294966320,194,0.26321974
0,2,car,517,600,504,563,83,59,0.8491415
1,2,car,502,590,508,564,88,56,0.7944646
2,2,car,502,590,509,564,88,55,0.8253944
3,2,car,491,574,495,555,83,60,0.8099735
4,2,car,498,589,509,564,91,55,0.87746143
5,2,car,516,598,504,561,82,57,0.8511085
6,2,car,514,598,507,564,84,57,0.8401219
7,2,car,504,593,510,564,89,54,0.9110706
8,2,car,497,583,508,566,86,58,0.8351104
9,2,car,502,595,509,565,93,56,0.9387687
10,2,car,504,593,510,564,89,54,0.8912073
11,2,car,502,594,510,565,92,55,0.9285165
12,2,car,502,592,510,565,90,55,0.89384234
13,2,car,515,598,504,560,83,56,0.4257941
14,2,car,514,598,507,564,84,57,0.31927696
15,2,car,501,590,510,567,89,57,0.72163993
16,2,car,501,591,509,564,90,55,0.88262093
17,2,car,502,593,510,565,91,55,0.89309627
18,2,car,506,594,506,566,88,60,0.76903325
19,2,car,507,593,509,566,86,57,0.7786368
20,2,car,507,594,508,565,87,57,0.7380539
21,2,car,495,585,509,566,90,57,0.8718345
22,2,car,502,592,508,565,90,57,0.76711863
23,2,car,501,591,508,565,90,57,0.5544183
24,2,car,502,594,508,564,92,56,0.87572163
25,2,car,4294967271,1075,377,560,-4294966196,183,0.3504756
26,2,car,4294967278,1089,361,549,-4294966189,188,0.28828707
27,2,car,4294967277,1090,365,555,-4294966187,190,0.21405561
28,2,car,4294967294,1076,365,560,-4294966218,195,0.28676075
29,2,car,4294967275,1087,380,566,-4294966188,186,0.22077179
30,2,car,4294967273,1061,378,575,-4294966212,197,0.31963575
31,2,car,13,1082,373,578,1069,205,0.5401667
32,2,car,14,1056,383,578,1042,195,0.2695259
33,2,car,4294967270,1099,386,564,-4294966171,178,0.24828371
34,2,car,4294967286,966,380,574,-4294966320,194,0.26321974
0,2,car,514,602,494,554,88,60,0.31047094
1,2,car,517,600,504,563,83,59,0.8491415
2,2,car,502,590,508,564,88,56,0.7944646
3,2,car,502,590,509,564,88,55,0.8253944
4,2,car,491,574,495,555,83,60,0.8099735
5,2,car,498,589,509,564,91,55,0.87746143
6,2,car,516,598,504,561,82,57,0.8511085
7,2,car,514,598,507,564,84,57,0.8401219
8,2,car,504,593,510,564,89,54,0.9110706
9,2,car,497,583,508,566,86,58,0.8351104
10,2,car,502,595,509,565,93,56,0.9387687
11,2,car,504,593,510,564,89,54,0.8912073
12,2,car,502,594,510,565,92,55,0.9285165
13,2,car,502,592,510,565,90,55,0.89384234
14,2,car,515,598,504,560,83,56,0.4257941
15,2,car,514,598,507,564,84,57,0.31927696
16,2,car,501,590,510,567,89,57,0.72163993
17,2,car,501,591,509,564,90,55,0.88262093
18,2,car,502,593,510,565,91,55,0.89309627
19,2,car,506,594,506,566,88,60,0.76903325
20,2,car,507,593,509,566,86,57,0.7786368
21,2,car,507,594,508,565,87,57,0.7380539
22,2,car,495,585,509,566,90,57,0.8718345
23,2,car,502,592,508,565,90,57,0.76711863
24,2,car,501,591,508,565,90,57,0.5544183
25,2,car,502,594,508,564,92,56,0.87572163
26,2,car,4294967271,1075,377,560,-4294966196,183,0.3504756
27,2,car,4294967278,1089,361,549,-4294966189,188,0.28828707
28,2,car,4294967277,1090,365,555,-4294966187,190,0.21405561
29,2,car,4294967294,1076,365,560,-4294966218,195,0.28676075
30,2,car,4294967275,1087,380,566,-4294966188,186,0.22077179
31,2,car,4294967273,1061,378,575,-4294966212,197,0.31963575
32,2,car,13,1082,373,578,1069,205,0.5401667
33,2,car,14,1056,383,578,1042,195,0.2695259
34,2,car,4294967270,1099,386,564,-4294966171,178,0.24828371
35,2,car,4294967286,966,380,574,-4294966320,194,0.26321974
0,2,car,502,591,509,563,89,54,0.7096379
1,2,car,514,602,494,554,88,60,0.31047094
2,2,car,517,600,504,563,83,59,0.8491415
3,2,car,502,590,508,564,88,56,0.7944646
4,2,car,502,590,509,564,88,55,0.8253944
5,2,car,491,574,495,555,83,60,0.8099735
6,2,car,498,589,509,564,91,55,0.87746143
7,2,car,516,598,504,561,82,57,0.8511085
8,2,car,514,598,507,564,84,57,0.8401219
9,2,car,504,593,510,564,89,54,0.9110706
10,2,car,497,583,508,566,86,58,0.8351104
11,2,car,502,595,509,565,93,56,0.9387687
12,2,car,504,593,510,564,89,54,0.8912073
13,2,car,502,594,510,565,92,55,0.9285165
14,2,car,502,592,510,565,90,55,0.89384234
15,2,car,515,598,504,560,83,56,0.4257941
16,2,car,514,598,507,564,84,57,0.31927696
17,2,car,501,590,510,567,89,57,0.72163993
18,2,car,501,591,509,564,90,55,0.88262093
19,2,car,502,593,510,565,91,55,0.89309627
20,2,car,506,594,506,566,88,60,0.76903325
21,2,car,507,593,509,566,86,57,0.7786368
22,2,car,507,594,508,565,87,57,0.7380539
23,2,car,495,585,509,566,90,57,0.8718345
24,2,car,502,592,508,565,90,57,0.76711863
25,2,car,501,591,508,565,90,57,0.5544183
26,2,car,502,594,508,564,92,56,0.87572163
27,2,car,4294967271,1075,377,560,-4294966196,183,0.3504756
28,2,car,4294967278,1089,361,549,-4294966189,188,0.28828707
29,2,car,4294967277,1090,365,555,-4294966187,190,0.21405561
30,2,car,4294967294,1076,365,560,-4294966218,195,0.28676075
31,2,car,4294967275,1087,380,566,-4294966188,186,0.22077179
32,2,car,4294967273,1061,378,575,-4294966212,197,0.31963575
33,2,car,13,1082,373,578,1069,205,0.5401667
34,2,car,14,1056,383,578,1042,195,0.2695259
35,2,car,4294967270,1099,386,564,-4294966171,178,0.24828371
36,2,car,4294967286,966,380,574,-4294966320,194,0.26321974
0,2,car,501,589,507,563,88,56,0.75885755
1,2,car,502,591,509,563,89,54,0.7096379
2,2,car,514,602,494,554,88,60,0.31047094
3,2,car,517,600,504,563,83,59,0.8491415
4,2,car,502,590,508,564,88,56,0.7944646
5,2,car,502,590,509,564,88,55,0.8253944
6,2,car,491,574,495,555,83,60,0.8099735
7,2,car,498,589,509,564,91,55,0.87746143
8,2,car,516,598,504,561,82,57,0.8511085
9,2,car,514,598,507,564,84,57,0.8401219
10,2,car,504,593,510,564,89,54,0.9110706
11,2,car,497,583,508,566,86,58,0.8351104
12,2,car,502,595,509,565,93,56,0.9387687
13,2,car,504,593,510,564,89,54,0.8912073
14,2,car,502,594,510,565,92,55,0.9285165
15,2,car,502,592,510,565,90,55,0.89384234
16,2,car,515,598,504,560,83,56,0.4257941
17,2,car,514,598,507,564,84,57,0.31927696
18,2,car,501,590,510,567,89,57,0.72163993
19,2,car,501,591,509,564,90,55,0.88262093
20,2,car,502,593,510,565,91,55,0.89309627
21,2,car,506,594,506,566,88,60,0.76903325
22,2,car,507,593,509,566,86,57,0.7786368
23,2,car,507,594,508,565,87,57,0.7380539
24,2,car,495,585,509,566,90,57,0.8718345
25,2,car,502,592,508,565,90,57,0.76711863
26,2,car,501,591,508,565,90,57,0.5544183
27,2,car,502,594,508,564,92,56,0.87572163
28,2,car,4294967271,1075,377,560,-4294966196,183,0.3504756
29,2,car,4294967278,1089,361,549,-4294966189,188,0.28828707
30,2,car,4294967277,1090,365,555,-4294966187,190,0.21405561
31,2,car,4294967294,1076,365,560,-4294966218,195,0.28676075
32,2,car,4294967275,1087,380,566,-4294966188,186,0.22077179
33,2,car,4294967273,1061,378,575,-4294966212,197,0.31963575
34,2,car,13,1082,373,578,1069,205,0.5401667
35,2,car,14,1056,383,578,1042,195,0.2695259
36,2,car,4294967270,1099,386,564,-4294966171,178,0.24828371
37,2,car,4294967286,966,380,574,-4294966320,194,0.26321974
0,2,car,501,589,507,564,88,57,0.8935997
1,2,car,501,589,507,563,88,56,0.75885755
2,2,car,502,591,509,563,89,54,0.7096379
3,2,car,514,602,494,554,88,60,0.31047094
4,2,car,517,600,504,563,83,59,0.8491415
5,2,car,502,590,508,564,88,56,0.7944646
6,2,car,502,590,509,564,88,55,0.8253944
7,2,car,491,574,495,555,83,60,0.8099735
8,2,car,498,589,509,564,91,55,0.87746143
9,2,car,516,598,504,561,82,57,0.8511085
10,2,car,514,598,507,564,84,57,0.8401219
11,2,car,504,593,510,564,89,54,0.9110706
12,2,car,497,583,508,566,86,58,0.8351104
13,2,car,502,595,509,565,93,56,0.9387687
14,2,car,504,593,510,564,89,54,0.8912073
15,2,car,502,594,510,565,92,55,0.9285165
16,2,car,502,592,510,565,90,55,0.89384234
17,2,car,515,598,504,560,83,56,0.4257941
18,2,car,514,598,507,564,84,57,0.31927696
19,2,car,501,590,510,567,89,57,0.72163993
20,2,car,501,591,509,564,90,55,0.88262093
21,2,car,502,593,510,565,91,55,0.89309627
22,2,car,506,594,506,566,88,60,0.76903325
23,2,car,507,593,509,566,86,57,0.7786368
24,2,car,507,594,508,565,87,57,0.7380539
25,2,car,495,585,509,566,90,57,0.8718345
26,2,car,502,592,508,565,90,57,0.76711863
27,2,car,501,591,508,565,90,57,0.5544183
28,2,car,502,594,508,564,92,56,0.87572163
29,2,car,4294967271,1075,377,560,-4294966196,183,0.3504756
30,2,car,4294967278,1089,361,549,-4294966189,188,0.28828707
31,2,car,4294967277,1090,365,555,-4294966187,190,0.21405561
32,2,car,4294967294,1076,365,560,-4294966218,195,0.28676075
33,2,car,4294967275,1087,380,566,-4294966188,186,0.22077179
34,2,car,4294967273,1061,378,575,-4294966212,197,0.31963575
35,2,car,13,1082,373,578,1069,205,0.5401667
36,2,car,14,1056,383,578,1042,195,0.2695259
37,2,car,4294967270,1099,386,564,-4294966171,178,0.24828371
38,2,car,4294967286,966,380,574,-4294966320,194,0.26321974
0,2,car,501,589,506,563,88,57,0.85617733
1,2,car,501,589,507,564,88,57,0.8935997
2,2,car,501,589,507,563,88,56,0.75885755
3,2,car,502,591,509,563,89,54,0.7096379
4,2,car,514,602,494,554,88,60,0.31047094
5,2,car,517,600,504,563,83,59,0.8491415
6,2,car,502,590,508,564,88,56,0.7944646
7,2,car,502,590,509,564,88,55,0.8253944
8,2,car,491,574,495,555,83,60,0.8099735
9,2,car,498,589,509,564,91,55,0.87746143
10,2,car,516,598,504,561,82,57,0.8511085
11,2,car,514,598,507,564,84,57,0.8401219
12,2,car,504,593,510,564,89,54,0.9110706
13,2,car,497,583,508,566,86,58,0.8351104
14,2,car,502,595,509,565,93,56,0.9387687
15,2,car,504,593,510,564,89,54,0.8912073
16,2,car,502,594,510,565,92,55,0.9285165
17,2,car,502,592,510,565,90,55,0.89384234
18,2,car,515,598,504,560,83,56,0.4257941
19,2,car,514,598,507,564,84,57,0.31927696
20,2,car,501,590,510,567,89,57,0.72163993
21,2,car,501,591,509,564,90,55,0.88262093
22,2,car,502,593,510,565,91,55,0.89309627
23,2,car,506,594,506,566,88,60,0.76903325
24,2,car,507,593,509,566,86,57,0.7786368
25,2,car,507,594,508,565,87,57,0.7380539
26,2,car,495,585,509,566,90,57,0.8718345
27,2,car,502,592,508,565,90,57,0.76711863
28,2,car,501,591,508,565,90,57,0.5544183
29,2,car,502,594,508,564,92,56,0.87572163
30,2,car,4294967271,1075,377,560,-4294966196,183,0.3504756
31,2,car,4294967278,1089,361,549,-4294966189,188,0.28828707
32,2,car,4294967277,1090,365,555,-4294966187,190,0.21405561
33,2,car,4294967294,1076,365,560,-4294966218,195,0.28676075
34,2,car,4294967275,1087,380,566,-4294966188,186,0.22077179
35,2,car,4294967273,1061,378,575,-4294966212,197,0.31963575
36,2,car,13,1082,373,578,1069,205,0.5401667
37,2,car,14,1056,383,578,1042,195,0.2695259
38,2,car,4294967270,1099,386,564,-4294966171,178,0.24828371
39,2,car,4294967286,966,380,574,-4294966320,194,0.26321974
0,2,car,501,589,506,562,88,56,0.79819185
1,2,car,501,589,506,563,88,57,0.85617733
2,2,car,501,589,507,564,88,57,0.8935997
3,2,car,501,589,507,563,88,56,0.75885755
4,2,car,502,591,509,563,89,54,0.7096379
5,2,car,514,602,494,554,88,60,0.31047094
6,2,car,517,600,504,563,83,59,0.8491415
7,2,car,502,590,508,564,88,56,0.7944646
8,2,car,502,590,509,564,88,55,0.8253944
9,2,car,491,574,495,555,83,60,0.8099735
10,2,car,498,589,509,564,91,55,0.87746143
11,2,car,516,598,504,561,82,57,0.8511085
12,2,car,514,598,507,564,84,57,0.8401219
13,2,car,504,593,510,564,89,54,0.9110706
14,2,car,497,583,508,566,86,58,0.8351104
15,2,car,502,595,509,565,93,56,0.9387687
16,2,car,504,593,510,564,89,54,0.8912073
17,2,car,502,594,510,565,92,55,0.9285165
18,2,car,502,592,510,565,90,55,0.89384234
19,2,car,515,598,504,560,83,56,0.4257941
20,2,car,514,598,507,564,84,57,0.31927696
21,2,car,501,590,510,567,89,57,0.72163993
22,2,car,501,591,509,564,90,55,0.88262093
23,2,car,502,593,510,565,91,55,0.89309627
24,2,car,506,594,506,566,88,60,0.76903325
25,2,car,507,593,509,566,86,57,0.7786368
26,2,car,507,594,508,565,87,57,0.7380539
27,2,car,495,585,509,566,90,57,0.8718345
28,2,car,502,592,508,565,90,57,0.76711863
29,2,car,501,591,508,565,90,57,0.5544183
30,2,car,502,594,508,564,92,56,0.87572163
31,2,car,4294967271,1075,377,560,-4294966196,183,0.3504756
32,2,car,4294967278,1089,361,549,-4294966189,188,0.28828707
33,2,car,4294967277,1090,365,555,-4294966187,190,0.21405561
34,2,car,4294967294,1076,365,560,-4294966218,195,0.28676075
35,2,car,4294967275,1087,380,566,-4294966188,186,0.22077179
36,2,car,4294967273,1061,378,575,-4294966212,197,0.31963575
37,2,car,13,1082,373,578,1069,205,0.5401667
38,2,car,14,1056,383,578,1042,195,0.2695259
39,2,car,4294967270,1099,386,564,-4294966171,178,0.24828371
40,2,car,4294967286,966,380,574,-4294966320,194,0.26321974
0,2,car,502,589,506,562,87,56,0.8541347
1,2,car,501,589,506,562,88,56,0.79819185
2,2,car,501,589,506,563,88,57,0.85617733
3,2,car,501,589,507,564,88,57,0.8935997
4,2,car,501,589,507,563,88,56,0.75885755
5,2,car,502,591,509,563,89,54,0.7096379
6,2,car,514,602,494,554,88,60,0.31047094
7,2,car,517,600,504,563,83,59,0.8491415
8,2,car,502,590,508,564,88,56,0.7944646
9,2,car,502,590,509,564,88,55,0.8253944
10,2,car,491,574,495,555,83,60,0.8099735
11,2,car,498,589,509,564,91,55,0.87746143
12,2,car,516,598,504,561,82,57,0.8511085
13,2,car,514,598,507,564,84,57,0.8401219
14,2,car,504,593,510,564,89,54,0.9110706
15,2,car,497,583,508,566,86,58,0.8351104
16,2,car,502,595,509,565,93,56,0.9387687
17,2,car,504,593,510,564,89,54,0.8912073
18,2,car,502,594,510,565,92,55,0.9285165
19,2,car,502,592,510,565,90,55,0.89384234
20,2,car,515,598,504,560,83,56,0.4257941
21,2,car,514,598,507,564,84,57,0.31927696
22,2,car,501,590,510,567,89,57,0.72163993
23,2,car,501,591,509,564,90,55,0.88262093
24,2,car,502,593,510,565,91,55,0.89309627
25,2,car,506,594,506,566,88,60,0.76903325
26,2,car,507,593,509,566,86,57,0.7786368
27,2,car,507,594,508,565,87,57,0.7380539
28,2,car,495,585,509,566,90,57,0.8718345
29,2,car,502,592,508,565,90,57,0.76711863
30,2,car,501,591,508,565,90,57,0.5544183
31,2,car,502,594,508,564,92,56,0.87572163
32,2,car,4294967271,1075,377,560,-4294966196,183,0.3504756
33,2,car,4294967278,1089,361,549,-4294966189,188,0.28828707
34,2,car,4294967277,1090,365,555,-4294966187,190,0.21405561
35,2,car,4294967294,1076,365,560,-4294966218,195,0.28676075
36,2,car,4294967275,1087,380,566,-4294966188,186,0.22077179
37,2,car,4294967273,1061,378,575,-4294966212,197,0.31963575
38,2,car,13,1082,373,578,1069,205,0.5401667
39,2,car,14,1056,383,578,1042,195,0.2695259
40,2,car,4294967270,1099,386,564,-4294966171,178,0.24828371
41,2,car,4294967286,966,380,574,-4294966320,194,0.26321974
0,2,car,502,589,506,563,87,57,0.8359229
1,2,car,502,589,506,562,87,56,0.8541347
2,2,car,501,589,506,562,88,56,0.79819185
3,2,car,501,589,506,563,88,57,0.85617733
4,2,car,501,589,507,564,88,57,0.8935997
5,2,car,501,589,507,563,88,56,0.75885755
6,2,car,502,591,509,563,89,54,0.7096379
7,2,car,514,602,494,554,88,60,0.31047094
8,2,car,517,600,504,563,83,59,0.8491415
9,2,car,502,590,508,564,88,56,0.7944646
10,2,car,502,590,509,564,88,55,0.8253944
11,2,car,491,574,495,555,83,60,0.8099735
12,2,car,498,589,509,564,91,55,0.87746143
13,2,car,516,598,504,561,82,57,0.8511085
14,2,car,514,598,507,564,84,57,0.8401219
15,2,car,504,593,510,564,89,54,0.9110706
16,2,car,497,583,508,566,86,58,0.8351104
17,2,car,502,595,509,565,93,56,0.9387687
18,2,car,504,593,510,564,89,54,0.8912073
19,2,car,502,594,510,565,92,55,0.9285165
20,2,car,502,592,510,565,90,55,0.89384234
21,2,car,515,598,504,560,83,56,0.4257941
22,2,car,514,598,507,564,84,57,0.31927696
23,2,car,501,590,510,567,89,57,0.72163993
24,2,car,501,591,509,564,90,55,0.88262093
25,2,car,502,593,510,565,91,55,0.89309627
26,2,car,506,594,506,566,88,60,0.76903325
27,2,car,507,593,509,566,86,57,0.7786368
28,2,car,507,594,508,565,87,57,0.7380539
29,2,car,495,585,509,566,90,57,0.8718345
30,2,car,502,592,508,565,90,57,0.76711863
31,2,car,501,591,508,565,90,57,0.5544183
32,2,car,502,594,508,564,92,56,0.87572163
33,2,car,4294967271,1075,377,560,-4294966196,183,0.3504756
34,2,car,4294967278,1089,361,549,-4294966189,188,0.28828707
35,2,car,4294967277,1090,365,555,-4294966187,190,0.21405561
36,2,car,4294967294,1076,365,560,-4294966218,195,0.28676075
37,2,car,4294967275,1087,380,566,-4294966188,186,0.22077179
38,2,car,4294967273,1061,378,575,-4294966212,197,0.31963575
39,2,car,13,1082,373,578,1069,205,0.5401667
40,2,car,14,1056,383,578,1042,195,0.2695259
41,2,car,4294967270,1099,386,564,-4294966171,178,0.24828371
42,2,car,4294967286,966,380,574,-4294966320,194,0.26321974
0,2,car,502,590,506,562,88,56,0.8553335
1,2,car,502,589,506,563,87,57,0.8359229
2,2,car,502,589,506,562,87,56,0.8541347
3,2,car,501,589,506,562,88,56,0.79819185
4,2,car,501,589,506,563,88,57,0.85617733
5,2,car,501,589,507,564,88,57,0.8935997
6,2,car,501,589,507,563,88,56,0.75885755
7,2,car,502,591,509,563,89,54,0.7096379
8,2,car,514,602,494,554,88,60,0.31047094
9,2,car,517,600,504,563,83,59,0.8491415
10,2,car,502,590,508,564,88,56,0.7944646
11,2,car,502,590,509,564,88,55,0.8253944
12,2,car,491,574,495,555,83,60,0.8099735
13,2,car,498,589,509,564,91,55,0.87746143
14,2,car,516,598,504,561,82,57,0.8511085
15,2,car,514,598,507,564,84,57,0.8401219
16,2,car,504,593,510,564,89,54,0.9110706
17,2,car,497,583,508,566,86,58,0.8351104
18,2,car,502,595,509,565,93,56,0.9387687
19,2,car,504,593,510,564,89,54,0.8912073
20,2,car,502,594,510,565,92,55,0.9285165
21,2,car,502,592,510,565,90,55,0.89384234
22,2,car,515,598,504,560,83,56,0.4257941
23,2,car,514,598,507,564,84,57,0.31927696
24,2,car,501,590,510,567,89,57,0.72163993
25,2,car,501,591,509,564,90,55,0.88262093
26,2,car,502,593,510,565,91,55,0.89309627
27,2,car,506,594,506,566,88,60,0.76903325
28,2,car,507,593,509,566,86,57,0.7786368
29,2,car,507,594,508,565,87,57,0.7380539
30,2,car,495,585,509,566,90,57,0.8718345
31,2,car,502,592,508,565,90,57,0.76711863
32,2,car,501,591,508,565,90,57,0.5544183
33,2,car,502,594,508,564,92,56,0.87572163
34,2,car,4294967271,1075,377,560,-4294966196,183,0.3504756
35,2,car,4294967278,1089,361,549,-4294966189,188,0.28828707
36,2,car,4294967277,1090,365,555,-4294966187,190,0.21405561
37,2,car,4294967294,1076,365,560,-4294966218,195,0.28676075
38,2,car,4294967275,1087,380,566,-4294966188,186,0.22077179
39,2,car,4294967273,1061,378,575,-4294966212,197,0.31963575
40,2,car,13,1082,373,578,1069,205,0.5401667
41,2,car,14,1056,383,578,1042,195,0.2695259
42,2,car,4294967270,1099,386,564,-4294966171,178,0.24828371
43,2,car,4294967286,966,380,574,-4294966320,194,0.26321974
0,2,car,502,590,506,562,88,56,0.92112195
1,2,car,502,590,506,562,88,56,0.8553335
2,2,car,502,589,506,563,87,57,0.8359229
3,2,car,502,589,506,562,87,56,0.8541347
4,2,car,501,589,506,562,88,56,0.79819185
5,2,car,501,589,506,563,88,57,0.85617733
6,2,car,501,589,507,564,88,57,0.8935997
7,2,car,501,589,507,563,88,56,0.75885755
8,2,car,502,591,509,563,89,54,0.7096379
9,2,car,514,602,494,554,88,60,0.31047094
10,2,car,517,600,504,563,83,59,0.8491415
11,2,car,502,590,508,564,88,56,0.7944646
12,2,car,502,590,509,564,88,55,0.8253944
13,2,car,491,574,495,555,83,60,0.8099735
14,2,car,498,589,509,564,91,55,0.87746143
15,2,car,516,598,504,561,82,57,0.8511085
16,2,car,514,598,507,564,84,57,0.8401219
17,2,car,504,593,510,564,89,54,0.9110706
18,2,car,497,583,508,566,86,58,0.8351104
19,2,car,502,595,509,565,93,56,0.9387687
20,2,car,504,593,510,564,89,54,0.8912073
21,2,car,502,594,510,565,92,55,0.9285165
22,2,car,502,592,510,565,90,55,0.89384234
23,2,car,515,598,504,560,83,56,0.4257941
24,2,car,514,598,507,564,84,57,0.31927696
25,2,car,501,590,510,567,89,57,0.72163993
26,2,car,501,591,509,564,90,55,0.88262093
27,2,car,502,593,510,565,91,55,0.89309627
28,2,car,506,594,506,566,88,60,0.76903325
29,2,car,507,593,509,566,86,57,0.7786368
30,2,car,507,594,508,565,87,57,0.7380539
31,2,car,495,585,509,566,90,57,0.8718345
32,2,car,502,592,508,565,90,57,0.76711863
33,2,car,501,591,508,565,90,57,0.5544183
34,2,car,502,594,508,564,92,56,0.87572163
35,2,car,4294967271,1075,377,560,-4294966196,183,0.3504756
36,2,car,4294967278,1089,361,549,-4294966189,188,0.28828707
37,2,car,4294967277,1090,365,555,-4294966187,190,0.21405561
38,2,car,4294967294,1076,365,560,-4294966218,195,0.28676075
39,2,car,4294967275,1087,380,566,-4294966188,186,0.22077179
40,2,car,4294967273,1061,378,575,-4294966212,197,0.31963575
41,2,car,13,1082,373,578,1069,205,0.5401667
42,2,car,14,1056,383,578,1042,195,0.2695259
43,2,car,4294967270,1099,386,564,-4294966171,178,0.24828371
44,2,car,4294967286,966,380,574,-4294966320,194,0.26321974
0,2,car,502,589,507,562,87,55,0.87911797
1,2,car,502,590,506,562,88,56,0.92112195
2,2,car,502,590,506,562,88,56,0.8553335
3,2,car,502,589,506,563,87,57,0.8359229
4,2,car,502,589,506,562,87,56,0.8541347
5,2,car,501,589,506,562,88,56,0.79819185
6,2,car,501,589,506,563,88,57,0.85617733
7,2,car,501,589,507,564,88,57,0.8935997
8,2,car,501,589,507,563,88,56,0.75885755
9,2,car,502,591,509,563,89,54,0.7096379
10,2,car,514,602,494,554,88,60,0.31047094
11,2,car,517,600,504,563,83,59,0.8491415
12,2,car,502,590,508,564,88,56,0.7944646
13,2,car,502,590,509,564,88,55,0.8253944
14,2,car,491,574,495,555,83,60,0.8099735
15,2,car,498,589,509,564,91,55,0.87746143
16,2,car,516,598,504,561,82,57,0.8511085
17,2,car,514,598,507,564,84,57,0.8401219
18,2,car,504,593,510,564,89,54,0.9110706
19,2,car,497,583,508,566,86,58,0.8351104
20,2,car,502,595,509,565,93,56,0.9387687
21,2,car,504,593,510,564,89,54,0.8912073
22,2,car,502,594,510,565,92,55,0.9285165
23,2,car,502,592,510,565,90,55,0.89384234
24,2,car,515,598,504,560,83,56,0.4257941
25,2,car,514,598,507,564,84,57,0.31927696
26,2,car,501,590,510,567,89,57,0.72163993
27,2,car,501,591,509,564,90,55,0.88262093
28,2,car,502,593,510,565,91,55,0.89309627
29,2,car,506,594,506,566,88,60,0.76903325
30,2,car,507,593,509,566,86,57,0.7786368
31,2,car,507,594,508,565,87,57,0.7380539
32,2,car,495,585,509,566,90,57,0.8718345
33,2,car,502,592,508,565,90,57,0.76711863
34,2,car,501,591,508,565,90,57,0.5544183
35,2,car,502,594,508,564,92,56,0.87572163
36,2,car,4294967271,1075,377,560,-4294966196,183,0.3504756
37,2,car,4294967278,1089,361,549,-4294966189,188,0.28828707
38,2,car,4294967277,1090,365,555,-4294966187,190,0.21405561
39,2,car,4294967294,1076,365,560,-4294966218,195,0.28676075
40,2,car,4294967275,1087,380,566,-4294966188,186,0.22077179
41,2,car,4294967273,1061,378,575,-4294966212,197,0.31963575
42,2,car,13,1082,373,578,1069,205,0.5401667
43,2,car,14,1056,383,578,1042,195,0.2695259
44,2,car,4294967270,1099,386,564,-4294966171,178,0.24828371
45,2,car,4294967286,966,380,574,-4294966320,194,0.26321974
0,2,car,501,589,506,562,88,56,0.868128
1,2,car,502,589,507,562,87,55,0.87911797
2,2,car,502,590,506,562,88,56,0.92112195
3,2,car,502,590,506,562,88,56,0.8553335
4,2,car,502,589,506,563,87,57,0.8359229
5,2,car,502,589,506,562,87,56,0.8541347
6,2,car,501,589,506,562,88,56,0.79819185
7,2,car,501,589,506,563,88,57,0.85617733
8,2,car,501,589,507,564,88,57,0.8935997
9,2,car,501,589,507,563,88,56,0.75885755
10,2,car,502,591,509,563,89,54,0.7096379
11,2,car,514,602,494,554,88,60,0.31047094
12,2,car,517,600,504,563,83,59,0.8491415
13,2,car,502,590,508,564,88,56,0.7944646
14,2,car,502,590,509,564,88,55,0.8253944
15,2,car,491,574,495,555,83,60,0.8099735
16,2,car,498,589,509,564,91,55,0.87746143
17,2,car,516,598,504,561,82,57,0.8511085
18,2,car,514,598,507,564,84,57,0.8401219
19,2,car,504,593,510,564,89,54,0.9110706
20,2,car,497,583,508,566,86,58,0.8351104
21,2,car,502,595,509,565,93,56,0.9387687
22,2,car,504,593,510,564,89,54,0.8912073
23,2,car,502,594,510,565,92,55,0.9285165
24,2,car,502,592,510,565,90,55,0.89384234
25,2,car,515,598,504,560,83,56,0.4257941
26,2,car,514,598,507,564,84,57,0.31927696
27,2,car,501,590,510,567,89,57,0.72163993
28,2,car,501,591,509,564,90,55,0.88262093
29,2,car,502,593,510,565,91,55,0.89309627
30,2,car,506,594,506,566,88,60,0.76903325
31,2,car,507,593,509,566,86,57,0.7786368
32,2,car,507,594,508,565,87,57,0.7380539
33,2,car,495,585,509,566,90,57,0.8718345
34,2,car,502,592,508,565,90,57,0.76711863
35,2,car,501,591,508,565,90,57,0.5544183
36,2,car,502,594,508,564,92,56,0.87572163
37,2,car,4294967271,1075,377,560,-4294966196,183,0.3504756
38,2,car,4294967278,1089,361,549,-4294966189,188,0.28828707
39,2,car,4294967277,1090,365,555,-4294966187,190,0.21405561
40,2,car,4294967294,1076,365,560,-4294966218,195,0.28676075
41,2,car,4294967275,1087,380,566,-4294966188,186,0.22077179
42,2,car,4294967273,1061,378,575,-4294966212,197,0.31963575
43,2,car,13,1082,373,578,1069,205,0.5401667
44,2,car,14,1056,383,578,1042,195,0.2695259
45,2,car,4294967270,1099,386,564,-4294966171,178,0.24828371
46,2,car,4294967286,966,380,574,-4294966320,194,0.26321974
0,2,car,501,589,506,562,88,56,0.8826827
1,2,car,501,589,506,562,88,56,0.868128
2,2,car,502,589,507,562,87,55,0.87911797
3,2,car,502,590,506,562,88,56,0.92112195
4,2,car,502,590,506,562,88,56,0.8553335
5,2,car,502,589,506,563,87,57,0.8359229
6,2,car,502,589,506,562,87,56,0.8541347
7,2,car,501,589,506,562,88,56,0.79819185
8,2,car,501,589,506,563,88,57,0.85617733
9,2,car,501,589,507,564,88,57,0.8935997
10,2,car,501,589,507,563,88,56,0.75885755
11,2,car,502,591,509,563,89,54,0.7096379
12,2,car,514,602,494,554,88,60,0.31047094
13,2,car,517,600,504,563,83,59,0.8491415
14,2,car,502,590,508,564,88,56,0.7944646
15,2,car,502,590,509,564,88,55,0.8253944
16,2,car,491,574,495,555,83,60,0.8099735
17,2,car,498,589,509,564,91,55,0.87746143
18,2,car,516,598,504,561,82,57,0.8511085
19,2,car,514,598,507,564,84,57,0.8401219
20,2,car,504,593,510,564,89,54,0.9110706
21,2,car,497,583,508,566,86,58,0.8351104
22,2,car,502,595,509,565,93,56,0.9387687
23,2,car,504,593,510,564,89,54,0.8912073
24,2,car,502,594,510,565,92,55,0.9285165
25,2,car,502,592,510,565,90,55,0.89384234
26,2,car,515,598,504,560,83,56,0.4257941
27,2,car,514,598,507,564,84,57,0.31927696
28,2,car,501,590,510,567,89,57,0.72163993
29,2,car,501,591,509,564,90,55,0.88262093
30,2,car,502,593,510,565,91,55,0.89309627
31,2,car,506,594,506,566,88,60,0.76903325
32,2,car,507,593,509,566,86,57,0.7786368
33,2,car,507,594,508,565,87,57,0.7380539
34,2,car,495,585,509,566,90,57,0.8718345
35,2,car,502,592,508,565,90,57,0.76711863
36,2,car,501,591,508,565,90,57,0.5544183
37,2,car,502,594,508,564,92,56,0.87572163
38,2,car,4294967271,1075,377,560,-4294966196,183,0.3504756
39,2,car,4294967278,1089,361,549,-4294966189,188,0.28828707
40,2,car,4294967277,1090,365,555,-4294966187,190,0.21405561
41,2,car,4294967294,1076,365,560,-4294966218,195,0.28676075
42,2,car,4294967275,1087,380,566,-4294966188,186,0.22077179
43,2,car,4294967273,1061,378,575,-4294966212,197,0.31963575
44,2,car,13,1082,373,578,1069,205,0.5401667
45,2,car,14,1056,383,578,1042,195,0.2695259
46,2,car,4294967270,1099,386,564,-4294966171,178,0.24828371
47,2,car,4294967286,966,380,574,-4294966320,194,0.26321974
0,2,car,502,590,506,562,88,56,0.8953387
1,2,car,501,589,506,562,88,56,0.8826827
2,2,car,501,589,506,562,88,56,0.868128
3,2,car,502,589,507,562,87,55,0.87911797
4,2,car,502,590,506,562,88,56,0.92112195
5,2,car,502,590,506,562,88,56,0.8553335
6,2,car,502,589,506,563,87,57,0.8359229
7,2,car,502,589,506,562,87,56,0.8541347
8,2,car,501,589,506,562,88,56,0.79819185
9,2,car,501,589,506,563,88,57,0.85617733
10,2,car,501,589,507,564,88,57,0.8935997
11,2,car,501,589,507,563,88,56,0.75885755
12,2,car,502,591,509,563,89,54,0.7096379
13,2,car,514,602,494,554,88,60,0.31047094
14,2,car,517,600,504,563,83,59,0.8491415
15,2,car,502,590,508,564,88,56,0.7944646
16,2,car,502,590,509,564,88,55,0.8253944
17,2,car,491,574,495,555,83,60,0.8099735
18,2,car,498,589,509,564,91,55,0.87746143
19,2,car,516,598,504,561,82,57,0.8511085
20,2,car,514,598,507,564,84,57,0.8401219
21,2,car,504,593,510,564,89,54,0.9110706
22,2,car,497,583,508,566,86,58,0.8351104
23,2,car,502,595,509,565,93,56,0.9387687
24,2,car,504,593,510,564,89,54,0.8912073
25,2,car,502,594,510,565,92,55,0.9285165
26,2,car,502,592,510,565,90,55,0.89384234
27,2,car,515,598,504,560,83,56,0.4257941
28,2,car,514,598,507,564,84,57,0.31927696
29,2,car,501,590,510,567,89,57,0.72163993
30,2,car,501,591,509,564,90,55,0.88262093
31,2,car,502,593,510,565,91,55,0.89309627
32,2,car,506,594,506,566,88,60,0.76903325
33,2,car,507,593,509,566,86,57,0.7786368
34,2,car,507,594,508,565,87,57,0.7380539
35,2,car,495,585,509,566,90,57,0.8718345
36,2,car,502,592,508,565,90,57,0.76711863
37,2,car,501,591,508,565,90,57,0.5544183
38,2,car,502,594,508,564,92,56,0.87572163
39,2,car,4294967271,1075,377,560,-4294966196,183,0.3504756
40,2,car,4294967278,1089,361,549,-4294966189,188,0.28828707
41,2,car,4294967277,1090,365,555,-4294966187,190,0.21405561
42,2,car,4294967294,1076,365,560,-4294966218,195,0.28676075
43,2,car,4294967275,1087,380,566,-4294966188,186,0.22077179
44,2,car,4294967273,1061,378,575,-4294966212,197,0.31963575
45,2,car,13,1082,373,578,1069,205,0.5401667
46,2,car,14,1056,383,578,1042,195,0.2695259
47,2,car,4294967270,1099,386,564,-4294966171,178,0.24828371
48,2,car,4294967286,966,380,574,-4294966320,194,0.26321974
0,2,car,502,589,506,562,87,56,0.90897566
1,2,car,502,590,506,562,88,56,0.8953387
2,2,car,501,589,506,562,88,56,0.8826827
3,2,car,501,589,506,562,88,56,0.868128
4,2,car,502,589,507,562,87,55,0.87911797
5,2,car,502,590,506,562,88,56,0.92112195
6,2,car,502,590,506,562,88,56,0.8553335
7,2,car,502,589,506,563,87,57,0.8359229
8,2,car,502,589,506,562,87,56,0.8541347
9,2,car,501,589,506,562,88,56,0.79819185
10,2,car,501,589,506,563,88,57,0.85617733
11,2,car,501,589,507,564,88,57,0.8935997
12,2,car,501,589,507,563,88,56,0.75885755
13,2,car,502,591,509,563,89,54,0.7096379
14,2,car,514,602,494,554,88,60,0.31047094
15,2,car,517,600,504,563,83,59,0.8491415
16,2,car,502,590,508,564,88,56,0.7944646
17,2,car,502,590,509,564,88,55,0.8253944
18,2,car,491,574,495,555,83,60,0.8099735
19,2,car,498,589,509,564,91,55,0.87746143
20,2,car,516,598,504,561,82,57,0.8511085
21,2,car,514,598,507,564,84,57,0.8401219
22,2,car,504,593,510,564,89,54,0.9110706
23,2,car,497,583,508,566,86,58,0.8351104
24,2,car,502,595,509,565,93,56,0.9387687
25,2,car,504,593,510,564,89,54,0.8912073
26,2,car,502,594,510,565,92,55,0.9285165
27,2,car,502,592,510,565,90,55,0.89384234
28,2,car,515,598,504,560,83,56,0.4257941
29,2,car,514,598,507,564,84,57,0.31927696
30,2,car,501,590,510,567,89,57,0.72163993
31,2,car,501,591,509,564,90,55,0.88262093
32,2,car,502,593,510,565,91,55,0.89309627
33,2,car,506,594,506,566,88,60,0.76903325
34,2,car,507,593,509,566,86,57,0.7786368
35,2,car,507,594,508,565,87,57,0.7380539
36,2,car,495,585,509,566,90,57,0.8718345
37,2,car,502,592,508,565,90,57,0.76711863
38,2,car,501,591,508,565,90,57,0.5544183
39,2,car,502,594,508,564,92,56,0.87572163
40,2,car,4294967271,1075,377,560,-4294966196,183,0.3504756
41,2,car,4294967278,1089,361,549,-4294966189,188,0.28828707
42,2,car,4294967277,1090,365,555,-4294966187,190,0.21405561
43,2,car,4294967294,1076,365,560,-4294966218,195,0.28676075
44,2,car,4294967275,1087,380,566,-4294966188,186,0.22077179
45,2,car,4294967273,1061,378,575,-4294966212,197,0.31963575
46,2,car,13,1082,373,578,1069,205,0.5401667
47,2,car,14,1056,383,578,1042,195,0.2695259
48,2,car,4294967270,1099,386,564,-4294966171,178,0.24828371
49,2,car,4294967286,966,380,574,-4294966320,194,0.26321974
0,2,car,501,589,505,562,88,57,0.8158088
1,2,car,502,589,506,562,87,56,0.90897566
2,2,car,502,590,506,562,88,56,0.8953387
3,2,car,501,589,506,562,88,56,0.8826827
4,2,car,501,589,506,562,88,56,0.868128
5,2,car,502,589,507,562,87,55,0.87911797
6,2,car,502,590,506,562,88,56,0.92112195
7,2,car,502,590,506,562,88,56,0.8553335
8,2,car,502,589,506,563,87,57,0.8359229
9,2,car,502,589,506,562,87,56,0.8541347
10,2,car,501,589,506,562,88,56,0.79819185
11,2,car,501,589,506,563,88,57,0.85617733
12,2,car,501,589,507,564,88,57,0.8935997
13,2,car,501,589,507,563,88,56,0.75885755
14,2,car,502,591,509,563,89,54,0.7096379
15,2,car,514,602,494,554,88,60,0.31047094
16,2,car,517,600,504,563,83,59,0.8491415
17,2,car,502,590,508,564,88,56,0.7944646
18,2,car,502,590,509,564,88,55,0.8253944
19,2,car,491,574,495,555,83,60,0.8099735
20,2,car,498,589,509,564,91,55,0.87746143
21,2,car,516,598,504,561,82,57,0.8511085
22,2,car,514,598,507,564,84,57,0.8401219
23,2,car,504,593,510,564,89,54,0.9110706
24,2,car,497,583,508,566,86,58,0.8351104
25,2,car,502,595,509,565,93,56,0.9387687
26,2,car,504,593,510,564,89,54,0.8912073
27,2,car,502,594,510,565,92,55,0.9285165
28,2,car,502,592,510,565,90,55,0.89384234
29,2,car,515,598,504,560,83,56,0.4257941
30,2,car,514,598,507,564,84,57,0.31927696
31,2,car,501,590,510,567,89,57,0.72163993
32,2,car,501,591,509,564,90,55,0.88262093
33,2,car,502,593,510,565,91,55,0.89309627
34,2,car,506,594,506,566,88,60,0.76903325
35,2,car,507,593,509,566,86,57,0.7786368
36,2,car,507,594,508,565,87,57,0.7380539
37,2,car,495,585,509,566,90,57,0.8718345
38,2,car,502,592,508,565,90,57,0.76711863
39,2,car,501,591,508,565,90,57,0.5544183
40,2,car,502,594,508,564,92,56,0.87572163
41,2,car,4294967271,1075,377,560,-4294966196,183,0.3504756
42,2,car,4294967278,1089,361,549,-4294966189,188,0.28828707
43,2,car,4294967277,1090,365,555,-4294966187,190,0.21405561
44,2,car,4294967294,1076,365,560,-4294966218,195,0.28676075
45,2,car,4294967275,1087,380,566,-4294966188,186,0.22077179
46,2,car,4294967273,1061,378,575,-4294966212,197,0.31963575
47,2,car,13,1082,373,578,1069,205,0.5401667
48,2,car,14,1056,383,578,1042,195,0.2695259
49,2,car,4294967270,1099,386,564,-4294966171,178,0.24828371
50,2,car,4294967286,966,380,574,-4294966320,194,0.26321974
0,2,car,503,590,507,562,87,55,0.910038
1,2,car,501,589,505,562,88,57,0.8158088
2,2,car,502,589,506,562,87,56,0.90897566
3,2,car,502,590,506,562,88,56,0.8953387
4,2,car,501,589,506,562,88,56,0.8826827
5,2,car,501,589,506,562,88,56,0.868128
6,2,car,502,589,507,562,87,55,0.87911797
7,2,car,502,590,506,562,88,56,0.92112195
8,2,car,502,590,506,562,88,56,0.8553335
9,2,car,502,589,506,563,87,57,0.8359229
10,2,car,502,589,506,562,87,56,0.8541347
11,2,car,501,589,506,562,88,56,0.79819185
12,2,car,501,589,506,563,88,57,0.85617733
13,2,car,501,589,507,564,88,57,0.8935997
14,2,car,501,589,507,563,88,56,0.75885755
15,2,car,502,591,509,563,89,54,0.7096379
16,2,car,514,602,494,554,88,60,0.31047094
17,2,car,517,600,504,563,83,59,0.8491415
18,2,car,502,590,508,564,88,56,0.7944646
19,2,car,502,590,509,564,88,55,0.8253944
20,2,car,491,574,495,555,83,60,0.8099735
21,2,car,498,589,509,564,91,55,0.87746143
22,2,car,516,598,504,561,82,57,0.8511085
23,2,car,514,598,507,564,84,57,0.8401219
24,2,car,504,593,510,564,89,54,0.9110706
25,2,car,497,583,508,566,86,58,0.8351104
26,2,car,502,595,509,565,93,56,0.9387687
27,2,car,504,593,510,564,89,54,0.8912073
28,2,car,502,594,510,565,92,55,0.9285165
29,2,car,502,592,510,565,90,55,0.89384234
30,2,car,515,598,504,560,83,56,0.4257941
31,2,car,514,598,507,564,84,57,0.31927696
32,2,car,501,590,510,567,89,57,0.72163993
33,2,car,501,591,509,564,90,55,0.88262093
34,2,car,502,593,510,565,91,55,0.89309627
35,2,car,506,594,506,566,88,60,0.76903325
36,2,car,507,593,509,566,86,57,0.7786368
37,2,car,507,594,508,565,87,57,0.7380539
38,2,car,495,585,509,566,90,57,0.8718345
39,2,car,502,592,508,565,90,57,0.76711863
40,2,car,501,591,508,565,90,57,0.5544183
41,2,car,502,594,508,564,92,56,0.87572163
42,2,car,4294967271,1075,377,560,-4294966196,183,0.3504756
43,2,car,4294967278,1089,361,549,-4294966189,188,0.28828707
44,2,car,4294967277,1090,365,555,-4294966187,190,0.21405561
45,2,car,4294967294,1076,365,560,-4294966218,195,0.28676075
46,2,car,4294967275,1087,380,566,-4294966188,186,0.22077179
47,2,car,4294967273,1061,378,575,-4294966212,197,0.31963575
48,2,car,13,1082,373,578,1069,205,0.5401667
49,2,car,14,1056,383,578,1042,195,0.2695259
50,2,car,4294967270,1099,386,564,-4294966171,178,0.24828371
51,2,car,4294967286,966,380,574,-4294966320,194,0.26321974
0,2,car,502,590,505,561,88,56,0.84265935
1,2,car,503,590,507,562,87,55,0.910038
2,2,car,501,589,505,562,88,57,0.8158088
3,2,car,502,589,506,562,87,56,0.90897566
4,2,car,502,590,506,562,88,56,0.8953387
5,2,car,501,589,506,562,88,56,0.8826827
6,2,car,501,589,506,562,88,56,0.868128
7,2,car,502,589,507,562,87,55,0.87911797
8,2,car,502,590,506,562,88,56,0.92112195
9,2,car,502,590,506,562,88,56,0.8553335
10,2,car,502,589,506,563,87,57,0.8359229
11,2,car,502,589,506,562,87,56,0.8541347
12,2,car,501,589,506,562,88,56,0.79819185
13,2,car,501,589,506,563,88,57,0.85617733
14,2,car,501,589,507,564,88,57,0.8935997
15,2,car,501,589,507,563,88,56,0.75885755
16,2,car,502,591,509,563,89,54,0.7096379
17,2,car,514,602,494,554,88,60,0.31047094
18,2,car,517,600,504,563,83,59,0.8491415
19,2,car,502,590,508,564,88,56,0.7944646
20,2,car,502,590,509,564,88,55,0.8253944
21,2,car,491,574,495,555,83,60,0.8099735
22,2,car,498,589,509,564,91,55,0.87746143
23,2,car,516,598,504,561,82,57,0.8511085
24,2,car,514,598,507,564,84,57,0.8401219
25,2,car,504,593,510,564,89,54,0.9110706
26,2,car,497,583,508,566,86,58,0.8351104
27,2,car,502,595,509,565,93,56,0.9387687
28,2,car,504,593,510,564,89,54,0.8912073
29,2,car,502,594,510,565,92,55,0.9285165
30,2,car,502,592,510,565,90,55,0.89384234
31,2,car,515,598,504,560,83,56,0.4257941
32,2,car,514,598,507,564,84,57,0.31927696
33,2,car,501,590,510,567,89,57,0.72163993
34,2,car,501,591,509,564,90,55,0.88262093
35,2,car,502,593,510,565,91,55,0.89309627
36,2,car,506,594,506,566,88,60,0.76903325
37,2,car,507,593,509,566,86,57,0.7786368
38,2,car,507,594,508,565,87,57,0.7380539
39,2,car,495,585,509,566,90,57,0.8718345
40,2,car,502,592,508,565,90,57,0.76711863
41,2,car,501,591,508,565,90,57,0.5544183
42,2,car,502,594,508,564,92,56,0.87572163
43,2,car,4294967271,1075,377,560,-4294966196,183,0.3504756
44,2,car,4294967278,1089,361,549,-4294966189,188,0.28828707
45,2,car,4294967277,1090,365,555,-4294966187,190,0.21405561
46,2,car,4294967294,1076,365,560,-4294966218,195,0.28676075
47,2,car,4294967275,1087,380,566,-4294966188,186,0.22077179
48,2,car,4294967273,1061,378,575,-4294966212,197,0.31963575
49,2,car,13,1082,373,578,1069,205,0.5401667
50,2,car,14,1056,383,578,1042,195,0.2695259
51,2,car,4294967270,1099,386,564,-4294966171,178,0.24828371
52,2,car,4294967286,966,380,574,-4294966320,194,0.26321974
0,2,car,501,589,505,561,88,56,0.88724774
1,2,car,502,590,505,561,88,56,0.84265935
2,2,car,503,590,507,562,87,55,0.910038
3,2,car,501,589,505,562,88,57,0.8158088
4,2,car,502,589,506,562,87,56,0.90897566
5,2,car,502,590,506,562,88,56,0.8953387
6,2,car,501,589,506,562,88,56,0.8826827
7,2,car,501,589,506,562,88,56,0.868128
8,2,car,502,589,507,562,87,55,0.87911797
9,2,car,502,590,506,562,88,56,0.92112195
10,2,car,502,590,506,562,88,56,0.8553335
11,2,car,502,589,506,563,87,57,0.8359229
12,2,car,502,589,506,562,87,56,0.8541347
13,2,car,501,589,506,562,88,56,0.79819185
14,2,car,501,589,506,563,88,57,0.85617733
15,2,car,501,589,507,564,88,57,0.8935997
16,2,car,501,589,507,563,88,56,0.75885755
17,2,car,502,591,509,563,89,54,0.7096379
18,2,car,514,602,494,554,88,60,0.31047094
19,2,car,517,600,504,563,83,59,0.8491415
20,2,car,502,590,508,564,88,56,0.7944646
21,2,car,502,590,509,564,88,55,0.8253944
22,2,car,491,574,495,555,83,60,0.8099735
23,2,car,498,589,509,564,91,55,0.87746143
24,2,car,516,598,504,561,82,57,0.8511085
25,2,car,514,598,507,564,84,57,0.8401219
26,2,car,504,593,510,564,89,54,0.9110706
27,2,car,497,583,508,566,86,58,0.8351104
28,2,car,502,595,509,565,93,56,0.9387687
29,2,car,504,593,510,564,89,54,0.8912073
30,2,car,502,594,510,565,92,55,0.9285165
31,2,car,502,592,510,565,90,55,0.89384234
32,2,car,515,598,504,560,83,56,0.4257941
33,2,car,514,598,507,564,84,57,0.31927696
34,2,car,501,590,510,567,89,57,0.72163993
35,2,car,501,591,509,564,90,55,0.88262093
36,2,car,502,593,510,565,91,55,0.89309627
37,2,car,506,594,506,566,88,60,0.76903325
38,2,car,507,593,509,566,86,57,0.7786368
39,2,car,507,594,508,565,87,57,0.7380539
40,2,car,495,585,509,566,90,57,0.8718345
41,2,car,502,592,508,565,90,57,0.76711863
42,2,car,501,591,508,565,90,57,0.5544183
43,2,car,502,594,508,564,92,56,0.87572163
44,2,car,4294967271,1075,377,560,-4294966196,183,0.3504756
45,2,car,4294967278,1089,361,549,-4294966189,188,0.28828707
46,2,car,4294967277,1090,365,555,-4294966187,190,0.21405561
47,2,car,4294967294,1076,365,560,-4294966218,195,0.28676075
48,2,car,4294967275,1087,380,566,-4294966188,186,0.22077179
49,2,car,4294967273,1061,378,575,-4294966212,197,0.31963575
50,2,car,13,1082,373,578,1069,205,0.5401667
51,2,car,14,1056,383,578,1042,195,0.2695259
52,2,car,4294967270,1099,386,564,-4294966171,178,0.24828371
53,2,car,4294967286,966,380,574,-4294966320,194,0.26321974
0,2,car,503,590,506,562,87,56,0.8665674
1,2,car,501,589,505,561,88,56,0.88724774
2,2,car,502,590,505,561,88,56,0.84265935
3,2,car,503,590,507,562,87,55,0.910038
4,2,car,501,589,505,562,88,57,0.8158088
5,2,car,502,589,506,562,87,56,0.90897566
6,2,car,502,590,506,562,88,56,0.8953387
7,2,car,501,589,506,562,88,56,0.8826827
8,2,car,501,589,506,562,88,56,0.868128
9,2,car,502,589,507,562,87,55,0.87911797
10,2,car,502,590,506,562,88,56,0.92112195
11,2,car,502,590,506,562,88,56,0.8553335
12,2,car,502,589,506,563,87,57,0.8359229
13,2,car,502,589,506,562,87,56,0.8541347
14,2,car,501,589,506,562,88,56,0.79819185
15,2,car,501,589,506,563,88,57,0.85617733
16,2,car,501,589,507,564,88,57,0.8935997
17,2,car,501,589,507,563,88,56,0.75885755
18,2,car,502,591,509,563,89,54,0.7096379
19,2,car,514,602,494,554,88,60,0.31047094
20,2,car,517,600,504,563,83,59,0.8491415
21,2,car,502,590,508,564,88,56,0.7944646
22,2,car,502,590,509,564,88,55,0.8253944
23,2,car,491,574,495,555,83,60,0.8099735
24,2,car,498,589,509,564,91,55,0.87746143
25,2,car,516,598,504,561,82,57,0.8511085
26,2,car,514,598,507,564,84,57,0.8401219
27,2,car,504,593,510,564,89,54,0.9110706
28,2,car,497,583,508,566,86,58,0.8351104
29,2,car,502,595,509,565,93,56,0.9387687
30,2,car,504,593,510,564,89,54,0.8912073
31,2,car,502,594,510,565,92,55,0.9285165
32,2,car,502,592,510,565,90,55,0.89384234
33,2,car,515,598,504,560,83,56,0.4257941
34,2,car,514,598,507,564,84,57,0.31927696
35,2,car,501,590,510,567,89,57,0.72163993
36,2,car,501,591,509,564,90,55,0.88262093
37,2,car,502,593,510,565,91,55,0.89309627
38,2,car,506,594,506,566,88,60,0.76903325
39,2,car,507,593,509,566,86,57,0.7786368
40,2,car,507,594,508,565,87,57,0.7380539
41,2,car,495,585,509,566,90,57,0.8718345
42,2,car,502,592,508,565,90,57,0.76711863
43,2,car,501,591,508,565,90,57,0.5544183
44,2,car,502,594,508,564,92,56,0.87572163
45,2,car,4294967271,1075,377,560,-4294966196,183,0.3504756
46,2,car,4294967278,1089,361,549,-4294966189,188,0.28828707
47,2,car,4294967277,1090,365,555,-4294966187,190,0.21405561
48,2,car,4294967294,1076,365,560,-4294966218,195,0.28676075
49,2,car,4294967275,1087,380,566,-4294966188,186,0.22077179
50,2,car,4294967273,1061,378,575,-4294966212,197,0.31963575
51,2,car,13,1082,373,578,1069,205,0.5401667
52,2,car,14,1056,383,578,1042,195,0.2695259
53,2,car,4294967270,1099,386,564,-4294966171,178,0.24828371
54,2,car,4294967286,966,380,574,-4294966320,194,0.26321974
0,2,car,502,590,505,562,88,57,0.8459921
1,2,car,503,590,506,562,87,56,0.8665674
2,2,car,501,589,505,561,88,56,0.88724774
3,2,car,502,590,505,561,88,56,0.84265935
4,2,car,503,590,507,562,87,55,0.910038
5,2,car,501,589,505,562,88,57,0.8158088
6,2,car,502,589,506,562,87,56,0.90897566
7,2,car,502,590,506,562,88,56,0.8953387
8,2,car,501,589,506,562,88,56,0.8826827
9,2,car,501,589,506,562,88,56,0.868128
10,2,car,502,589,507,562,87,55,0.87911797
11,2,car,502,590,506,562,88,56,0.92112195
12,2,car,502,590,506,562,88,56,0.8553335
13,2,car,502,589,506,563,87,57,0.8359229
14,2,car,502,589,506,562,87,56,0.8541347
15,2,car,501,589,506,562,88,56,0.79819185
16,2,car,501,589,506,563,88,57,0.85617733
17,2,car,501,589,507,564,88,57,0.8935997
18,2,car,501,589,507,563,88,56,0.75885755
19,2,car,502,591,509,563,89,54,0.7096379
20,2,car,514,602,494,554,88,60,0.31047094
21,2,car,517,600,504,563,83,59,0.8491415
22,2,car,502,590,508,564,88,56,0.7944646
23,2,car,502,590,509,564,88,55,0.8253944
24,2,car,491,574,495,555,83,60,0.8099735
25,2,car,498,589,509,564,91,55,0.87746143
26,2,car,516,598,504,561,82,57,0.8511085
27,2,car,514,598,507,564,84,57,0.8401219
28,2,car,504,593,510,564,89,54,0.9110706
29,2,car,497,583,508,566,86,58,0.8351104
30,2,car,502,595,509,565,93,56,0.9387687
31,2,car,504,593,510,564,89,54,0.8912073
32,2,car,502,594,510,565,92,55,0.9285165
33,2,car,502,592,510,565,90,55,0.89384234
34,2,car,515,598,504,560,83,56,0.4257941
35,2,car,514,598,507,564,84,57,0.31927696
36,2,car,501,590,510,567,89,57,0.72163993
37,2,car,501,591,509,564,90,55,0.88262093
38,2,car,502,593,510,565,91,55,0.89309627
39,2,car,506,594,506,566,88,60,0.76903325
40,2,car,507,593,509,566,86,57,0.7786368
41,2,car,507,594,508,565,87,57,0.7380539
42,2,car,495,585,509,566,90,57,0.8718345
43,2,car,502,592,508,565,90,57,0.76711863
44,2,car,501,591,508,565,90,57,0.5544183
45,2,car,502,594,508,564,92,56,0.87572163
46,2,car,4294967271,1075,377,560,-4294966196,183,0.3504756
47,2,car,4294967278,1089,361,549,-4294966189,188,0.28828707
48,2,car,4294967277,1090,365,555,-4294966187,190,0.21405561
49,2,car,4294967294,1076,365,560,-4294966218,195,0.28676075
50,2,car,4294967275,1087,380,566,-4294966188,186,0.22077179
51,2,car,4294967273,1061,378,575,-4294966212,197,0.31963575
52,2,car,13,1082,373,578,1069,205,0.5401667
53,2,car,14,1056,383,578,1042,195,0.2695259
54,2,car,4294967270,1099,386,564,-4294966171,178,0.24828371
55,2,car,4294967286,966,380,574,-4294966320,194,0.26321974
0,2,car,502,589,505,561,87,56,0.90627426
1,2,car,502,590,505,562,88,57,0.8459921
2,2,car,503,590,506,562,87,56,0.8665674
3,2,car,501,589,505,561,88,56,0.88724774
4,2,car,502,590,505,561,88,56,0.84265935
5,2,car,503,590,507,562,87,55,0.910038
6,2,car,501,589,505,562,88,57,0.8158088
7,2,car,502,589,506,562,87,56,0.90897566
8,2,car,502,590,506,562,88,56,0.8953387
9,2,car,501,589,506,562,88,56,0.8826827
10,2,car,501,589,506,562,88,56,0.868128
11,2,car,502,589,507,562,87,55,0.87911797
12,2,car,502,590,506,562,88,56,0.92112195
13,2,car,502,590,506,562,88,56,0.8553335
14,2,car,502,589,506,563,87,57,0.8359229
15,2,car,502,589,506,562,87,56,0.8541347
16,2,car,501,589,506,562,88,56,0.79819185
17,2,car,501,589,506,563,88,57,0.85617733
18,2,car,501,589,507,564,88,57,0.8935997
19,2,car,501,589,507,563,88,56,0.75885755
20,2,car,502,591,509,563,89,54,0.7096379
21,2,car,514,602,494,554,88,60,0.31047094
22,2,car,517,600,504,563,83,59,0.8491415
23,2,car,502,590,508,564,88,56,0.7944646
24,2,car,502,590,509,564,88,55,0.8253944
25,2,car,491,574,495,555,83,60,0.8099735
26,2,car,498,589,509,564,91,55,0.87746143
27,2,car,516,598,504,561,82,57,0.8511085
28,2,car,514,598,507,564,84,57,0.8401219
29,2,car,504,593,510,564,89,54,0.9110706
30,2,car,497,583,508,566,86,58,0.8351104
31,2,car,502,595,509,565,93,56,0.9387687
32,2,car,504,593,510,564,89,54,0.8912073
33,2,car,502,594,510,565,92,55,0.9285165
34,2,car,502,592,510,565,90,55,0.89384234
35,2,car,515,598,504,560,83,56,0.4257941
36,2,car,514,598,507,564,84,57,0.31927696
37,2,car,501,590,510,567,89,57,0.72163993
38,2,car,501,591,509,564,90,55,0.88262093
39,2,car,502,593,510,565,91,55,0.89309627
40,2,car,506,594,506,566,88,60,0.76903325
41,2,car,507,593,509,566,86,57,0.7786368
42,2,car,507,594,508,565,87,57,0.7380539
43,2,car,495,585,509,566,90,57,0.8718345
44,2,car,502,592,508,565,90,57,0.76711863
45,2,car,501,591,508,565,90,57,0.5544183
46,2,car,502,594,508,564,92,56,0.87572163
47,2,car,4294967271,1075,377,560,-4294966196,183,0.3504756
48,2,car,4294967278,1089,361,549,-4294966189,188,0.28828707
49,2,car,4294967277,1090,365,555,-4294966187,190,0.21405561
50,2,car,4294967294,1076,365,560,-4294966218,195,0.28676075
51,2,car,4294967275,1087,380,566,-4294966188,186,0.22077179
52,2,car,4294967273,1061,378,575,-4294966212,197,0.31963575
53,2,car,13,1082,373,578,1069,205,0.5401667
54,2,car,14,1056,383,578,1042,195,0.2695259
55,2,car,4294967270,1099,386,564,-4294966171,178,0.24828371
56,2,car,4294967286,966,380,574,-4294966320,194,0.26321974
0,2,car,502,590,507,562,88,55,0.9228381
1,2,car,502,589,505,561,87,56,0.90627426
2,2,car,502,590,505,562,88,57,0.8459921
3,2,car,503,590,506,562,87,56,0.8665674
4,2,car,501,589,505,561,88,56,0.88724774
5,2,car,502,590,505,561,88,56,0.84265935
6,2,car,503,590,507,562,87,55,0.910038
7,2,car,501,589,505,562,88,57,0.8158088
8,2,car,502,589,506,562,87,56,0.90897566
9,2,car,502,590,506,562,88,56,0.8953387
10,2,car,501,589,506,562,88,56,0.8826827
11,2,car,501,589,506,562,88,56,0.868128
12,2,car,502,589,507,562,87,55,0.87911797
13,2,car,502,590,506,562,88,56,0.92112195
14,2,car,502,590,506,562,88,56,0.8553335
15,2,car,502,589,506,563,87,57,0.8359229
16,2,car,502,589,506,562,87,56,0.8541347
17,2,car,501,589,506,562,88,56,0.79819185
18,2,car,501,589,506,563,88,57,0.85617733
19,2,car,501,589,507,564,88,57,0.8935997
20,2,car,501,589,507,563,88,56,0.75885755
21,2,car,502,591,509,563,89,54,0.7096379
22,2,car,514,602,494,554,88,60,0.31047094
23,2,car,517,600,504,563,83,59,0.8491415
24,2,car,502,590,508,564,88,56,0.7944646
25,2,car,502,590,509,564,88,55,0.8253944
26,2,car,491,574,495,555,83,60,0.8099735
27,2,car,498,589,509,564,91,55,0.87746143
28,2,car,516,598,504,561,82,57,0.8511085
29,2,car,514,598,507,564,84,57,0.8401219
30,2,car,504,593,510,564,89,54,0.9110706
31,2,car,497,583,508,566,86,58,0.8351104
32,2,car,502,595,509,565,93,56,0.9387687
33,2,car,504,593,510,564,89,54,0.8912073
34,2,car,502,594,510,565,92,55,0.9285165
35,2,car,502,592,510,565,90,55,0.89384234
36,2,car,515,598,504,560,83,56,0.4257941
37,2,car,514,598,507,564,84,57,0.31927696
38,2,car,501,590,510,567,89,57,0.72163993
39,2,car,501,591,509,564,90,55,0.88262093
40,2,car,502,593,510,565,91,55,0.89309627
41,2,car,506,594,506,566,88,60,0.76903325
42,2,car,507,593,509,566,86,57,0.7786368
43,2,car,507,594,508,565,87,57,0.7380539
44,2,car,495,585,509,566,90,57,0.8718345
45,2,car,502,592,508,565,90,57,0.76711863
46,2,car,501,591,508,565,90,57,0.5544183
47,2,car,502,594,508,564,92,56,0.87572163
48,2,car,4294967271,1075,377,560,-4294966196,183,0.3504756
49,2,car,4294967278,1089,361,549,-4294966189,188,0.28828707
50,2,car,4294967277,1090,365,555,-4294966187,190,0.21405561
51,2,car,4294967294,1076,365,560,-4294966218,195,0.28676075
52,2,car,4294967275,1087,380,566,-4294966188,186,0.22077179
53,2,car,4294967273,1061,378,575,-4294966212,197,0.31963575
54,2,car,13,1082,373,578,1069,205,0.5401667
55,2,car,14,1056,383,578,1042,195,0.2695259
56,2,car,4294967270,1099,386,564,-4294966171,178,0.24828371
57,2,car,4294967286,966,380,574,-4294966320,194,0.26321974
0,2,car,502,590,505,562,88,57,0.8950311
1,2,car,502,590,507,562,88,55,0.9228381
2,2,car,502,589,505,561,87,56,0.90627426
3,2,car,502,590,505,562,88,57,0.8459921
4,2,car,503,590,506,562,87,56,0.8665674
5,2,car,501,589,505,561,88,56,0.88724774
6,2,car,502,590,505,561,88,56,0.84265935
7,2,car,503,590,507,562,87,55,0.910038
8,2,car,501,589,505,562,88,57,0.8158088
9,2,car,502,589,506,562,87,56,0.90897566
10,2,car,502,590,506,562,88,56,0.8953387
11,2,car,501,589,506,562,88,56,0.8826827
12,2,car,501,589,506,562,88,56,0.868128
13,2,car,502,589,507,562,87,55,0.87911797
14,2,car,502,590,506,562,88,56,0.92112195
15,2,car,502,590,506,562,88,56,0.8553335
16,2,car,502,589,506,563,87,57,0.8359229
17,2,car,502,589,506,562,87,56,0.8541347
18,2,car,501,589,506,562,88,56,0.79819185
19,2,car,501,589,506,563,88,57,0.85617733
20,2,car,501,589,507,564,88,57,0.8935997
21,2,car,501,589,507,563,88,56,0.75885755
22,2,car,502,591,509,563,89,54,0.7096379
23,2,car,514,602,494,554,88,60,0.31047094
24,2,car,517,600,504,563,83,59,0.8491415
25,2,car,502,590,508,564,88,56,0.7944646
26,2,car,502,590,509,564,88,55,0.8253944
27,2,car,491,574,495,555,83,60,0.8099735
28,2,car,498,589,509,564,91,55,0.87746143
29,2,car,516,598,504,561,82,57,0.8511085
30,2,car,514,598,507,564,84,57,0.8401219
31,2,car,504,593,510,564,89,54,0.9110706
32,2,car,497,583,508,566,86,58,0.8351104
33,2,car,502,595,509,565,93,56,0.9387687
34,2,car,504,593,510,564,89,54,0.8912073
35,2,car,502,594,510,565,92,55,0.9285165
36,2,car,502,592,510,565,90,55,0.89384234
37,2,car,515,598,504,560,83,56,0.4257941
38,2,car,514,598,507,564,84,57,0.31927696
39,2,car,501,590,510,567,89,57,0.72163993
40,2,car,501,591,509,564,90,55,0.88262093
41,2,car,502,593,510,565,91,55,0.89309627
42,2,car,506,594,506,566,88,60,0.76903325
43,2,car,507,593,509,566,86,57,0.7786368
44,2,car,507,594,508,565,87,57,0.7380539
45,2,car,495,585,509,566,90,57,0.8718345
46,2,car,502,592,508,565,90,57,0.76711863
47,2,car,501,591,508,565,90,57,0.5544183
48,2,car,502,594,508,564,92,56,0.87572163
49,2,car,4294967271,1075,377,560,-4294966196,183,0.3504756
50,2,car,4294967278,1089,361,549,-4294966189,188,0.28828707
51,2,car,4294967277,1090,365,555,-4294966187,190,0.21405561
52,2,car,4294967294,1076,365,560,-4294966218,195,0.28676075
53,2,car,4294967275,1087,380,566,-4294966188,186,0.22077179
54,2,car,4294967273,1061,378,575,-4294966212,197,0.31963575
55,2,car,13,1082,373,578,1069,205,0.5401667
56,2,car,14,1056,383,578,1042,195,0.2695259
57,2,car,4294967270,1099,386,564,-4294966171,178,0.24828371
58,2,car,4294967286,966,380,574,-4294966320,194,0.26321974
0,2,car,501,589,505,562,88,57,0.8479053
1,2,car,502,590,505,562,88,57,0.8950311
2,2,car,502,590,507,562,88,55,0.9228381
3,2,car,502,589,505,561,87,56,0.90627426
4,2,car,502,590,505,562,88,57,0.8459921
5,2,car,503,590,506,562,87,56,0.8665674
6,2,car,501,589,505,561,88,56,0.88724774
7,2,car,502,590,505,561,88,56,0.84265935
8,2,car,503,590,507,562,87,55,0.910038
9,2,car,501,589,505,562,88,57,0.8158088
10,2,car,502,589,506,562,87,56,0.90897566
11,2,car,502,590,506,562,88,56,0.8953387
12,2,car,501,589,506,562,88,56,0.8826827
13,2,car,501,589,506,562,88,56,0.868128
14,2,car,502,589,507,562,87,55,0.87911797
15,2,car,502,590,506,562,88,56,0.92112195
16,2,car,502,590,506,562,88,56,0.8553335
17,2,car,502,589,506,563,87,57,0.8359229
18,2,car,502,589,506,562,87,56,0.8541347
19,2,car,501,589,506,562,88,56,0.79819185
20,2,car,501,589,506,563,88,57,0.85617733
21,2,car,501,589,507,564,88,57,0.8935997
22,2,car,501,589,507,563,88,56,0.75885755
23,2,car,502,591,509,563,89,54,0.7096379
24,2,car,514,602,494,554,88,60,0.31047094
25,2,car,517,600,504,563,83,59,0.8491415
26,2,car,502,590,508,564,88,56,0.7944646
27,2,car,502,590,509,564,88,55,0.8253944
28,2,car,491,574,495,555,83,60,0.8099735
29,2,car,498,589,509,564,91,55,0.87746143
30,2,car,516,598,504,561,82,57,0.8511085
31,2,car,514,598,507,564,84,57,0.8401219
32,2,car,504,593,510,564,89,54,0.9110706
33,2,car,497,583,508,566,86,58,0.8351104
34,2,car,502,595,509,565,93,56,0.9387687
35,2,car,504,593,510,564,89,54,0.8912073
36,2,car,502,594,510,565,92,55,0.9285165
37,2,car,502,592,510,565,90,55,0.89384234
38,2,car,515,598,504,560,83,56,0.4257941
39,2,car,514,598,507,564,84,57,0.31927696
40,2,car,501,590,510,567,89,57,0.72163993
41,2,car,501,591,509,564,90,55,0.88262093
42,2,car,502,593,510,565,91,55,0.89309627
43,2,car,506,594,506,566,88,60,0.76903325
44,2,car,507,593,509,566,86,57,0.7786368
45,2,car,507,594,508,565,87,57,0.7380539
46,2,car,495,585,509,566,90,57,0.8718345
47,2,car,502,592,508,565,90,57,0.76711863
48,2,car,501,591,508,565,90,57,0.5544183
49,2,car,502,594,508,564,92,56,0.87572163
50,2,car,4294967271,1075,377,560,-4294966196,183,0.3504756
51,2,car,4294967278,1089,361,549,-4294966189,188,0.28828707
52,2,car,4294967277,1090,365,555,-4294966187,190,0.21405561
53,2,car,4294967294,1076,365,560,-4294966218,195,0.28676075
54,2,car,4294967275,1087,380,566,-4294966188,186,0.22077179
55,2,car,4294967273,1061,378,575,-4294966212,197,0.31963575
56,2,car,13,1082,373,578,1069,205,0.5401667
57,2,car,14,1056,383,578,1042,195,0.2695259
58,2,car,4294967270,1099,386,564,-4294966171,178,0.24828371
59,2,car,4294967286,966,380,574,-4294966320,194,0.26321974
0,2,car,501,589,506,562,88,56,0.8497129
1,2,car,501,589,505,562,88,57,0.8479053
2,2,car,502,590,505,562,88,57,0.8950311
3,2,car,502,590,507,562,88,55,0.9228381
4,2,car,502,589,505,561,87,56,0.90627426
5,2,car,502,590,505,562,88,57,0.8459921
6,2,car,503,590,506,562,87,56,0.8665674
7,2,car,501,589,505,561,88,56,0.88724774
8,2,car,502,590,505,561,88,56,0.84265935
9,2,car,503,590,507,562,87,55,0.910038
10,2,car,501,589,505,562,88,57,0.8158088
11,2,car,502,589,506,562,87,56,0.90897566
12,2,car,502,590,506,562,88,56,0.8953387
13,2,car,501,589,506,562,88,56,0.8826827
14,2,car,501,589,506,562,88,56,0.868128
15,2,car,502,589,507,562,87,55,0.87911797
16,2,car,502,590,506,562,88,56,0.92112195
17,2,car,502,590,506,562,88,56,0.8553335
18,2,car,502,589,506,563,87,57,0.8359229
19,2,car,502,589,506,562,87,56,0.8541347
20,2,car,501,589,506,562,88,56,0.79819185
21,2,car,501,589,506,563,88,57,0.85617733
22,2,car,501,589,507,564,88,57,0.8935997
23,2,car,501,589,507,563,88,56,0.75885755
24,2,car,502,591,509,563,89,54,0.7096379
25,2,car,514,602,494,554,88,60,0.31047094
26,2,car,517,600,504,563,83,59,0.8491415
27,2,car,502,590,508,564,88,56,0.7944646
28,2,car,502,590,509,564,88,55,0.8253944
29,2,car,491,574,495,555,83,60,0.8099735
30,2,car,498,589,509,564,91,55,0.87746143
31,2,car,516,598,504,561,82,57,0.8511085
32,2,car,514,598,507,564,84,57,0.8401219
33,2,car,504,593,510,564,89,54,0.9110706
34,2,car,497,583,508,566,86,58,0.8351104
35,2,car,502,595,509,565,93,56,0.9387687
36,2,car,504,593,510,564,89,54,0.8912073
37,2,car,502,594,510,565,92,55,0.9285165
38,2,car,502,592,510,565,90,55,0.89384234
39,2,car,515,598,504,560,83,56,0.4257941
40,2,car,514,598,507,564,84,57,0.31927696
41,2,car,501,590,510,567,89,57,0.72163993
42,2,car,501,591,509,564,90,55,0.88262093
43,2,car,502,593,510,565,91,55,0.89309627
44,2,car,506,594,506,566,88,60,0.76903325
45,2,car,507,593,509,566,86,57,0.7786368
46,2,car,507,594,508,565,87,57,0.7380539
47,2,car,495,585,509,566,90,57,0.8718345
48,2,car,502,592,508,565,90,57,0.76711863
49,2,car,501,591,508,565,90,57,0.5544183
50,2,car,502,594,508,564,92,56,0.87572163
51,2,car,4294967271,1075,377,560,-4294966196,183,0.3504756
52,2,car,4294967278,1089,361,549,-4294966189,188,0.28828707
53,2,car,4294967277,1090,365,555,-4294966187,190,0.21405561
54,2,car,4294967294,1076,365,560,-4294966218,195,0.28676075
55,2,car,4294967275,1087,380,566,-4294966188,186,0.22077179
56,2,car,4294967273,1061,378,575,-4294966212,197,0.31963575
57,2,car,13,1082,373,578,1069,205,0.5401667
58,2,car,14,1056,383,578,1042,195,0.2695259
59,2,car,4294967270,1099,386,564,-4294966171,178,0.24828371
60,2,car,4294967286,966,380,574,-4294966320,194,0.26321974
0,2,car,502,589,506,562,87,56,0.87762594
1,2,car,501,589,506,562,88,56,0.8497129
2,2,car,501,589,505,562,88,57,0.8479053
3,2,car,502,590,505,562,88,57,0.8950311
4,2,car,502,590,507,562,88,55,0.9228381
5,2,car,502,589,505,561,87,56,0.90627426
6,2,car,502,590,505,562,88,57,0.8459921
7,2,car,503,590,506,562,87,56,0.8665674
8,2,car,501,589,505,561,88,56,0.88724774
9,2,car,502,590,505,561,88,56,0.84265935
10,2,car,503,590,507,562,87,55,0.910038
11,2,car,501,589,505,562,88,57,0.8158088
12,2,car,502,589,506,562,87,56,0.90897566
13,2,car,502,590,506,562,88,56,0.8953387
14,2,car,501,589,506,562,88,56,0.8826827
15,2,car,501,589,506,562,88,56,0.868128
16,2,car,502,589,507,562,87,55,0.87911797
17,2,car,502,590,506,562,88,56,0.92112195
18,2,car,502,590,506,562,88,56,0.8553335
19,2,car,502,589,506,563,87,57,0.8359229
20,2,car,502,589,506,562,87,56,0.8541347
21,2,car,501,589,506,562,88,56,0.79819185
22,2,car,501,589,506,563,88,57,0.85617733
23,2,car,501,589,507,564,88,57,0.8935997
24,2,car,501,589,507,563,88,56,0.75885755
25,2,car,502,591,509,563,89,54,0.7096379
26,2,car,514,602,494,554,88,60,0.31047094
27,2,car,517,600,504,563,83,59,0.8491415
28,2,car,502,590,508,564,88,56,0.7944646
29,2,car,502,590,509,564,88,55,0.8253944
30,2,car,491,574,495,555,83,60,0.8099735
31,2,car,498,589,509,564,91,55,0.87746143
32,2,car,516,598,504,561,82,57,0.8511085
33,2,car,514,598,507,564,84,57,0.8401219
34,2,car,504,593,510,564,89,54,0.9110706
35,2,car,497,583,508,566,86,58,0.8351104
36,2,car,502,595,509,565,93,56,0.9387687
37,2,car,504,593,510,564,89,54,0.8912073
38,2,car,502,594,510,565,92,55,0.9285165
39,2,car,502,592,510,565,90,55,0.89384234
40,2,car,515,598,504,560,83,56,0.4257941
41,2,car,514,598,507,564,84,57,0.31927696
42,2,car,501,590,510,567,89,57,0.72163993
43,2,car,501,591,509,564,90,55,0.88262093
44,2,car,502,593,510,565,91,55,0.89309627
45,2,car,506,594,506,566,88,60,0.76903325
46,2,car,507,593,509,566,86,57,0.7786368
47,2,car,507,594,508,565,87,57,0.7380539
48,2,car,495,585,509,566,90,57,0.8718345
49,2,car,502,592,508,565,90,57,0.76711863
50,2,car,501,591,508,565,90,57,0.5544183
51,2,car,502,594,508,564,92,56,0.87572163
52,2,car,4294967271,1075,377,560,-4294966196,183,0.3504756
53,2,car,4294967278,1089,361,549,-4294966189,188,0.28828707
54,2,car,4294967277,1090,365,555,-4294966187,190,0.21405561
55,2,car,4294967294,1076,365,560,-4294966218,195,0.28676075
56,2,car,4294967275,1087,380,566,-4294966188,186,0.22077179
57,2,car,4294967273,1061,378,575,-4294966212,197,0.31963575
58,2,car,13,1082,373,578,1069,205,0.5401667
59,2,car,14,1056,383,578,1042,195,0.2695259
60,2,car,4294967270,1099,386,564,-4294966171,178,0.24828371
61,2,car,4294967286,966,380,574,-4294966320,194,0.26321974
0,2,car,502,590,505,561,88,56,0.86747587
1,2,car,502,589,506,562,87,56,0.87762594
2,2,car,501,589,506,562,88,56,0.8497129
3,2,car,501,589,505,562,88,57,0.8479053
4,2,car,502,590,505,562,88,57,0.8950311
5,2,car,502,590,507,562,88,55,0.9228381
6,2,car,502,589,505,561,87,56,0.90627426
7,2,car,502,590,505,562,88,57,0.8459921
8,2,car,503,590,506,562,87,56,0.8665674
9,2,car,501,589,505,561,88,56,0.88724774
10,2,car,502,590,505,561,88,56,0.84265935
11,2,car,503,590,507,562,87,55,0.910038
12,2,car,501,589,505,562,88,57,0.8158088
13,2,car,502,589,506,562,87,56,0.90897566
14,2,car,502,590,506,562,88,56,0.8953387
15,2,car,501,589,506,562,88,56,0.8826827
16,2,car,501,589,506,562,88,56,0.868128
17,2,car,502,589,507,562,87,55,0.87911797
18,2,car,502,590,506,562,88,56,0.92112195
19,2,car,502,590,506,562,88,56,0.8553335
20,2,car,502,589,506,563,87,57,0.8359229
21,2,car,502,589,506,562,87,56,0.8541347
22,2,car,501,589,506,562,88,56,0.79819185
23,2,car,501,589,506,563,88,57,0.85617733
24,2,car,501,589,507,564,88,57,0.8935997
25,2,car,501,589,507,563,88,56,0.75885755
26,2,car,502,591,509,563,89,54,0.7096379
27,2,car,514,602,494,554,88,60,0.31047094
28,2,car,517,600,504,563,83,59,0.8491415
29,2,car,502,590,508,564,88,56,0.7944646
30,2,car,502,590,509,564,88,55,0.8253944
31,2,car,491,574,495,555,83,60,0.8099735
32,2,car,498,589,509,564,91,55,0.87746143
33,2,car,516,598,504,561,82,57,0.8511085
34,2,car,514,598,507,564,84,57,0.8401219
35,2,car,504,593,510,564,89,54,0.9110706
36,2,car,497,583,508,566,86,58,0.8351104
37,2,car,502,595,509,565,93,56,0.9387687
38,2,car,504,593,510,564,89,54,0.8912073
39,2,car,502,594,510,565,92,55,0.9285165
40,2,car,502,592,510,565,90,55,0.89384234
41,2,car,515,598,504,560,83,56,0.4257941
42,2,car,514,598,507,564,84,57,0.31927696
43,2,car,501,590,510,567,89,57,0.72163993
44,2,car,501,591,509,564,90,55,0.88262093
45,2,car,502,593,510,565,91,55,0.89309627
46,2,car,506,594,506,566,88,60,0.76903325
47,2,car,507,593,509,566,86,57,0.7786368
48,2,car,507,594,508,565,87,57,0.7380539
49,2,car,495,585,509,566,90,57,0.8718345
50,2,car,502,592,508,565,90,57,0.76711863
51,2,car,501,591,508,565,90,57,0.5544183
52,2,car,502,594,508,564,92,56,0.87572163
53,2,car,4294967271,1075,377,560,-4294966196,183,0.3504756
54,2,car,4294967278,1089,361,549,-4294966189,188,0.28828707
55,2,car,4294967277,1090,365,555,-4294966187,190,0.21405561
56,2,car,4294967294,1076,365,560,-4294966218,195,0.28676075
57,2,car,4294967275,1087,380,566,-4294966188,186,0.22077179
58,2,car,4294967273,1061,378,575,-4294966212,197,0.31963575
59,2,car,13,1082,373,578,1069,205,0.5401667
60,2,car,14,1056,383,578,1042,195,0.2695259
61,2,car,4294967270,1099,386,564,-4294966171,178,0.24828371
62,2,car,4294967286,966,380,574,-4294966320,194,0.26321974
0,2,car,503,590,506,563,87,57,0.907217
1,2,car,502,590,505,561,88,56,0.86747587
2,2,car,502,589,506,562,87,56,0.87762594
3,2,car,501,589,506,562,88,56,0.8497129
4,2,car,501,589,505,562,88,57,0.8479053
5,2,car,502,590,505,562,88,57,0.8950311
6,2,car,502,590,507,562,88,55,0.9228381
7,2,car,502,589,505,561,87,56,0.90627426
8,2,car,502,590,505,562,88,57,0.8459921
9,2,car,503,590,506,562,87,56,0.8665674
10,2,car,501,589,505,561,88,56,0.88724774
11,2,car,502,590,505,561,88,56,0.84265935
12,2,car,503,590,507,562,87,55,0.910038
13,2,car,501,589,505,562,88,57,0.8158088
14,2,car,502,589,506,562,87,56,0.90897566
15,2,car,502,590,506,562,88,56,0.8953387
16,2,car,501,589,506,562,88,56,0.8826827
17,2,car,501,589,506,562,88,56,0.868128
18,2,car,502,589,507,562,87,55,0.87911797
19,2,car,502,590,506,562,88,56,0.92112195
20,2,car,502,590,506,562,88,56,0.8553335
21,2,car,502,589,506,563,87,57,0.8359229
22,2,car,502,589,506,562,87,56,0.8541347
23,2,car,501,589,506,562,88,56,0.79819185
24,2,car,501,589,506,563,88,57,0.85617733
25,2,car,501,589,507,564,88,57,0.8935997
26,2,car,501,589,507,563,88,56,0.75885755
27,2,car,502,591,509,563,89,54,0.7096379
28,2,car,514,602,494,554,88,60,0.31047094
29,2,car,517,600,504,563,83,59,0.8491415
30,2,car,502,590,508,564,88,56,0.7944646
31,2,car,502,590,509,564,88,55,0.8253944
32,2,car,491,574,495,555,83,60,0.8099735
33,2,car,498,589,509,564,91,55,0.87746143
34,2,car,516,598,504,561,82,57,0.8511085
35,2,car,514,598,507,564,84,57,0.8401219
36,2,car,504,593,510,564,89,54,0.9110706
37,2,car,497,583,508,566,86,58,0.8351104
38,2,car,502,595,509,565,93,56,0.9387687
39,2,car,504,593,510,564,89,54,0.8912073
40,2,car,502,594,510,565,92,55,0.9285165
41,2,car,502,592,510,565,90,55,0.89384234
42,2,car,515,598,504,560,83,56,0.4257941
43,2,car,514,598,507,564,84,57,0.31927696
44,2,car,501,590,510,567,89,57,0.72163993
45,2,car,501,591,509,564,90,55,0.88262093
46,2,car,502,593,510,565,91,55,0.89309627
47,2,car,506,594,506,566,88,60,0.76903325
48,2,car,507,593,509,566,86,57,0.7786368
49,2,car,507,594,508,565,87,57,0.7380539
50,2,car,495,585,509,566,90,57,0.8718345
51,2,car,502,592,508,565,90,57,0.76711863
52,2,car,501,591,508,565,90,57,0.5544183
53,2,car,502,594,508,564,92,56,0.87572163
54,2,car,4294967271,1075,377,560,-4294966196,183,0.3504756
55,2,car,4294967278,1089,361,549,-4294966189,188,0.28828707
56,2,car,4294967277,1090,365,555,-4294966187,190,0.21405561
57,2,car,4294967294,1076,365,560,-4294966218,195,0.28676075
58,2,car,4294967275,1087,380,566,-4294966188,186,0.22077179
59,2,car,4294967273,1061,378,575,-4294966212,197,0.31963575
60,2,car,13,1082,373,578,1069,205,0.5401667
61,2,car,14,1056,383,578,1042,195,0.2695259
62,2,car,4294967270,1099,386,564,-4294966171,178,0.24828371
63,2,car,4294967286,966,380,574,-4294966320,194,0.26321974
0,2,car,502,590,506,562,88,56,0.88858736
1,2,car,503,590,506,563,87,57,0.907217
2,2,car,502,590,505,561,88,56,0.86747587
3,2,car,502,589,506,562,87,56,0.87762594
4,2,car,501,589,506,562,88,56,0.8497129
5,2,car,501,589,505,562,88,57,0.8479053
6,2,car,502,590,505,562,88,57,0.8950311
7,2,car,502,590,507,562,88,55,0.9228381
8,2,car,502,589,505,561,87,56,0.90627426
9,2,car,502,590,505,562,88,57,0.8459921
10,2,car,503,590,506,562,87,56,0.8665674
11,2,car,501,589,505,561,88,56,0.88724774
12,2,car,502,590,505,561,88,56,0.84265935
13,2,car,503,590,507,562,87,55,0.910038
14,2,car,501,589,505,562,88,57,0.8158088
15,2,car,502,589,506,562,87,56,0.90897566
16,2,car,502,590,506,562,88,56,0.8953387
17,2,car,501,589,506,562,88,56,0.8826827
18,2,car,501,589,506,562,88,56,0.868128
19,2,car,502,589,507,562,87,55,0.87911797
20,2,car,502,590,506,562,88,56,0.92112195
21,2,car,502,590,506,562,88,56,0.8553335
22,2,car,502,589,506,563,87,57,0.8359229
23,2,car,502,589,506,562,87,56,0.8541347
24,2,car,501,589,506,562,88,56,0.79819185
25,2,car,501,589,506,563,88,57,0.85617733
26,2,car,501,589,507,564,88,57,0.8935997
27,2,car,501,589,507,563,88,56,0.75885755
28,2,car,502,591,509,563,89,54,0.7096379
29,2,car,514,602,494,554,88,60,0.31047094
30,2,car,517,600,504,563,83,59,0.8491415
31,2,car,502,590,508,564,88,56,0.7944646
32,2,car,502,590,509,564,88,55,0.8253944
33,2,car,491,574,495,555,83,60,0.8099735
34,2,car,498,589,509,564,91,55,0.87746143
35,2,car,516,598,504,561,82,57,0.8511085
36,2,car,514,598,507,564,84,57,0.8401219
37,2,car,504,593,510,564,89,54,0.9110706
38,2,car,497,583,508,566,86,58,0.8351104
39,2,car,502,595,509,565,93,56,0.9387687
40,2,car,504,593,510,564,89,54,0.8912073
41,2,car,502,594,510,565,92,55,0.9285165
42,2,car,502,592,510,565,90,55,0.89384234
43,2,car,515,598,504,560,83,56,0.4257941
44,2,car,514,598,507,564,84,57,0.31927696
45,2,car,501,590,510,567,89,57,0.72163993
46,2,car,501,591,509,564,90,55,0.88262093
47,2,car,502,593,510,565,91,55,0.89309627
48,2,car,506,594,506,566,88,60,0.76903325
49,2,car,507,593,509,566,86,57,0.7786368
50,2,car,507,594,508,565,87,57,0.7380539
51,2,car,495,585,509,566,90,57,0.8718345
52,2,car,502,592,508,565,90,57,0.76711863
53,2,car,501,591,508,565,90,57,0.5544183
54,2,car,502,594,508,564,92,56,0.87572163
55,2,car,4294967271,1075,377,560,-4294966196,183,0.3504756
56,2,car,4294967278,1089,361,549,-4294966189,188,0.28828707
57,2,car,4294967277,1090,365,555,-4294966187,190,0.21405561
58,2,car,4294967294,1076,365,560,-4294966218,195,0.28676075
59,2,car,4294967275,1087,380,566,-4294966188,186,0.22077179
60,2,car,4294967273,1061,378,575,-4294966212,197,0.31963575
61,2,car,13,1082,373,578,1069,205,0.5401667
62,2,car,14,1056,383,578,1042,195,0.2695259
63,2,car,4294967270,1099,386,564,-4294966171,178,0.24828371
64,2,car,4294967286,966,380,574,-4294966320,194,0.26321974
0,2,car,503,590,506,562,87,56,0.86517256
1,2,car,502,590,506,562,88,56,0.88858736
2,2,car,503,590,506,563,87,57,0.907217
3,2,car,502,590,505,561,88,56,0.86747587
4,2,car,502,589,506,562,87,56,0.87762594
5,2,car,501,589,506,562,88,56,0.8497129
6,2,car,501,589,505,562,88,57,0.8479053
7,2,car,502,590,505,562,88,57,0.8950311
8,2,car,502,590,507,562,88,55,0.9228381
9,2,car,502,589,505,561,87,56,0.90627426
10,2,car,502,590,505,562,88,57,0.8459921
11,2,car,503,590,506,562,87,56,0.8665674
12,2,car,501,589,505,561,88,56,0.88724774
13,2,car,502,590,505,561,88,56,0.84265935
14,2,car,503,590,507,562,87,55,0.910038
15,2,car,501,589,505,562,88,57,0.8158088
16,2,car,502,589,506,562,87,56,0.90897566
17,2,car,502,590,506,562,88,56,0.8953387
18,2,car,501,589,506,562,88,56,0.8826827
19,2,car,501,589,506,562,88,56,0.868128
20,2,car,502,589,507,562,87,55,0.87911797
21,2,car,502,590,506,562,88,56,0.92112195
22,2,car,502,590,506,562,88,56,0.8553335
23,2,car,502,589,506,563,87,57,0.8359229
24,2,car,502,589,506,562,87,56,0.8541347
25,2,car,501,589,506,562,88,56,0.79819185
26,2,car,501,589,506,563,88,57,0.85617733
27,2,car,501,589,507,564,88,57,0.8935997
28,2,car,501,589,507,563,88,56,0.75885755
29,2,car,502,591,509,563,89,54,0.7096379
30,2,car,514,602,494,554,88,60,0.31047094
31,2,car,517,600,504,563,83,59,0.8491415
32,2,car,502,590,508,564,88,56,0.7944646
33,2,car,502,590,509,564,88,55,0.8253944
34,2,car,491,574,495,555,83,60,0.8099735
35,2,car,498,589,509,564,91,55,0.87746143
36,2,car,516,598,504,561,82,57,0.8511085
37,2,car,514,598,507,564,84,57,0.8401219
38,2,car,504,593,510,564,89,54,0.9110706
39,2,car,497,583,508,566,86,58,0.8351104
40,2,car,502,595,509,565,93,56,0.9387687
41,2,car,504,593,510,564,89,54,0.8912073
42,2,car,502,594,510,565,92,55,0.9285165
43,2,car,502,592,510,565,90,55,0.89384234
44,2,car,515,598,504,560,83,56,0.4257941
45,2,car,514,598,507,564,84,57,0.31927696
46,2,car,501,590,510,567,89,57,0.72163993
47,2,car,501,591,509,564,90,55,0.88262093
48,2,car,502,593,510,565,91,55,0.89309627
49,2,car,506,594,506,566,88,60,0.76903325
50,2,car,507,593,509,566,86,57,0.7786368
51,2,car,507,594,508,565,87,57,0.7380539
52,2,car,495,585,509,566,90,57,0.8718345
53,2,car,502,592,508,565,90,57,0.76711863
54,2,car,501,591,508,565,90,57,0.5544183
55,2,car,502,594,508,564,92,56,0.87572163
56,2,car,4294967271,1075,377,560,-4294966196,183,0.3504756
57,2,car,4294967278,1089,361,549,-4294966189,188,0.28828707
58,2,car,4294967277,1090,365,555,-4294966187,190,0.21405561
59,2,car,4294967294,1076,365,560,-4294966218,195,0.28676075
60,2,car,4294967275,1087,380,566,-4294966188,186,0.22077179
61,2,car,4294967273,1061,378,575,-4294966212,197,0.31963575
62,2,car,13,1082,373,578,1069,205,0.5401667
63,2,car,14,1056,383,578,1042,195,0.2695259
64,2,car,4294967270,1099,386,564,-4294966171,178,0.24828371
65,2,car,4294967286,966,380,574,-4294966320,194,0.26321974
0,2,car,502,589,505,562,87,57,0.7969156
1,2,car,503,590,506,562,87,56,0.86517256
2,2,car,502,590,506,562,88,56,0.88858736
3,2,car,503,590,506,563,87,57,0.907217
4,2,car,502,590,505,561,88,56,0.86747587
5,2,car,502,589,506,562,87,56,0.87762594
6,2,car,501,589,506,562,88,56,0.8497129
7,2,car,501,589,505,562,88,57,0.8479053
8,2,car,502,590,505,562,88,57,0.8950311
9,2,car,502,590,507,562,88,55,0.9228381
10,2,car,502,589,505,561,87,56,0.90627426
11,2,car,502,590,505,562,88,57,0.8459921
12,2,car,503,590,506,562,87,56,0.8665674
13,2,car,501,589,505,561,88,56,0.88724774
14,2,car,502,590,505,561,88,56,0.84265935
15,2,car,503,590,507,562,87,55,0.910038
16,2,car,501,589,505,562,88,57,0.8158088
17,2,car,502,589,506,562,87,56,0.90897566
18,2,car,502,590,506,562,88,56,0.8953387
19,2,car,501,589,506,562,88,56,0.8826827
20,2,car,501,589,506,562,88,56,0.868128
21,2,car,502,589,507,562,87,55,0.87911797
22,2,car,502,590,506,562,88,56,0.92112195
23,2,car,502,590,506,562,88,56,0.8553335
24,2,car,502,589,506,563,87,57,0.8359229
25,2,car,502,589,506,562,87,56,0.8541347
26,2,car,501,589,506,562,88,56,0.79819185
27,2,car,501,589,506,563,88,57,0.85617733
28,2,car,501,589,507,564,88,57,0.8935997
29,2,car,501,589,507,563,88,56,0.75885755
30,2,car,502,591,509,563,89,54,0.7096379
31,2,car,514,602,494,554,88,60,0.31047094
32,2,car,517,600,504,563,83,59,0.8491415
33,2,car,502,590,508,564,88,56,0.7944646
34,2,car,502,590,509,564,88,55,0.8253944
35,2,car,491,574,495,555,83,60,0.8099735
36,2,car,498,589,509,564,91,55,0.87746143
37,2,car,516,598,504,561,82,57,0.8511085
38,2,car,514,598,507,564,84,57,0.8401219
39,2,car,504,593,510,564,89,54,0.9110706
40,2,car,497,583,508,566,86,58,0.8351104
41,2,car,502,595,509,565,93,56,0.9387687
42,2,car,504,593,510,564,89,54,0.8912073
43,2,car,502,594,510,565,92,55,0.9285165
44,2,car,502,592,510,565,90,55,0.89384234
45,2,car,515,598,504,560,83,56,0.4257941
46,2,car,514,598,507,564,84,57,0.31927696
47,2,car,501,590,510,567,89,57,0.72163993
48,2,car,501,591,509,564,90,55,0.88262093
49,2,car,502,593,510,565,91,55,0.89309627
50,2,car,506,594,506,566,88,60,0.76903325
51,2,car,507,593,509,566,86,57,0.7786368
52,2,car,507,594,508,565,87,57,0.7380539
53,2,car,495,585,509,566,90,57,0.8718345
54,2,car,502,592,508,565,90,57,0.76711863
55,2,car,501,591,508,565,90,57,0.5544183
56,2,car,502,594,508,564,92,56,0.87572163
57,2,car,4294967271,1075,377,560,-4294966196,183,0.3504756
58,2,car,4294967278,1089,361,549,-4294966189,188,0.28828707
59,2,car,4294967277,1090,365,555,-4294966187,190,0.21405561
60,2,car,4294967294,1076,365,560,-4294966218,195,0.28676075
61,2,car,4294967275,1087,380,566,-4294966188,186,0.22077179
62,2,car,4294967273,1061,378,575,-4294966212,197,0.31963575
63,2,car,13,1082,373,578,1069,205,0.5401667
64,2,car,14,1056,383,578,1042,195,0.2695259
65,2,car,4294967270,1099,386,564,-4294966171,178,0.24828371
66,2,car,4294967286,966,380,574,-4294966320,194,0.26321974
0,2,car,501,589,506,562,88,56,0.8766702
1,2,car,502,589,505,562,87,57,0.7969156
2,2,car,503,590,506,562,87,56,0.86517256
3,2,car,502,590,506,562,88,56,0.88858736
4,2,car,503,590,506,563,87,57,0.907217
5,2,car,502,590,505,561,88,56,0.86747587
6,2,car,502,589,506,562,87,56,0.87762594
7,2,car,501,589,506,562,88,56,0.8497129
8,2,car,501,589,505,562,88,57,0.8479053
9,2,car,502,590,505,562,88,57,0.8950311
10,2,car,502,590,507,562,88,55,0.9228381
11,2,car,502,589,505,561,87,56,0.90627426
12,2,car,502,590,505,562,88,57,0.8459921
13,2,car,503,590,506,562,87,56,0.8665674
14,2,car,501,589,505,561,88,56,0.88724774
15,2,car,502,590,505,561,88,56,0.84265935
16,2,car,503,590,507,562,87,55,0.910038
17,2,car,501,589,505,562,88,57,0.8158088
18,2,car,502,589,506,562,87,56,0.90897566
19,2,car,502,590,506,562,88,56,0.8953387
20,2,car,501,589,506,562,88,56,0.8826827
21,2,car,501,589,506,562,88,56,0.868128
22,2,car,502,589,507,562,87,55,0.87911797
23,2,car,502,590,506,562,88,56,0.92112195
24,2,car,502,590,506,562,88,56,0.8553335
25,2,car,502,589,506,563,87,57,0.8359229
26,2,car,502,589,506,562,87,56,0.8541347
27,2,car,501,589,506,562,88,56,0.79819185
28,2,car,501,589,506,563,88,57,0.85617733
29,2,car,501,589,507,564,88,57,0.8935997
30,2,car,501,589,507,563,88,56,0.75885755
31,2,car,502,591,509,563,89,54,0.7096379
32,2,car,514,602,494,554,88,60,0.31047094
33,2,car,517,600,504,563,83,59,0.8491415
34,2,car,502,590,508,564,88,56,0.7944646
35,2,car,502,590,509,564,88,55,0.8253944
36,2,car,491,574,495,555,83,60,0.8099735
37,2,car,498,589,509,564,91,55,0.87746143
38,2,car,516,598,504,561,82,57,0.8511085
39,2,car,514,598,507,564,84,57,0.8401219
40,2,car,504,593,510,564,89,54,0.9110706
41,2,car,497,583,508,566,86,58,0.8351104
42,2,car,502,595,509,565,93,56,0.9387687
43,2,car,504,593,510,564,89,54,0.8912073
44,2,car,502,594,510,565,92,55,0.9285165
45,2,car,502,592,510,565,90,55,0.89384234
46,2,car,515,598,504,560,83,56,0.4257941
47,2,car,514,598,507,564,84,57,0.31927696
48,2,car,501,590,510,567,89,57,0.72163993
49,2,car,501,591,509,564,90,55,0.88262093
50,2,car,502,593,510,565,91,55,0.89309627
51,2,car,506,594,506,566,88,60,0.76903325
52,2,car,507,593,509,566,86,57,0.7786368
53,2,car,507,594,508,565,87,57,0.7380539
54,2,car,495,585,509,566,90,57,0.8718345
55,2,car,502,592,508,565,90,57,0.76711863
56,2,car,501,591,508,565,90,57,0.5544183
57,2,car,502,594,508,564,92,56,0.87572163
58,2,car,4294967271,1075,377,560,-4294966196,183,0.3504756
59,2,car,4294967278,1089,361,549,-4294966189,188,0.28828707
60,2,car,4294967277,1090,365,555,-4294966187,190,0.21405561
61,2,car,4294967294,1076,365,560,-4294966218,195,0.28676075
62,2,car,4294967275,1087,380,566,-4294966188,186,0.22077179
63,2,car,4294967273,1061,378,575,-4294966212,197,0.31963575
64,2,car,13,1082,373,578,1069,205,0.5401667
65,2,car,14,1056,383,578,1042,195,0.2695259
66,2,car,4294967270,1099,386,564,-4294966171,178,0.24828371
67,2,car,4294967286,966,380,574,-4294966320,194,0.26321974
0,2,car,502,590,507,562,88,55,0.84904313
1,2,car,501,589,506,562,88,56,0.8766702
2,2,car,502,589,505,562,87,57,0.7969156
3,2,car,503,590,506,562,87,56,0.86517256
4,2,car,502,590,506,562,88,56,0.88858736
5,2,car,503,590,506,563,87,57,0.907217
6,2,car,502,590,505,561,88,56,0.86747587
7,2,car,502,589,506,562,87,56,0.87762594
8,2,car,501,589,506,562,88,56,0.8497129
9,2,car,501,589,505,562,88,57,0.8479053
10,2,car,502,590,505,562,88,57,0.8950311
11,2,car,502,590,507,562,88,55,0.9228381
12,2,car,502,589,505,561,87,56,0.90627426
13,2,car,502,590,505,562,88,57,0.8459921
14,2,car,503,590,506,562,87,56,0.8665674
15,2,car,501,589,505,561,88,56,0.88724774
16,2,car,502,590,505,561,88,56,0.84265935
17,2,car,503,590,507,562,87,55,0.910038
18,2,car,501,589,505,562,88,57,0.8158088
19,2,car,502,589,506,562,87,56,0.90897566
20,2,car,502,590,506,562,88,56,0.8953387
21,2,car,501,589,506,562,88,56,0.8826827
22,2,car,501,589,506,562,88,56,0.868128
23,2,car,502,589,507,562,87,55,0.87911797
24,2,car,502,590,506,562,88,56,0.92112195
25,2,car,502,590,506,562,88,56,0.8553335
26,2,car,502,589,506,563,87,57,0.8359229
27,2,car,502,589,506,562,87,56,0.8541347
28,2,car,501,589,506,562,88,56,0.79819185
29,2,car,501,589,506,563,88,57,0.85617733
30,2,car,501,589,507,564,88,57,0.8935997
31,2,car,501,589,507,563,88,56,0.75885755
32,2,car,502,591,509,563,89,54,0.7096379
33,2,car,514,602,494,554,88,60,0.31047094
34,2,car,517,600,504,563,83,59,0.8491415
35,2,car,502,590,508,564,88,56,0.7944646
36,2,car,502,590,509,564,88,55,0.8253944
37,2,car,491,574,495,555,83,60,0.8099735
38,2,car,498,589,509,564,91,55,0.87746143
39,2,car,516,598,504,561,82,57,0.8511085
40,2,car,514,598,507,564,84,57,0.8401219
41,2,car,504,593,510,564,89,54,0.9110706
42,2,car,497,583,508,566,86,58,0.8351104
43,2,car,502,595,509,565,93,56,0.9387687
44,2,car,504,593,510,564,89,54,0.8912073
45,2,car,502,594,510,565,92,55,0.9285165
46,2,car,502,592,510,565,90,55,0.89384234
47,2,car,515,598,504,560,83,56,0.4257941
48,2,car,514,598,507,564,84,57,0.31927696
49,2,car,501,590,510,567,89,57,0.72163993
50,2,car,501,591,509,564,90,55,0.88262093
51,2,car,502,593,510,565,91,55,0.89309627
52,2,car,506,594,506,566,88,60,0.76903325
53,2,car,507,593,509,566,86,57,0.7786368
54,2,car,507,594,508,565,87,57,0.7380539
55,2,car,495,585,509,566,90,57,0.8718345
56,2,car,502,592,508,565,90,57,0.76711863
57,2,car,501,591,508,565,90,57,0.5544183
58,2,car,502,594,508,564,92,56,0.87572163
59,2,car,4294967271,1075,377,560,-4294966196,183,0.3504756
60,2,car,4294967278,1089,361,549,-4294966189,188,0.28828707
61,2,car,4294967277,1090,365,555,-4294966187,190,0.21405561
62,2,car,4294967294,1076,365,560,-4294966218,195,0.28676075
63,2,car,4294967275,1087,380,566,-4294966188,186,0.22077179
64,2,car,4294967273,1061,378,575,-4294966212,197,0.31963575
65,2,car,13,1082,373,578,1069,205,0.5401667
66,2,car,14,1056,383,578,1042,195,0.2695259
67,2,car,4294967270,1099,386,564,-4294966171,178,0.24828371
68,2,car,4294967286,966,380,574,-4294966320,194,0.26321974
0,2,car,502,590,506,562,88,56,0.8507978
1,2,car,502,590,507,562,88,55,0.84904313
2,2,car,501,589,506,562,88,56,0.8766702
3,2,car,502,589,505,562,87,57,0.7969156
4,2,car,503,590,506,562,87,56,0.86517256
5,2,car,502,590,506,562,88,56,0.88858736
6,2,car,503,590,506,563,87,57,0.907217
7,2,car,502,590,505,561,88,56,0.86747587
8,2,car,502,589,506,562,87,56,0.87762594
9,2,car,501,589,506,562,88,56,0.8497129
10,2,car,501,589,505,562,88,57,0.8479053
11,2,car,502,590,505,562,88,57,0.8950311
12,2,car,502,590,507,562,88,55,0.9228381
13,2,car,502,589,505,561,87,56,0.90627426
14,2,car,502,590,505,562,88,57,0.8459921
15,2,car,503,590,506,562,87,56,0.8665674
16,2,car,501,589,505,561,88,56,0.88724774
17,2,car,502,590,505,561,88,56,0.84265935
18,2,car,503,590,507,562,87,55,0.910038
19,2,car,501,589,505,562,88,57,0.8158088
20,2,car,502,589,506,562,87,56,0.90897566
21,2,car,502,590,506,562,88,56,0.8953387
22,2,car,501,589,506,562,88,56,0.8826827
23,2,car,501,589,506,562,88,56,0.868128
24,2,car,502,589,507,562,87,55,0.87911797
25,2,car,502,590,506,562,88,56,0.92112195
26,2,car,502,590,506,562,88,56,0.8553335
27,2,car,502,589,506,563,87,57,0.8359229
28,2,car,502,589,506,562,87,56,0.8541347
29,2,car,501,589,506,562,88,56,0.79819185
30,2,car,501,589,506,563,88,57,0.85617733
31,2,car,501,589,507,564,88,57,0.8935997
32,2,car,501,589,507,563,88,56,0.75885755
33,2,car,502,591,509,563,89,54,0.7096379
34,2,car,514,602,494,554,88,60,0.31047094
35,2,car,517,600,504,563,83,59,0.8491415
36,2,car,502,590,508,564,88,56,0.7944646
37,2,car,502,590,509,564,88,55,0.8253944
38,2,car,491,574,495,555,83,60,0.8099735
39,2,car,498,589,509,564,91,55,0.87746143
40,2,car,516,598,504,561,82,57,0.8511085
41,2,car,514,598,507,564,84,57,0.8401219
42,2,car,504,593,510,564,89,54,0.9110706
43,2,car,497,583,508,566,86,58,0.8351104
44,2,car,502,595,509,565,93,56,0.9387687
45,2,car,504,593,510,564,89,54,0.8912073
46,2,car,502,594,510,565,92,55,0.9285165
47,2,car,502,592,510,565,90,55,0.89384234
48,2,car,515,598,504,560,83,56,0.4257941
49,2,car,514,598,507,564,84,57,0.31927696
50,2,car,501,590,510,567,89,57,0.72163993
51,2,car,501,591,509,564,90,55,0.88262093
52,2,car,502,593,510,565,91,55,0.89309627
53,2,car,506,594,506,566,88,60,0.76903325
54,2,car,507,593,509,566,86,57,0.7786368
55,2,car,507,594,508,565,87,57,0.7380539
56,2,car,495,585,509,566,90,57,0.8718345
57,2,car,502,592,508,565,90,57,0.76711863
58,2,car,501,591,508,565,90,57,0.5544183
59,2,car,502,594,508,564,92,56,0.87572163
60,2,car,4294967271,1075,377,560,-4294966196,183,0.3504756
61,2,car,4294967278,1089,361,549,-4294966189,188,0.28828707
62,2,car,4294967277,1090,365,555,-4294966187,190,0.21405561
63,2,car,4294967294,1076,365,560,-4294966218,195,0.28676075
64,2,car,4294967275,1087,380,566,-4294966188,186,0.22077179
65,2,car,4294967273,1061,378,575,-4294966212,197,0.31963575
66,2,car,13,1082,373,578,1069,205,0.5401667
67,2,car,14,1056,383,578,1042,195,0.2695259
68,2,car,4294967270,1099,386,564,-4294966171,178,0.24828371
69,2,car,4294967286,966,380,574,-4294966320,194,0.26321974
0,2,car,502,590,507,562,88,55,0.91756964
1,2,car,502,590,506,562,88,56,0.8507978
2,2,car,502,590,507,562,88,55,0.84904313
3,2,car,501,589,506,562,88,56,0.8766702
4,2,car,502,589,505,562,87,57,0.7969156
5,2,car,503,590,506,562,87,56,0.86517256
6,2,car,502,590,506,562,88,56,0.88858736
7,2,car,503,590,506,563,87,57,0.907217
8,2,car,502,590,505,561,88,56,0.86747587
9,2,car,502,589,506,562,87,56,0.87762594
10,2,car,501,589,506,562,88,56,0.8497129
11,2,car,501,589,505,562,88,57,0.8479053
12,2,car,502,590,505,562,88,57,0.8950311
13,2,car,502,590,507,562,88,55,0.9228381
14,2,car,502,589,505,561,87,56,0.90627426
15,2,car,502,590,505,562,88,57,0.8459921
16,2,car,503,590,506,562,87,56,0.8665674
17,2,car,501,589,505,561,88,56,0.88724774
18,2,car,502,590,505,561,88,56,0.84265935
19,2,car,503,590,507,562,87,55,0.910038
20,2,car,501,589,505,562,88,57,0.8158088
21,2,car,502,589,506,562,87,56,0.90897566
22,2,car,502,590,506,562,88,56,0.8953387
23,2,car,501,589,506,562,88,56,0.8826827
24,2,car,501,589,506,562,88,56,0.868128
25,2,car,502,589,507,562,87,55,0.87911797
26,2,car,502,590,506,562,88,56,0.92112195
27,2,car,502,590,506,562,88,56,0.8553335
28,2,car,502,589,506,563,87,57,0.8359229
29,2,car,502,589,506,562,87,56,0.8541347
30,2,car,501,589,506,562,88,56,0.79819185
31,2,car,501,589,506,563,88,57,0.85617733
32,2,car,501,589,507,564,88,57,0.8935997
33,2,car,501,589,507,563,88,56,0.75885755
34,2,car,502,591,509,563,89,54,0.7096379
35,2,car,514,602,494,554,88,60,0.31047094
36,2,car,517,600,504,563,83,59,0.8491415
37,2,car,502,590,508,564,88,56,0.7944646
38,2,car,502,590,509,564,88,55,0.8253944
39,2,car,491,574,495,555,83,60,0.8099735
40,2,car,498,589,509,564,91,55,0.87746143
41,2,car,516,598,504,561,82,57,0.8511085
42,2,car,514,598,507,564,84,57,0.8401219
43,2,car,504,593,510,564,89,54,0.9110706
44,2,car,497,583,508,566,86,58,0.8351104
45,2,car,502,595,509,565,93,56,0.9387687
46,2,car,504,593,510,564,89,54,0.8912073
47,2,car,502,594,510,565,92,55,0.9285165
48,2,car,502,592,510,565,90,55,0.89384234
49,2,car,515,598,504,560,83,56,0.4257941
50,2,car,514,598,507,564,84,57,0.31927696
51,2,car,501,590,510,567,89,57,0.72163993
52,2,car,501,591,509,564,90,55,0.88262093
53,2,car,502,593,510,565,91,55,0.89309627
54,2,car,506,594,506,566,88,60,0.76903325
55,2,car,507,593,509,566,86,57,0.7786368
56,2,car,507,594,508,565,87,57,0.7380539
57,2,car,495,585,509,566,90,57,0.8718345
58,2,car,502,592,508,565,90,57,0.76711863
59,2,car,501,591,508,565,90,57,0.5544183
60,2,car,502,594,508,564,92,56,0.87572163
61,2,car,4294967271,1075,377,560,-4294966196,183,0.3504756
62,2,car,4294967278,1089,361,549,-4294966189,188,0.28828707
63,2,car,4294967277,1090,365,555,-4294966187,190,0.21405561
64,2,car,4294967294,1076,365,560,-4294966218,195,0.28676075
65,2,car,4294967275,1087,380,566,-4294966188,186,0.22077179
66,2,car,4294967273,1061,378,575,-4294966212,197,0.31963575
67,2,car,13,1082,373,578,1069,205,0.5401667
68,2,car,14,1056,383,578,1042,195,0.2695259
69,2,car,4294967270,1099,386,564,-4294966171,178,0.24828371
70,2,car,4294967286,966,380,574,-4294966320,194,0.26321974
0,2,car,503,590,506,562,87,56,0.9390719
1,2,car,502,590,507,562,88,55,0.91756964
2,2,car,502,590,506,562,88,56,0.8507978
3,2,car,502,590,507,562,88,55,0.84904313
4,2,car,501,589,506,562,88,56,0.8766702
5,2,car,502,589,505,562,87,57,0.7969156
6,2,car,503,590,506,562,87,56,0.86517256
7,2,car,502,590,506,562,88,56,0.88858736
8,2,car,503,590,506,563,87,57,0.907217
9,2,car,502,590,505,561,88,56,0.86747587
10,2,car,502,589,506,562,87,56,0.87762594
11,2,car,501,589,506,562,88,56,0.8497129
12,2,car,501,589,505,562,88,57,0.8479053
13,2,car,502,590,505,562,88,57,0.8950311
14,2,car,502,590,507,562,88,55,0.9228381
15,2,car,502,589,505,561,87,56,0.90627426
16,2,car,502,590,505,562,88,57,0.8459921
17,2,car,503,590,506,562,87,56,0.8665674
18,2,car,501,589,505,561,88,56,0.88724774
19,2,car,502,590,505,561,88,56,0.84265935
20,2,car,503,590,507,562,87,55,0.910038
21,2,car,501,589,505,562,88,57,0.8158088
22,2,car,502,589,506,562,87,56,0.90897566
23,2,car,502,590,506,562,88,56,0.8953387
24,2,car,501,589,506,562,88,56,0.8826827
25,2,car,501,589,506,562,88,56,0.868128
26,2,car,502,589,507,562,87,55,0.87911797
27,2,car,502,590,506,562,88,56,0.92112195
28,2,car,502,590,506,562,88,56,0.8553335
29,2,car,502,589,506,563,87,57,0.8359229
30,2,car,502,589,506,562,87,56,0.8541347
31,2,car,501,589,506,562,88,56,0.79819185
32,2,car,501,589,506,563,88,57,0.85617733
33,2,car,501,589,507,564,88,57,0.8935997
34,2,car,501,589,507,563,88,56,0.75885755
35,2,car,502,591,509,563,89,54,0.7096379
36,2,car,514,602,494,554,88,60,0.31047094
37,2,car,517,600,504,563,83,59,0.8491415
38,2,car,502,590,508,564,88,56,0.7944646
39,2,car,502,590,509,564,88,55,0.8253944
40,2,car,491,574,495,555,83,60,0.8099735
41,2,car,498,589,509,564,91,55,0.87746143
42,2,car,516,598,504,561,82,57,0.8511085
43,2,car,514,598,507,564,84,57,0.8401219
44,2,car,504,593,510,564,89,54,0.9110706
45,2,car,497,583,508,566,86,58,0.8351104
46,2,car,502,595,509,565,93,56,0.9387687
47,2,car,504,593,510,564,89,54,0.8912073
48,2,car,502,594,510,565,92,55,0.9285165
49,2,car,502,592,510,565,90,55,0.89384234
50,2,car,515,598,504,560,83,56,0.4257941
51,2,car,514,598,507,564,84,57,0.31927696
52,2,car,501,590,510,567,89,57,0.72163993
53,2,car,501,591,509,564,90,55,0.88262093
54,2,car,502,593,510,565,91,55,0.89309627
55,2,car,506,594,506,566,88,60,0.76903325
56,2,car,507,593,509,566,86,57,0.7786368
57,2,car,507,594,508,565,87,57,0.7380539
58,2,car,495,585,509,566,90,57,0.8718345
59,2,car,502,592,508,565,90,57,0.76711863
60,2,car,501,591,508,565,90,57,0.5544183
61,2,car,502,594,508,564,92,56,0.87572163
62,2,car,4294967271,1075,377,560,-4294966196,183,0.3504756
63,2,car,4294967278,1089,361,549,-4294966189,188,0.28828707
64,2,car,4294967277,1090,365,555,-4294966187,190,0.21405561
65,2,car,4294967294,1076,365,560,-4294966218,195,0.28676075
66,2,car,4294967275,1087,380,566,-4294966188,186,0.22077179
67,2,car,4294967273,1061,378,575,-4294966212,197,0.31963575
68,2,car,13,1082,373,578,1069,205,0.5401667
69,2,car,14,1056,383,578,1042,195,0.2695259
70,2,car,4294967270,1099,386,564,-4294966171,178,0.24828371
71,2,car,4294967286,966,380,574,-4294966320,194,0.26321974
0,2,car,502,590,505,561,88,56,0.8724688
1,2,car,503,590,506,562,87,56,0.9390719
2,2,car,502,590,507,562,88,55,0.91756964
3,2,car,502,590,506,562,88,56,0.8507978
4,2,car,502,590,507,562,88,55,0.84904313
5,2,car,501,589,506,562,88,56,0.8766702
6,2,car,502,589,505,562,87,57,0.7969156
7,2,car,503,590,506,562,87,56,0.86517256
8,2,car,502,590,506,562,88,56,0.88858736
9,2,car,503,590,506,563,87,57,0.907217
10,2,car,502,590,505,561,88,56,0.86747587
11,2,car,502,589,506,562,87,56,0.87762594
12,2,car,501,589,506,562,88,56,0.8497129
13,2,car,501,589,505,562,88,57,0.8479053
14,2,car,502,590,505,562,88,57,0.8950311
15,2,car,502,590,507,562,88,55,0.9228381
16,2,car,502,589,505,561,87,56,0.90627426
17,2,car,502,590,505,562,88,57,0.8459921
18,2,car,503,590,506,562,87,56,0.8665674
19,2,car,501,589,505,561,88,56,0.88724774
20,2,car,502,590,505,561,88,56,0.84265935
21,2,car,503,590,507,562,87,55,0.910038
22,2,car,501,589,505,562,88,57,0.8158088
23,2,car,502,589,506,562,87,56,0.90897566
24,2,car,502,590,506,562,88,56,0.8953387
25,2,car,501,589,506,562,88,56,0.8826827
26,2,car,501,589,506,562,88,56,0.868128
27,2,car,502,589,507,562,87,55,0.87911797
28,2,car,502,590,506,562,88,56,0.92112195
29,2,car,502,590,506,562,88,56,0.8553335
30,2,car,502,589,506,563,87,57,0.8359229
31,2,car,502,589,506,562,87,56,0.8541347
32,2,car,501,589,506,562,88,56,0.79819185
33,2,car,501,589,506,563,88,57,0.85617733
34,2,car,501,589,507,564,88,57,0.8935997
35,2,car,501,589,507,563,88,56,0.75885755
36,2,car,502,591,509,563,89,54,0.7096379
37,2,car,514,602,494,554,88,60,0.31047094
38,2,car,517,600,504,563,83,59,0.8491415
39,2,car,502,590,508,564,88,56,0.7944646
40,2,car,502,590,509,564,88,55,0.8253944
41,2,car,491,574,495,555,83,60,0.8099735
42,2,car,498,589,509,564,91,55,0.87746143
43,2,car,516,598,504,561,82,57,0.8511085
44,2,car,514,598,507,564,84,57,0.8401219
45,2,car,504,593,510,564,89,54,0.9110706
46,2,car,497,583,508,566,86,58,0.8351104
47,2,car,502,595,509,565,93,56,0.9387687
48,2,car,504,593,510,564,89,54,0.8912073
49,2,car,502,594,510,565,92,55,0.9285165
50,2,car,502,592,510,565,90,55,0.89384234
51,2,car,515,598,504,560,83,56,0.4257941
52,2,car,514,598,507,564,84,57,0.31927696
53,2,car,501,590,510,567,89,57,0.72163993
54,2,car,501,591,509,564,90,55,0.88262093
55,2,car,502,593,510,565,91,55,0.89309627
56,2,car,506,594,506,566,88,60,0.76903325
57,2,car,507,593,509,566,86,57,0.7786368
58,2,car,507,594,508,565,87,57,0.7380539
59,2,car,495,585,509,566,90,57,0.8718345
60,2,car,502,592,508,565,90,57,0.76711863
61,2,car,501,591,508,565,90,57,0.5544183
62,2,car,502,594,508,564,92,56,0.87572163
63,2,car,4294967271,1075,377,560,-4294966196,183,0.3504756
64,2,car,4294967278,1089,361,549,-4294966189,188,0.28828707
65,2,car,4294967277,1090,365,555,-4294966187,190,0.21405561
66,2,car,4294967294,1076,365,560,-4294966218,195,0.28676075
67,2,car,4294967275,1087,380,566,-4294966188,186,0.22077179
68,2,car,4294967273,1061,378,575,-4294966212,197,0.31963575
69,2,car,13,1082,373,578,1069,205,0.5401667
70,2,car,14,1056,383,578,1042,195,0.2695259
71,2,car,4294967270,1099,386,564,-4294966171,178,0.24828371
72,2,car,4294967286,966,380,574,-4294966320,194,0.26321974
0,2,car,502,590,507,562,88,55,0.94661033
1,2,car,502,590,505,561,88,56,0.8724688
2,2,car,503,590,506,562,87,56,0.9390719
3,2,car,502,590,507,562,88,55,0.91756964
4,2,car,502,590,506,562,88,56,0.8507978
5,2,car,502,590,507,562,88,55,0.84904313
6,2,car,501,589,506,562,88,56,0.8766702
7,2,car,502,589,505,562,87,57,0.7969156
8,2,car,503,590,506,562,87,56,0.86517256
9,2,car,502,590,506,562,88,56,0.88858736
10,2,car,503,590,506,563,87,57,0.907217
11,2,car,502,590,505,561,88,56,0.86747587
12,2,car,502,589,506,562,87,56,0.87762594
13,2,car,501,589,506,562,88,56,0.8497129
14,2,car,501,589,505,562,88,57,0.8479053
15,2,car,502,590,505,562,88,57,0.8950311
16,2,car,502,590,507,562,88,55,0.9228381
17,2,car,502,589,505,561,87,56,0.90627426
18,2,car,502,590,505,562,88,57,0.8459921
19,2,car,503,590,506,562,87,56,0.8665674
20,2,car,501,589,505,561,88,56,0.88724774
21,2,car,502,590,505,561,88,56,0.84265935
22,2,car,503,590,507,562,87,55,0.910038
23,2,car,501,589,505,562,88,57,0.8158088
24,2,car,502,589,506,562,87,56,0.90897566
25,2,car,502,590,506,562,88,56,0.8953387
26,2,car,501,589,506,562,88,56,0.8826827
27,2,car,501,589,506,562,88,56,0.868128
28,2,car,502,589,507,562,87,55,0.87911797
29,2,car,502,590,506,562,88,56,0.92112195
30,2,car,502,590,506,562,88,56,0.8553335
31,2,car,502,589,506,563,87,57,0.8359229
32,2,car,502,589,506,562,87,56,0.8541347
33,2,car,501,589,506,562,88,56,0.79819185
34,2,car,501,589,506,563,88,57,0.85617733
35,2,car,501,589,507,564,88,57,0.8935997
36,2,car,501,589,507,563,88,56,0.75885755
37,2,car,502,591,509,563,89,54,0.7096379
38,2,car,514,602,494,554,88,60,0.31047094
39,2,car,517,600,504,563,83,59,0.8491415
40,2,car,502,590,508,564,88,56,0.7944646
41,2,car,502,590,509,564,88,55,0.8253944
42,2,car,491,574,495,555,83,60,0.8099735
43,2,car,498,589,509,564,91,55,0.87746143
44,2,car,516,598,504,561,82,57,0.8511085
45,2,car,514,598,507,564,84,57,0.8401219
46,2,car,504,593,510,564,89,54,0.9110706
47,2,car,497,583,508,566,86,58,0.8351104
48,2,car,502,595,509,565,93,56,0.9387687
49,2,car,504,593,510,564,89,54,0.8912073
50,2,car,502,594,510,565,92,55,0.9285165
51,2,car,502,592,510,565,90,55,0.89384234
52,2,car,515,598,504,560,83,56,0.4257941
53,2,car,514,598,507,564,84,57,0.31927696
54,2,car,501,590,510,567,89,57,0.72163993
55,2,car,501,591,509,564,90,55,0.88262093
56,2,car,502,593,510,565,91,55,0.89309627
57,2,car,506,594,506,566,88,60,0.76903325
58,2,car,507,593,509,566,86,57,0.7786368
59,2,car,507,594,508,565,87,57,0.7380539
60,2,car,495,585,509,566,90,57,0.8718345
61,2,car,502,592,508,565,90,57,0.76711863
62,2,car,501,591,508,565,90,57,0.5544183
63,2,car,502,594,508,564,92,56,0.87572163
64,2,car,4294967271,1075,377,560,-4294966196,183,0.3504756
65,2,car,4294967278,1089,361,549,-4294966189,188,0.28828707
66,2,car,4294967277,1090,365,555,-4294966187,190,0.21405561
67,2,car,4294967294,1076,365,560,-4294966218,195,0.28676075
68,2,car,4294967275,1087,380,566,-4294966188,186,0.22077179
69,2,car,4294967273,1061,378,575,-4294966212,197,0.31963575
70,2,car,13,1082,373,578,1069,205,0.5401667
71,2,car,14,1056,383,578,1042,195,0.2695259
72,2,car,4294967270,1099,386,564,-4294966171,178,0.24828371
73,2,car,4294967286,966,380,574,-4294966320,194,0.26321974
0,2,car,501,589,505,562,88,57,0.7960909
1,2,car,502,590,507,562,88,55,0.94661033
2,2,car,502,590,505,561,88,56,0.8724688
3,2,car,503,590,506,562,87,56,0.9390719
4,2,car,502,590,507,562,88,55,0.91756964
5,2,car,502,590,506,562,88,56,0.8507978
6,2,car,502,590,507,562,88,55,0.84904313
7,2,car,501,589,506,562,88,56,0.8766702
8,2,car,502,589,505,562,87,57,0.7969156
9,2,car,503,590,506,562,87,56,0.86517256
10,2,car,502,590,506,562,88,56,0.88858736
11,2,car,503,590,506,563,87,57,0.907217
12,2,car,502,590,505,561,88,56,0.86747587
13,2,car,502,589,506,562,87,56,0.87762594
14,2,car,501,589,506,562,88,56,0.8497129
15,2,car,501,589,505,562,88,57,0.8479053
16,2,car,502,590,505,562,88,57,0.8950311
17,2,car,502,590,507,562,88,55,0.9228381
18,2,car,502,589,505,561,87,56,0.90627426
19,2,car,502,590,505,562,88,57,0.8459921
20,2,car,503,590,506,562,87,56,0.8665674
21,2,car,501,589,505,561,88,56,0.88724774
22,2,car,502,590,505,561,88,56,0.84265935
23,2,car,503,590,507,562,87,55,0.910038
24,2,car,501,589,505,562,88,57,0.8158088
25,2,car,502,589,506,562,87,56,0.90897566
26,2,car,502,590,506,562,88,56,0.8953387
27,2,car,501,589,506,562,88,56,0.8826827
28,2,car,501,589,506,562,88,56,0.868128
29,2,car,502,589,507,562,87,55,0.87911797
30,2,car,502,590,506,562,88,56,0.92112195
31,2,car,502,590,506,562,88,56,0.8553335
32,2,car,502,589,506,563,87,57,0.8359229
33,2,car,502,589,506,562,87,56,0.8541347
34,2,car,501,589,506,562,88,56,0.79819185
35,2,car,501,589,506,563,88,57,0.85617733
36,2,car,501,589,507,564,88,57,0.8935997
37,2,car,501,589,507,563,88,56,0.75885755
38,2,car,502,591,509,563,89,54,0.7096379
39,2,car,514,602,494,554,88,60,0.31047094
40,2,car,517,600,504,563,83,59,0.8491415
41,2,car,502,590,508,564,88,56,0.7944646
42,2,car,502,590,509,564,88,55,0.8253944
43,2,car,491,574,495,555,83,60,0.8099735
44,2,car,498,589,509,564,91,55,0.87746143
45,2,car,516,598,504,561,82,57,0.8511085
46,2,car,514,598,507,564,84,57,0.8401219
47,2,car,504,593,510,564,89,54,0.9110706
48,2,car,497,583,508,566,86,58,0.8351104
49,2,car,502,595,509,565,93,56,0.9387687
50,2,car,504,593,510,564,89,54,0.8912073
51,2,car,502,594,510,565,92,55,0.9285165
52,2,car,502,592,510,565,90,55,0.89384234
53,2,car,515,598,504,560,83,56,0.4257941
54,2,car,514,598,507,564,84,57,0.31927696
55,2,car,501,590,510,567,89,57,0.72163993
56,2,car,501,591,509,564,90,55,0.88262093
57,2,car,502,593,510,565,91,55,0.89309627
58,2,car,506,594,506,566,88,60,0.76903325
59,2,car,507,593,509,566,86,57,0.7786368
60,2,car,507,594,508,565,87,57,0.7380539
61,2,car,495,585,509,566,90,57,0.8718345
62,2,car,502,592,508,565,90,57,0.76711863
63,2,car,501,591,508,565,90,57,0.5544183
64,2,car,502,594,508,564,92,56,0.87572163
65,2,car,4294967271,1075,377,560,-4294966196,183,0.3504756
66,2,car,4294967278,1089,361,549,-4294966189,188,0.28828707
67,2,car,4294967277,1090,365,555,-4294966187,190,0.21405561
68,2,car,4294967294,1076,365,560,-4294966218,195,0.28676075
69,2,car,4294967275,1087,380,566,-4294966188,186,0.22077179
70,2,car,4294967273,1061,378,575,-4294966212,197,0.31963575
71,2,car,13,1082,373,578,1069,205,0.5401667
72,2,car,14,1056,383,578,1042,195,0.2695259
73,2,car,4294967270,1099,386,564,-4294966171,178,0.24828371
74,2,car,4294967286,966,380,574,-4294966320,194,0.26321974
0,2,car,501,589,506,562,88,56,0.81126976
1,2,car,501,589,505,562,88,57,0.7960909
2,2,car,502,590,507,562,88,55,0.94661033
3,2,car,502,590,505,561,88,56,0.8724688
4,2,car,503,590,506,562,87,56,0.9390719
5,2,car,502,590,507,562,88,55,0.91756964
6,2,car,502,590,506,562,88,56,0.8507978
7,2,car,502,590,507,562,88,55,0.84904313
8,2,car,501,589,506,562,88,56,0.8766702
9,2,car,502,589,505,562,87,57,0.7969156
10,2,car,503,590,506,562,87,56,0.86517256
11,2,car,502,590,506,562,88,56,0.88858736
12,2,car,503,590,506,563,87,57,0.907217
13,2,car,502,590,505,561,88,56,0.86747587
14,2,car,502,589,506,562,87,56,0.87762594
15,2,car,501,589,506,562,88,56,0.8497129
16,2,car,501,589,505,562,88,57,0.8479053
17,2,car,502,590,505,562,88,57,0.8950311
18,2,car,502,590,507,562,88,55,0.9228381
19,2,car,502,589,505,561,87,56,0.90627426
20,2,car,502,590,505,562,88,57,0.8459921
21,2,car,503,590,506,562,87,56,0.8665674
22,2,car,501,589,505,561,88,56,0.88724774
23,2,car,502,590,505,561,88,56,0.84265935
24,2,car,503,590,507,562,87,55,0.910038
25,2,car,501,589,505,562,88,57,0.8158088
26,2,car,502,589,506,562,87,56,0.90897566
27,2,car,502,590,506,562,88,56,0.8953387
28,2,car,501,589,506,562,88,56,0.8826827
29,2,car,501,589,506,562,88,56,0.868128
30,2,car,502,589,507,562,87,55,0.87911797
31,2,car,502,590,506,562,88,56,0.92112195
32,2,car,502,590,506,562,88,56,0.8553335
33,2,car,502,589,506,563,87,57,0.8359229
34,2,car,502,589,506,562,87,56,0.8541347
35,2,car,501,589,506,562,88,56,0.79819185
36,2,car,501,589,506,563,88,57,0.85617733
37,2,car,501,589,507,564,88,57,0.8935997
38,2,car,501,589,507,563,88,56,0.75885755
39,2,car,502,591,509,563,89,54,0.7096379
40,2,car,514,602,494,554,88,60,0.31047094
41,2,car,517,600,504,563,83,59,0.8491415
42,2,car,502,590,508,564,88,56,0.7944646
43,2,car,502,590,509,564,88,55,0.8253944
44,2,car,491,574,495,555,83,60,0.8099735
45,2,car,498,589,509,564,91,55,0.87746143
46,2,car,516,598,504,561,82,57,0.8511085
47,2,car,514,598,507,564,84,57,0.8401219
48,2,car,504,593,510,564,89,54,0.9110706
49,2,car,497,583,508,566,86,58,0.8351104
50,2,car,502,595,509,565,93,56,0.9387687
51,2,car,504,593,510,564,89,54,0.8912073
52,2,car,502,594,510,565,92,55,0.9285165
53,2,car,502,592,510,565,90,55,0.89384234
54,2,car,515,598,504,560,83,56,0.4257941
55,2,car,514,598,507,564,84,57,0.31927696
56,2,car,501,590,510,567,89,57,0.72163993
57,2,car,501,591,509,564,90,55,0.88262093
58,2,car,502,593,510,565,91,55,0.89309627
59,2,car,506,594,506,566,88,60,0.76903325
60,2,car,507,593,509,566,86,57,0.7786368
61,2,car,507,594,508,565,87,57,0.7380539
62,2,car,495,585,509,566,90,57,0.8718345
63,2,car,502,592,508,565,90,57,0.76711863
64,2,car,501,591,508,565,90,57,0.5544183
65,2,car,502,594,508,564,92,56,0.87572163
66,2,car,4294967271,1075,377,560,-4294966196,183,0.3504756
67,2,car,4294967278,1089,361,549,-4294966189,188,0.28828707
68,2,car,4294967277,1090,365,555,-4294966187,190,0.21405561
69,2,car,4294967294,1076,365,560,-4294966218,195,0.28676075
70,2,car,4294967275,1087,380,566,-4294966188,186,0.22077179
71,2,car,4294967273,1061,378,575,-4294966212,197,0.31963575
72,2,car,13,1082,373,578,1069,205,0.5401667
73,2,car,14,1056,383,578,1042,195,0.2695259
74,2,car,4294967270,1099,386,564,-4294966171,178,0.24828371
75,2,car,4294967286,966,380,574,-4294966320,194,0.26321974
0,2,car,501,589,506,562,88,56,0.81126976
1,2,car,501,589,505,562,88,57,0.7960909
2,2,car,502,590,507,562,88,55,0.94661033
3,2,car,502,590,505,561,88,56,0.8724688
4,2,car,503,590,506,562,87,56,0.9390719
5,2,car,502,590,507,562,88,55,0.91756964
6,2,car,502,590,506,562,88,56,0.8507978
7,2,car,502,590,507,562,88,55,0.84904313
8,2,car,501,589,506,562,88,56,0.8766702
9,2,car,502,589,505,562,87,57,0.7969156
10,2,car,503,590,506,562,87,56,0.86517256
11,2,car,502,590,506,562,88,56,0.88858736
12,2,car,503,590,506,563,87,57,0.907217
13,2,car,502,590,505,561,88,56,0.86747587
14,2,car,502,589,506,562,87,56,0.87762594
15,2,car,501,589,506,562,88,56,0.8497129
16,2,car,501,589,505,562,88,57,0.8479053
17,2,car,502,590,505,562,88,57,0.8950311
18,2,car,502,590,507,562,88,55,0.9228381
19,2,car,502,589,505,561,87,56,0.90627426
20,2,car,502,590,505,562,88,57,0.8459921
21,2,car,503,590,506,562,87,56,0.8665674
22,2,car,501,589,505,561,88,56,0.88724774
23,2,car,502,590,505,561,88,56,0.84265935
24,2,car,503,590,507,562,87,55,0.910038
25,2,car,501,589,505,562,88,57,0.8158088
26,2,car,502,589,506,562,87,56,0.90897566
27,2,car,502,590,506,562,88,56,0.8953387
28,2,car,501,589,506,562,88,56,0.8826827
29,2,car,501,589,506,562,88,56,0.868128
30,2,car,502,589,507,562,87,55,0.87911797
31,2,car,502,590,506,562,88,56,0.92112195
32,2,car,502,590,506,562,88,56,0.8553335
33,2,car,502,589,506,563,87,57,0.8359229
34,2,car,502,589,506,562,87,56,0.8541347
35,2,car,501,589,506,562,88,56,0.79819185
36,2,car,501,589,506,563,88,57,0.85617733
37,2,car,501,589,507,564,88,57,0.8935997
38,2,car,501,589,507,563,88,56,0.75885755
39,2,car,502,591,509,563,89,54,0.7096379
40,2,car,514,602,494,554,88,60,0.31047094
41,2,car,517,600,504,563,83,59,0.8491415
42,2,car,502,590,508,564,88,56,0.7944646
43,2,car,502,590,509,564,88,55,0.8253944
44,2,car,491,574,495,555,83,60,0.8099735
45,2,car,498,589,509,564,91,55,0.87746143
46,2,car,516,598,504,561,82,57,0.8511085
47,2,car,514,598,507,564,84,57,0.8401219
48,2,car,504,593,510,564,89,54,0.9110706
49,2,car,497,583,508,566,86,58,0.8351104
50,2,car,502,595,509,565,93,56,0.9387687
51,2,car,504,593,510,564,89,54,0.8912073
52,2,car,502,594,510,565,92,55,0.9285165
53,2,car,502,592,510,565,90,55,0.89384234
54,2,car,515,598,504,560,83,56,0.4257941
55,2,car,514,598,507,564,84,57,0.31927696
56,2,car,501,590,510,567,89,57,0.72163993
57,2,car,501,591,509,564,90,55,0.88262093
58,2,car,502,593,510,565,91,55,0.89309627
59,2,car,506,594,506,566,88,60,0.76903325
60,2,car,507,593,509,566,86,57,0.7786368
61,2,car,507,594,508,565,87,57,0.7380539
62,2,car,495,585,509,566,90,57,0.8718345
63,2,car,502,592,508,565,90,57,0.76711863
64,2,car,501,591,508,565,90,57,0.5544183
65,2,car,502,594,508,564,92,56,0.87572163
66,2,car,4294967271,1075,377,560,-4294966196,183,0.3504756
67,2,car,4294967278,1089,361,549,-4294966189,188,0.28828707
68,2,car,4294967277,1090,365,555,-4294966187,190,0.21405561
69,2,car,4294967294,1076,365,560,-4294966218,195,0.28676075
70,2,car,4294967275,1087,380,566,-4294966188,186,0.22077179
71,2,car,4294967273,1061,378,575,-4294966212,197,0.31963575
72,2,car,13,1082,373,578,1069,205,0.5401667
73,2,car,14,1056,383,578,1042,195,0.2695259
74,2,car,4294967270,1099,386,564,-4294966171,178,0.24828371
75,2,car,4294967286,966,380,574,-4294966320,194,0.26321974
0,2,car,515,598,507,565,83,58,0.68271416
1,2,car,501,589,506,562,88,56,0.81126976
2,2,car,501,589,505,562,88,57,0.7960909
3,2,car,502,590,507,562,88,55,0.94661033
4,2,car,502,590,505,561,88,56,0.8724688
5,2,car,503,590,506,562,87,56,0.9390719
6,2,car,502,590,507,562,88,55,0.91756964
7,2,car,502,590,506,562,88,56,0.8507978
8,2,car,502,590,507,562,88,55,0.84904313
9,2,car,501,589,506,562,88,56,0.8766702
10,2,car,502,589,505,562,87,57,0.7969156
11,2,car,503,590,506,562,87,56,0.86517256
12,2,car,502,590,506,562,88,56,0.88858736
13,2,car,503,590,506,563,87,57,0.907217
14,2,car,502,590,505,561,88,56,0.86747587
15,2,car,502,589,506,562,87,56,0.87762594
16,2,car,501,589,506,562,88,56,0.8497129
17,2,car,501,589,505,562,88,57,0.8479053
18,2,car,502,590,505,562,88,57,0.8950311
19,2,car,502,590,507,562,88,55,0.9228381
20,2,car,502,589,505,561,87,56,0.90627426
21,2,car,502,590,505,562,88,57,0.8459921
22,2,car,503,590,506,562,87,56,0.8665674
23,2,car,501,589,505,561,88,56,0.88724774
24,2,car,502,590,505,561,88,56,0.84265935
25,2,car,503,590,507,562,87,55,0.910038
26,2,car,501,589,505,562,88,57,0.8158088
27,2,car,502,589,506,562,87,56,0.90897566
28,2,car,502,590,506,562,88,56,0.8953387
29,2,car,501,589,506,562,88,56,0.8826827
30,2,car,501,589,506,562,88,56,0.868128
31,2,car,502,589,507,562,87,55,0.87911797
32,2,car,502,590,506,562,88,56,0.92112195
33,2,car,502,590,506,562,88,56,0.8553335
34,2,car,502,589,506,563,87,57,0.8359229
35,2,car,502,589,506,562,87,56,0.8541347
36,2,car,501,589,506,562,88,56,0.79819185
37,2,car,501,589,506,563,88,57,0.85617733
38,2,car,501,589,507,564,88,57,0.8935997
39,2,car,501,589,507,563,88,56,0.75885755
40,2,car,502,591,509,563,89,54,0.7096379
41,2,car,514,602,494,554,88,60,0.31047094
42,2,car,517,600,504,563,83,59,0.8491415
43,2,car,502,590,508,564,88,56,0.7944646
44,2,car,502,590,509,564,88,55,0.8253944
45,2,car,491,574,495,555,83,60,0.8099735
46,2,car,498,589,509,564,91,55,0.87746143
47,2,car,516,598,504,561,82,57,0.8511085
48,2,car,514,598,507,564,84,57,0.8401219
49,2,car,504,593,510,564,89,54,0.9110706
50,2,car,497,583,508,566,86,58,0.8351104
51,2,car,502,595,509,565,93,56,0.9387687
52,2,car,504,593,510,564,89,54,0.8912073
53,2,car,502,594,510,565,92,55,0.9285165
54,2,car,502,592,510,565,90,55,0.89384234
55,2,car,515,598,504,560,83,56,0.4257941
56,2,car,514,598,507,564,84,57,0.31927696
57,2,car,501,590,510,567,89,57,0.72163993
58,2,car,501,591,509,564,90,55,0.88262093
59,2,car,502,593,510,565,91,55,0.89309627
60,2,car,506,594,506,566,88,60,0.76903325
61,2,car,507,593,509,566,86,57,0.7786368
62,2,car,507,594,508,565,87,57,0.7380539
63,2,car,495,585,509,566,90,57,0.8718345
64,2,car,502,592,508,565,90,57,0.76711863
65,2,car,501,591,508,565,90,57,0.5544183
66,2,car,502,594,508,564,92,56,0.87572163
67,2,car,4294967271,1075,377,560,-4294966196,183,0.3504756
68,2,car,4294967278,1089,361,549,-4294966189,188,0.28828707
69,2,car,4294967277,1090,365,555,-4294966187,190,0.21405561
70,2,car,4294967294,1076,365,560,-4294966218,195,0.28676075
71,2,car,4294967275,1087,380,566,-4294966188,186,0.22077179
72,2,car,4294967273,1061,378,575,-4294966212,197,0.31963575
73,2,car,13,1082,373,578,1069,205,0.5401667
74,2,car,14,1056,383,578,1042,195,0.2695259
75,2,car,4294967270,1099,386,564,-4294966171,178,0.24828371
76,2,car,4294967286,966,380,574,-4294966320,194,0.26321974
0,2,car,514,598,505,565,84,60,0.7235904
1,2,car,515,598,507,565,83,58,0.68271416
2,2,car,501,589,506,562,88,56,0.81126976
3,2,car,501,589,505,562,88,57,0.7960909
4,2,car,502,590,507,562,88,55,0.94661033
5,2,car,502,590,505,561,88,56,0.8724688
6,2,car,503,590,506,562,87,56,0.9390719
7,2,car,502,590,507,562,88,55,0.91756964
8,2,car,502,590,506,562,88,56,0.8507978
9,2,car,502,590,507,562,88,55,0.84904313
10,2,car,501,589,506,562,88,56,0.8766702
11,2,car,502,589,505,562,87,57,0.7969156
12,2,car,503,590,506,562,87,56,0.86517256
13,2,car,502,590,506,562,88,56,0.88858736
14,2,car,503,590,506,563,87,57,0.907217
15,2,car,502,590,505,561,88,56,0.86747587
16,2,car,502,589,506,562,87,56,0.87762594
17,2,car,501,589,506,562,88,56,0.8497129
18,2,car,501,589,505,562,88,57,0.8479053
19,2,car,502,590,505,562,88,57,0.8950311
20,2,car,502,590,507,562,88,55,0.9228381
21,2,car,502,589,505,561,87,56,0.90627426
22,2,car,502,590,505,562,88,57,0.8459921
23,2,car,503,590,506,562,87,56,0.8665674
24,2,car,501,589,505,561,88,56,0.88724774
25,2,car,502,590,505,561,88,56,0.84265935
26,2,car,503,590,507,562,87,55,0.910038
27,2,car,501,589,505,562,88,57,0.8158088
28,2,car,502,589,506,562,87,56,0.90897566
29,2,car,502,590,506,562,88,56,0.8953387
30,2,car,501,589,506,562,88,56,0.8826827
31,2,car,501,589,506,562,88,56,0.868128
32,2,car,502,589,507,562,87,55,0.87911797
33,2,car,502,590,506,562,88,56,0.92112195
34,2,car,502,590,506,562,88,56,0.8553335
35,2,car,502,589,506,563,87,57,0.8359229
36,2,car,502,589,506,562,87,56,0.8541347
37,2,car,501,589,506,562,88,56,0.79819185
38,2,car,501,589,506,563,88,57,0.85617733
39,2,car,501,589,507,564,88,57,0.8935997
40,2,car,501,589,507,563,88,56,0.75885755
41,2,car,502,591,509,563,89,54,0.7096379
42,2,car,514,602,494,554,88,60,0.31047094
43,2,car,517,600,504,563,83,59,0.8491415
44,2,car,502,590,508,564,88,56,0.7944646
45,2,car,502,590,509,564,88,55,0.8253944
46,2,car,491,574,495,555,83,60,0.8099735
47,2,car,498,589,509,564,91,55,0.87746143
48,2,car,516,598,504,561,82,57,0.8511085
49,2,car,514,598,507,564,84,57,0.8401219
50,2,car,504,593,510,564,89,54,0.9110706
51,2,car,497,583,508,566,86,58,0.8351104
52,2,car,502,595,509,565,93,56,0.9387687
53,2,car,504,593,510,564,89,54,0.8912073
54,2,car,502,594,510,565,92,55,0.9285165
55,2,car,502,592,510,565,90,55,0.89384234
56,2,car,515,598,504,560,83,56,0.4257941
57,2,car,514,598,507,564,84,57,0.31927696
58,2,car,501,590,510,567,89,57,0.72163993
59,2,car,501,591,509,564,90,55,0.88262093
60,2,car,502,593,510,565,91,55,0.89309627
61,2,car,506,594,506,566,88,60,0.76903325
62,2,car,507,593,509,566,86,57,0.7786368
63,2,car,507,594,508,565,87,57,0.7380539
64,2,car,495,585,509,566,90,57,0.8718345
65,2,car,502,592,508,565,90,57,0.76711863
66,2,car,501,591,508,565,90,57,0.5544183
67,2,car,502,594,508,564,92,56,0.87572163
68,2,car,4294967271,1075,377,560,-4294966196,183,0.3504756
69,2,car,4294967278,1089,361,549,-4294966189,188,0.28828707
70,2,car,4294967277,1090,365,555,-4294966187,190,0.21405561
71,2,car,4294967294,1076,365,560,-4294966218,195,0.28676075
72,2,car,4294967275,1087,380,566,-4294966188,186,0.22077179
73,2,car,4294967273,1061,378,575,-4294966212,197,0.31963575
74,2,car,13,1082,373,578,1069,205,0.5401667
75,2,car,14,1056,383,578,1042,195,0.2695259
76,2,car,4294967270,1099,386,564,-4294966171,178,0.24828371
77,2,car,4294967286,966,380,574,-4294966320,194,0.26321974
0,2,car,507,590,508,565,83,57,0.700404
1,2,car,514,598,505,565,84,60,0.7235904
2,2,car,515,598,507,565,83,58,0.68271416
3,2,car,501,589,506,562,88,56,0.81126976
4,2,car,501,589,505,562,88,57,0.7960909
5,2,car,502,590,507,562,88,55,0.94661033
6,2,car,502,590,505,561,88,56,0.8724688
7,2,car,503,590,506,562,87,56,0.9390719
8,2,car,502,590,507,562,88,55,0.91756964
9,2,car,502,590,506,562,88,56,0.8507978
10,2,car,502,590,507,562,88,55,0.84904313
11,2,car,501,589,506,562,88,56,0.8766702
12,2,car,502,589,505,562,87,57,0.7969156
13,2,car,503,590,506,562,87,56,0.86517256
14,2,car,502,590,506,562,88,56,0.88858736
15,2,car,503,590,506,563,87,57,0.907217
16,2,car,502,590,505,561,88,56,0.86747587
17,2,car,502,589,506,562,87,56,0.87762594
18,2,car,501,589,506,562,88,56,0.8497129
19,2,car,501,589,505,562,88,57,0.8479053
20,2,car,502,590,505,562,88,57,0.8950311
21,2,car,502,590,507,562,88,55,0.9228381
22,2,car,502,589,505,561,87,56,0.90627426
23,2,car,502,590,505,562,88,57,0.8459921
24,2,car,503,590,506,562,87,56,0.8665674
25,2,car,501,589,505,561,88,56,0.88724774
26,2,car,502,590,505,561,88,56,0.84265935
27,2,car,503,590,507,562,87,55,0.910038
28,2,car,501,589,505,562,88,57,0.8158088
29,2,car,502,589,506,562,87,56,0.90897566
30,2,car,502,590,506,562,88,56,0.8953387
31,2,car,501,589,506,562,88,56,0.8826827
32,2,car,501,589,506,562,88,56,0.868128
33,2,car,502,589,507,562,87,55,0.87911797
34,2,car,502,590,506,562,88,56,0.92112195
35,2,car,502,590,506,562,88,56,0.8553335
36,2,car,502,589,506,563,87,57,0.8359229
37,2,car,502,589,506,562,87,56,0.8541347
38,2,car,501,589,506,562,88,56,0.79819185
39,2,car,501,589,506,563,88,57,0.85617733
40,2,car,501,589,507,564,88,57,0.8935997
41,2,car,501,589,507,563,88,56,0.75885755
42,2,car,502,591,509,563,89,54,0.7096379
43,2,car,514,602,494,554,88,60,0.31047094
44,2,car,517,600,504,563,83,59,0.8491415
45,2,car,502,590,508,564,88,56,0.7944646
46,2,car,502,590,509,564,88,55,0.8253944
47,2,car,491,574,495,555,83,60,0.8099735
48,2,car,498,589,509,564,91,55,0.87746143
49,2,car,516,598,504,561,82,57,0.8511085
50,2,car,514,598,507,564,84,57,0.8401219
51,2,car,504,593,510,564,89,54,0.9110706
52,2,car,497,583,508,566,86,58,0.8351104
53,2,car,502,595,509,565,93,56,0.9387687
54,2,car,504,593,510,564,89,54,0.8912073
55,2,car,502,594,510,565,92,55,0.9285165
56,2,car,502,592,510,565,90,55,0.89384234
57,2,car,515,598,504,560,83,56,0.4257941
58,2,car,514,598,507,564,84,57,0.31927696
59,2,car,501,590,510,567,89,57,0.72163993
60,2,car,501,591,509,564,90,55,0.88262093
61,2,car,502,593,510,565,91,55,0.89309627
62,2,car,506,594,506,566,88,60,0.76903325
63,2,car,507,593,509,566,86,57,0.7786368
64,2,car,507,594,508,565,87,57,0.7380539
65,2,car,495,585,509,566,90,57,0.8718345
66,2,car,502,592,508,565,90,57,0.76711863
67,2,car,501,591,508,565,90,57,0.5544183
68,2,car,502,594,508,564,92,56,0.87572163
69,2,car,4294967271,1075,377,560,-4294966196,183,0.3504756
70,2,car,4294967278,1089,361,549,-4294966189,188,0.28828707
71,2,car,4294967277,1090,365,555,-4294966187,190,0.21405561
72,2,car,4294967294,1076,365,560,-4294966218,195,0.28676075
73,2,car,4294967275,1087,380,566,-4294966188,186,0.22077179
74,2,car,4294967273,1061,378,575,-4294966212,197,0.31963575
75,2,car,13,1082,373,578,1069,205,0.5401667
76,2,car,14,1056,383,578,1042,195,0.2695259
77,2,car,4294967270,1099,386,564,-4294966171,178,0.24828371
78,2,car,4294967286,966,380,574,-4294966320,194,0.26321974
0,2,car,507,590,509,563,83,54,0.78095347
1,2,car,507,590,508,565,83,57,0.700404
2,2,car,514,598,505,565,84,60,0.7235904
3,2,car,515,598,507,565,83,58,0.68271416
4,2,car,501,589,506,562,88,56,0.81126976
5,2,car,501,589,505,562,88,57,0.7960909
6,2,car,502,590,507,562,88,55,0.94661033
7,2,car,502,590,505,561,88,56,0.8724688
8,2,car,503,590,506,562,87,56,0.9390719
9,2,car,502,590,507,562,88,55,0.91756964
10,2,car,502,590,506,562,88,56,0.8507978
11,2,car,502,590,507,562,88,55,0.84904313
12,2,car,501,589,506,562,88,56,0.8766702
13,2,car,502,589,505,562,87,57,0.7969156
14,2,car,503,590,506,562,87,56,0.86517256
15,2,car,502,590,506,562,88,56,0.88858736
16,2,car,503,590,506,563,87,57,0.907217
17,2,car,502,590,505,561,88,56,0.86747587
18,2,car,502,589,506,562,87,56,0.87762594
19,2,car,501,589,506,562,88,56,0.8497129
20,2,car,501,589,505,562,88,57,0.8479053
21,2,car,502,590,505,562,88,57,0.8950311
22,2,car,502,590,507,562,88,55,0.9228381
23,2,car,502,589,505,561,87,56,0.90627426
24,2,car,502,590,505,562,88,57,0.8459921
25,2,car,503,590,506,562,87,56,0.8665674
26,2,car,501,589,505,561,88,56,0.88724774
27,2,car,502,590,505,561,88,56,0.84265935
28,2,car,503,590,507,562,87,55,0.910038
29,2,car,501,589,505,562,88,57,0.8158088
30,2,car,502,589,506,562,87,56,0.90897566
31,2,car,502,590,506,562,88,56,0.8953387
32,2,car,501,589,506,562,88,56,0.8826827
33,2,car,501,589,506,562,88,56,0.868128
34,2,car,502,589,507,562,87,55,0.87911797
35,2,car,502,590,506,562,88,56,0.92112195
36,2,car,502,590,506,562,88,56,0.8553335
37,2,car,502,589,506,563,87,57,0.8359229
38,2,car,502,589,506,562,87,56,0.8541347
39,2,car,501,589,506,562,88,56,0.79819185
40,2,car,501,589,506,563,88,57,0.85617733
41,2,car,501,589,507,564,88,57,0.8935997
42,2,car,501,589,507,563,88,56,0.75885755
43,2,car,502,591,509,563,89,54,0.7096379
44,2,car,514,602,494,554,88,60,0.31047094
45,2,car,517,600,504,563,83,59,0.8491415
46,2,car,502,590,508,564,88,56,0.7944646
47,2,car,502,590,509,564,88,55,0.8253944
48,2,car,491,574,495,555,83,60,0.8099735
49,2,car,498,589,509,564,91,55,0.87746143
50,2,car,516,598,504,561,82,57,0.8511085
51,2,car,514,598,507,564,84,57,0.8401219
52,2,car,504,593,510,564,89,54,0.9110706
53,2,car,497,583,508,566,86,58,0.8351104
54,2,car,502,595,509,565,93,56,0.9387687
55,2,car,504,593,510,564,89,54,0.8912073
56,2,car,502,594,510,565,92,55,0.9285165
57,2,car,502,592,510,565,90,55,0.89384234
58,2,car,515,598,504,560,83,56,0.4257941
59,2,car,514,598,507,564,84,57,0.31927696
60,2,car,501,590,510,567,89,57,0.72163993
61,2,car,501,591,509,564,90,55,0.88262093
62,2,car,502,593,510,565,91,55,0.89309627
63,2,car,506,594,506,566,88,60,0.76903325
64,2,car,507,593,509,566,86,57,0.7786368
65,2,car,507,594,508,565,87,57,0.7380539
66,2,car,495,585,509,566,90,57,0.8718345
67,2,car,502,592,508,565,90,57,0.76711863
68,2,car,501,591,508,565,90,57,0.5544183
69,2,car,502,594,508,564,92,56,0.87572163
70,2,car,4294967271,1075,377,560,-4294966196,183,0.3504756
71,2,car,4294967278,1089,361,549,-4294966189,188,0.28828707
72,2,car,4294967277,1090,365,555,-4294966187,190,0.21405561
73,2,car,4294967294,1076,365,560,-4294966218,195,0.28676075
74,2,car,4294967275,1087,380,566,-4294966188,186,0.22077179
75,2,car,4294967273,1061,378,575,-4294966212,197,0.31963575
76,2,car,13,1082,373,578,1069,205,0.5401667
77,2,car,14,1056,383,578,1042,195,0.2695259
78,2,car,4294967270,1099,386,564,-4294966171,178,0.24828371
79,2,car,4294967286,966,380,574,-4294966320,194,0.26321974
0,2,car,506,590,508,564,84,56,0.8422107
1,2,car,507,590,509,563,83,54,0.78095347
2,2,car,507,590,508,565,83,57,0.700404
3,2,car,514,598,505,565,84,60,0.7235904
4,2,car,515,598,507,565,83,58,0.68271416
5,2,car,501,589,506,562,88,56,0.81126976
6,2,car,501,589,505,562,88,57,0.7960909
7,2,car,502,590,507,562,88,55,0.94661033
8,2,car,502,590,505,561,88,56,0.8724688
9,2,car,503,590,506,562,87,56,0.9390719
10,2,car,502,590,507,562,88,55,0.91756964
11,2,car,502,590,506,562,88,56,0.8507978
12,2,car,502,590,507,562,88,55,0.84904313
13,2,car,501,589,506,562,88,56,0.8766702
14,2,car,502,589,505,562,87,57,0.7969156
15,2,car,503,590,506,562,87,56,0.86517256
16,2,car,502,590,506,562,88,56,0.88858736
17,2,car,503,590,506,563,87,57,0.907217
18,2,car,502,590,505,561,88,56,0.86747587
19,2,car,502,589,506,562,87,56,0.87762594
20,2,car,501,589,506,562,88,56,0.8497129
21,2,car,501,589,505,562,88,57,0.8479053
22,2,car,502,590,505,562,88,57,0.8950311
23,2,car,502,590,507,562,88,55,0.9228381
24,2,car,502,589,505,561,87,56,0.90627426
25,2,car,502,590,505,562,88,57,0.8459921
26,2,car,503,590,506,562,87,56,0.8665674
27,2,car,501,589,505,561,88,56,0.88724774
28,2,car,502,590,505,561,88,56,0.84265935
29,2,car,503,590,507,562,87,55,0.910038
30,2,car,501,589,505,562,88,57,0.8158088
31,2,car,502,589,506,562,87,56,0.90897566
32,2,car,502,590,506,562,88,56,0.8953387
33,2,car,501,589,506,562,88,56,0.8826827
34,2,car,501,589,506,562,88,56,0.868128
35,2,car,502,589,507,562,87,55,0.87911797
36,2,car,502,590,506,562,88,56,0.92112195
37,2,car,502,590,506,562,88,56,0.8553335
38,2,car,502,589,506,563,87,57,0.8359229
39,2,car,502,589,506,562,87,56,0.8541347
40,2,car,501,589,506,562,88,56,0.79819185
41,2,car,501,589,506,563,88,57,0.85617733
42,2,car,501,589,507,564,88,57,0.8935997
43,2,car,501,589,507,563,88,56,0.75885755
44,2,car,502,591,509,563,89,54,0.7096379
45,2,car,514,602,494,554,88,60,0.31047094
46,2,car,517,600,504,563,83,59,0.8491415
47,2,car,502,590,508,564,88,56,0.7944646
48,2,car,502,590,509,564,88,55,0.8253944
49,2,car,491,574,495,555,83,60,0.8099735
50,2,car,498,589,509,564,91,55,0.87746143
51,2,car,516,598,504,561,82,57,0.8511085
52,2,car,514,598,507,564,84,57,0.8401219
53,2,car,504,593,510,564,89,54,0.9110706
54,2,car,497,583,508,566,86,58,0.8351104
55,2,car,502,595,509,565,93,56,0.9387687
56,2,car,504,593,510,564,89,54,0.8912073
57,2,car,502,594,510,565,92,55,0.9285165
58,2,car,502,592,510,565,90,55,0.89384234
59,2,car,515,598,504,560,83,56,0.4257941
60,2,car,514,598,507,564,84,57,0.31927696
61,2,car,501,590,510,567,89,57,0.72163993
62,2,car,501,591,509,564,90,55,0.88262093
63,2,car,502,593,510,565,91,55,0.89309627
64,2,car,506,594,506,566,88,60,0.76903325
65,2,car,507,593,509,566,86,57,0.7786368
66,2,car,507,594,508,565,87,57,0.7380539
67,2,car,495,585,509,566,90,57,0.8718345
68,2,car,502,592,508,565,90,57,0.76711863
69,2,car,501,591,508,565,90,57,0.5544183
70,2,car,502,594,508,564,92,56,0.87572163
71,2,car,4294967271,1075,377,560,-4294966196,183,0.3504756
72,2,car,4294967278,1089,361,549,-4294966189,188,0.28828707
73,2,car,4294967277,1090,365,555,-4294966187,190,0.21405561
74,2,car,4294967294,1076,365,560,-4294966218,195,0.28676075
75,2,car,4294967275,1087,380,566,-4294966188,186,0.22077179
76,2,car,4294967273,1061,378,575,-4294966212,197,0.31963575
77,2,car,13,1082,373,578,1069,205,0.5401667
78,2,car,14,1056,383,578,1042,195,0.2695259
79,2,car,4294967270,1099,386,564,-4294966171,178,0.24828371
80,2,car,4294967286,966,380,574,-4294966320,194,0.26321974
0,2,car,505,591,508,564,86,56,0.8463685
1,2,car,506,590,508,564,84,56,0.8422107
2,2,car,507,590,509,563,83,54,0.78095347
3,2,car,507,590,508,565,83,57,0.700404
4,2,car,514,598,505,565,84,60,0.7235904
5,2,car,515,598,507,565,83,58,0.68271416
6,2,car,501,589,506,562,88,56,0.81126976
7,2,car,501,589,505,562,88,57,0.7960909
8,2,car,502,590,507,562,88,55,0.94661033
9,2,car,502,590,505,561,88,56,0.8724688
10,2,car,503,590,506,562,87,56,0.9390719
11,2,car,502,590,507,562,88,55,0.91756964
12,2,car,502,590,506,562,88,56,0.8507978
13,2,car,502,590,507,562,88,55,0.84904313
14,2,car,501,589,506,562,88,56,0.8766702
15,2,car,502,589,505,562,87,57,0.7969156
16,2,car,503,590,506,562,87,56,0.86517256
17,2,car,502,590,506,562,88,56,0.88858736
18,2,car,503,590,506,563,87,57,0.907217
19,2,car,502,590,505,561,88,56,0.86747587
20,2,car,502,589,506,562,87,56,0.87762594
21,2,car,501,589,506,562,88,56,0.8497129
22,2,car,501,589,505,562,88,57,0.8479053
23,2,car,502,590,505,562,88,57,0.8950311
24,2,car,502,590,507,562,88,55,0.9228381
25,2,car,502,589,505,561,87,56,0.90627426
26,2,car,502,590,505,562,88,57,0.8459921
27,2,car,503,590,506,562,87,56,0.8665674
28,2,car,501,589,505,561,88,56,0.88724774
29,2,car,502,590,505,561,88,56,0.84265935
30,2,car,503,590,507,562,87,55,0.910038
31,2,car,501,589,505,562,88,57,0.8158088
32,2,car,502,589,506,562,87,56,0.90897566
33,2,car,502,590,506,562,88,56,0.8953387
34,2,car,501,589,506,562,88,56,0.8826827
35,2,car,501,589,506,562,88,56,0.868128
36,2,car,502,589,507,562,87,55,0.87911797
37,2,car,502,590,506,562,88,56,0.92112195
38,2,car,502,590,506,562,88,56,0.8553335
39,2,car,502,589,506,563,87,57,0.8359229
40,2,car,502,589,506,562,87,56,0.8541347
41,2,car,501,589,506,562,88,56,0.79819185
42,2,car,501,589,506,563,88,57,0.85617733
43,2,car,501,589,507,564,88,57,0.8935997
44,2,car,501,589,507,563,88,56,0.75885755
45,2,car,502,591,509,563,89,54,0.7096379
46,2,car,514,602,494,554,88,60,0.31047094
47,2,car,517,600,504,563,83,59,0.8491415
48,2,car,502,590,508,564,88,56,0.7944646
49,2,car,502,590,509,564,88,55,0.8253944
50,2,car,491,574,495,555,83,60,0.8099735
51,2,car,498,589,509,564,91,55,0.87746143
52,2,car,516,598,504,561,82,57,0.8511085
53,2,car,514,598,507,564,84,57,0.8401219
54,2,car,504,593,510,564,89,54,0.9110706
55,2,car,497,583,508,566,86,58,0.8351104
56,2,car,502,595,509,565,93,56,0.9387687
57,2,car,504,593,510,564,89,54,0.8912073
58,2,car,502,594,510,565,92,55,0.9285165
59,2,car,502,592,510,565,90,55,0.89384234
60,2,car,515,598,504,560,83,56,0.4257941
61,2,car,514,598,507,564,84,57,0.31927696
62,2,car,501,590,510,567,89,57,0.72163993
63,2,car,501,591,509,564,90,55,0.88262093
64,2,car,502,593,510,565,91,55,0.89309627
65,2,car,506,594,506,566,88,60,0.76903325
66,2,car,507,593,509,566,86,57,0.7786368
67,2,car,507,594,508,565,87,57,0.7380539
68,2,car,495,585,509,566,90,57,0.8718345
69,2,car,502,592,508,565,90,57,0.76711863
70,2,car,501,591,508,565,90,57,0.5544183
71,2,car,502,594,508,564,92,56,0.87572163
72,2,car,4294967271,1075,377,560,-4294966196,183,0.3504756
73,2,car,4294967278,1089,361,549,-4294966189,188,0.28828707
74,2,car,4294967277,1090,365,555,-4294966187,190,0.21405561
75,2,car,4294967294,1076,365,560,-4294966218,195,0.28676075
76,2,car,4294967275,1087,380,566,-4294966188,186,0.22077179
77,2,car,4294967273,1061,378,575,-4294966212,197,0.31963575
78,2,car,13,1082,373,578,1069,205,0.5401667
79,2,car,14,1056,383,578,1042,195,0.2695259
80,2,car,4294967270,1099,386,564,-4294966171,178,0.24828371
81,2,car,4294967286,966,380,574,-4294966320,194,0.26321974
0,2,car,506,591,509,564,85,55,0.8705986
1,2,car,505,591,508,564,86,56,0.8463685
2,2,car,506,590,508,564,84,56,0.8422107
3,2,car,507,590,509,563,83,54,0.78095347
4,2,car,507,590,508,565,83,57,0.700404
5,2,car,514,598,505,565,84,60,0.7235904
6,2,car,515,598,507,565,83,58,0.68271416
7,2,car,501,589,506,562,88,56,0.81126976
8,2,car,501,589,505,562,88,57,0.7960909
9,2,car,502,590,507,562,88,55,0.94661033
10,2,car,502,590,505,561,88,56,0.8724688
11,2,car,503,590,506,562,87,56,0.9390719
12,2,car,502,590,507,562,88,55,0.91756964
13,2,car,502,590,506,562,88,56,0.8507978
14,2,car,502,590,507,562,88,55,0.84904313
15,2,car,501,589,506,562,88,56,0.8766702
16,2,car,502,589,505,562,87,57,0.7969156
17,2,car,503,590,506,562,87,56,0.86517256
18,2,car,502,590,506,562,88,56,0.88858736
19,2,car,503,590,506,563,87,57,0.907217
20,2,car,502,590,505,561,88,56,0.86747587
21,2,car,502,589,506,562,87,56,0.87762594
22,2,car,501,589,506,562,88,56,0.8497129
23,2,car,501,589,505,562,88,57,0.8479053
24,2,car,502,590,505,562,88,57,0.8950311
25,2,car,502,590,507,562,88,55,0.9228381
26,2,car,502,589,505,561,87,56,0.90627426
27,2,car,502,590,505,562,88,57,0.8459921
28,2,car,503,590,506,562,87,56,0.8665674
29,2,car,501,589,505,561,88,56,0.88724774
30,2,car,502,590,505,561,88,56,0.84265935
31,2,car,503,590,507,562,87,55,0.910038
32,2,car,501,589,505,562,88,57,0.8158088
33,2,car,502,589,506,562,87,56,0.90897566
34,2,car,502,590,506,562,88,56,0.8953387
35,2,car,501,589,506,562,88,56,0.8826827
36,2,car,501,589,506,562,88,56,0.868128
37,2,car,502,589,507,562,87,55,0.87911797
38,2,car,502,590,506,562,88,56,0.92112195
39,2,car,502,590,506,562,88,56,0.8553335
40,2,car,502,589,506,563,87,57,0.8359229
41,2,car,502,589,506,562,87,56,0.8541347
42,2,car,501,589,506,562,88,56,0.79819185
43,2,car,501,589,506,563,88,57,0.85617733
44,2,car,501,589,507,564,88,57,0.8935997
45,2,car,501,589,507,563,88,56,0.75885755
46,2,car,502,591,509,563,89,54,0.7096379
47,2,car,514,602,494,554,88,60,0.31047094
48,2,car,517,600,504,563,83,59,0.8491415
49,2,car,502,590,508,564,88,56,0.7944646
50,2,car,502,590,509,564,88,55,0.8253944
51,2,car,491,574,495,555,83,60,0.8099735
52,2,car,498,589,509,564,91,55,0.87746143
53,2,car,516,598,504,561,82,57,0.8511085
54,2,car,514,598,507,564,84,57,0.8401219
55,2,car,504,593,510,564,89,54,0.9110706
56,2,car,497,583,508,566,86,58,0.8351104
57,2,car,502,595,509,565,93,56,0.9387687
58,2,car,504,593,510,564,89,54,0.8912073
59,2,car,502,594,510,565,92,55,0.9285165
60,2,car,502,592,510,565,90,55,0.89384234
61,2,car,515,598,504,560,83,56,0.4257941
62,2,car,514,598,507,564,84,57,0.31927696
63,2,car,501,590,510,567,89,57,0.72163993
64,2,car,501,591,509,564,90,55,0.88262093
65,2,car,502,593,510,565,91,55,0.89309627
66,2,car,506,594,506,566,88,60,0.76903325
67,2,car,507,593,509,566,86,57,0.7786368
68,2,car,507,594,508,565,87,57,0.7380539
69,2,car,495,585,509,566,90,57,0.8718345
70,2,car,502,592,508,565,90,57,0.76711863
71,2,car,501,591,508,565,90,57,0.5544183
72,2,car,502,594,508,564,92,56,0.87572163
73,2,car,4294967271,1075,377,560,-4294966196,183,0.3504756
74,2,car,4294967278,1089,361,549,-4294966189,188,0.28828707
75,2,car,4294967277,1090,365,555,-4294966187,190,0.21405561
76,2,car,4294967294,1076,365,560,-4294966218,195,0.28676075
77,2,car,4294967275,1087,380,566,-4294966188,186,0.22077179
78,2,car,4294967273,1061,378,575,-4294966212,197,0.31963575
79,2,car,13,1082,373,578,1069,205,0.5401667
80,2,car,14,1056,383,578,1042,195,0.2695259
81,2,car,4294967270,1099,386,564,-4294966171,178,0.24828371
82,2,car,4294967286,966,380,574,-4294966320,194,0.26321974
0,2,car,506,590,510,565,84,55,0.9022778
1,2,car,506,591,509,564,85,55,0.8705986
2,2,car,505,591,508,564,86,56,0.8463685
3,2,car,506,590,508,564,84,56,0.8422107
4,2,car,507,590,509,563,83,54,0.78095347
5,2,car,507,590,508,565,83,57,0.700404
6,2,car,514,598,505,565,84,60,0.7235904
7,2,car,515,598,507,565,83,58,0.68271416
8,2,car,501,589,506,562,88,56,0.81126976
9,2,car,501,589,505,562,88,57,0.7960909
10,2,car,502,590,507,562,88,55,0.94661033
11,2,car,502,590,505,561,88,56,0.8724688
12,2,car,503,590,506,562,87,56,0.9390719
13,2,car,502,590,507,562,88,55,0.91756964
14,2,car,502,590,506,562,88,56,0.8507978
15,2,car,502,590,507,562,88,55,0.84904313
16,2,car,501,589,506,562,88,56,0.8766702
17,2,car,502,589,505,562,87,57,0.7969156
18,2,car,503,590,506,562,87,56,0.86517256
19,2,car,502,590,506,562,88,56,0.88858736
20,2,car,503,590,506,563,87,57,0.907217
21,2,car,502,590,505,561,88,56,0.86747587
22,2,car,502,589,506,562,87,56,0.87762594
23,2,car,501,589,506,562,88,56,0.8497129
24,2,car,501,589,505,562,88,57,0.8479053
25,2,car,502,590,505,562,88,57,0.8950311
26,2,car,502,590,507,562,88,55,0.9228381
27,2,car,502,589,505,561,87,56,0.90627426
28,2,car,502,590,505,562,88,57,0.8459921
29,2,car,503,590,506,562,87,56,0.8665674
30,2,car,501,589,505,561,88,56,0.88724774
31,2,car,502,590,505,561,88,56,0.84265935
32,2,car,503,590,507,562,87,55,0.910038
33,2,car,501,589,505,562,88,57,0.8158088
34,2,car,502,589,506,562,87,56,0.90897566
35,2,car,502,590,506,562,88,56,0.8953387
36,2,car,501,589,506,562,88,56,0.8826827
37,2,car,501,589,506,562,88,56,0.868128
38,2,car,502,589,507,562,87,55,0.87911797
39,2,car,502,590,506,562,88,56,0.92112195
40,2,car,502,590,506,562,88,56,0.8553335
41,2,car,502,589,506,563,87,57,0.8359229
42,2,car,502,589,506,562,87,56,0.8541347
43,2,car,501,589,506,562,88,56,0.79819185
44,2,car,501,589,506,563,88,57,0.85617733
45,2,car,501,589,507,564,88,57,0.8935997
46,2,car,501,589,507,563,88,56,0.75885755
47,2,car,502,591,509,563,89,54,0.7096379
48,2,car,514,602,494,554,88,60,0.31047094
49,2,car,517,600,504,563,83,59,0.8491415
50,2,car,502,590,508,564,88,56,0.7944646
51,2,car,502,590,509,564,88,55,0.8253944
52,2,car,491,574,495,555,83,60,0.8099735
53,2,car,498,589,509,564,91,55,0.87746143
54,2,car,516,598,504,561,82,57,0.8511085
55,2,car,514,598,507,564,84,57,0.8401219
56,2,car,504,593,510,564,89,54,0.9110706
57,2,car,497,583,508,566,86,58,0.8351104
58,2,car,502,595,509,565,93,56,0.9387687
59,2,car,504,593,510,564,89,54,0.8912073
60,2,car,502,594,510,565,92,55,0.9285165
61,2,car,502,592,510,565,90,55,0.89384234
62,2,car,515,598,504,560,83,56,0.4257941
63,2,car,514,598,507,564,84,57,0.31927696
64,2,car,501,590,510,567,89,57,0.72163993
65,2,car,501,591,509,564,90,55,0.88262093
66,2,car,502,593,510,565,91,55,0.89309627
67,2,car,506,594,506,566,88,60,0.76903325
68,2,car,507,593,509,566,86,57,0.7786368
69,2,car,507,594,508,565,87,57,0.7380539
70,2,car,495,585,509,566,90,57,0.8718345
71,2,car,502,592,508,565,90,57,0.76711863
72,2,car,501,591,508,565,90,57,0.5544183
73,2,car,502,594,508,564,92,56,0.87572163
74,2,car,4294967271,1075,377,560,-4294966196,183,0.3504756
75,2,car,4294967278,1089,361,549,-4294966189,188,0.28828707
76,2,car,4294967277,1090,365,555,-4294966187,190,0.21405561
77,2,car,4294967294,1076,365,560,-4294966218,195,0.28676075
78,2,car,4294967275,1087,380,566,-4294966188,186,0.22077179
79,2,car,4294967273,1061,378,575,-4294966212,197,0.31963575
80,2,car,13,1082,373,578,1069,205,0.5401667
81,2,car,14,1056,383,578,1042,195,0.2695259
82,2,car,4294967270,1099,386,564,-4294966171,178,0.24828371
83,2,car,4294967286,966,380,574,-4294966320,194,0.26321974
0,2,car,506,590,510,564,84,54,0.83923197
1,2,car,506,590,510,565,84,55,0.9022778
2,2,car,506,591,509,564,85,55,0.8705986
3,2,car,505,591,508,564,86,56,0.8463685
4,2,car,506,590,508,564,84,56,0.8422107
5,2,car,507,590,509,563,83,54,0.78095347
6,2,car,507,590,508,565,83,57,0.700404
7,2,car,514,598,505,565,84,60,0.7235904
8,2,car,515,598,507,565,83,58,0.68271416
9,2,car,501,589,506,562,88,56,0.81126976
10,2,car,501,589,505,562,88,57,0.7960909
11,2,car,502,590,507,562,88,55,0.94661033
12,2,car,502,590,505,561,88,56,0.8724688
13,2,car,503,590,506,562,87,56,0.9390719
14,2,car,502,590,507,562,88,55,0.91756964
15,2,car,502,590,506,562,88,56,0.8507978
16,2,car,502,590,507,562,88,55,0.84904313
17,2,car,501,589,506,562,88,56,0.8766702
18,2,car,502,589,505,562,87,57,0.7969156
19,2,car,503,590,506,562,87,56,0.86517256
20,2,car,502,590,506,562,88,56,0.88858736
21,2,car,503,590,506,563,87,57,0.907217
22,2,car,502,590,505,561,88,56,0.86747587
23,2,car,502,589,506,562,87,56,0.87762594
24,2,car,501,589,506,562,88,56,0.8497129
25,2,car,501,589,505,562,88,57,0.8479053
26,2,car,502,590,505,562,88,57,0.8950311
27,2,car,502,590,507,562,88,55,0.9228381
28,2,car,502,589,505,561,87,56,0.90627426
29,2,car,502,590,505,562,88,57,0.8459921
30,2,car,503,590,506,562,87,56,0.8665674
31,2,car,501,589,505,561,88,56,0.88724774
32,2,car,502,590,505,561,88,56,0.84265935
33,2,car,503,590,507,562,87,55,0.910038
34,2,car,501,589,505,562,88,57,0.8158088
35,2,car,502,589,506,562,87,56,0.90897566
36,2,car,502,590,506,562,88,56,0.8953387
37,2,car,501,589,506,562,88,56,0.8826827
38,2,car,501,589,506,562,88,56,0.868128
39,2,car,502,589,507,562,87,55,0.87911797
40,2,car,502,590,506,562,88,56,0.92112195
41,2,car,502,590,506,562,88,56,0.8553335
42,2,car,502,589,506,563,87,57,0.8359229
43,2,car,502,589,506,562,87,56,0.8541347
44,2,car,501,589,506,562,88,56,0.79819185
45,2,car,501,589,506,563,88,57,0.85617733
46,2,car,501,589,507,564,88,57,0.8935997
47,2,car,501,589,507,563,88,56,0.75885755
48,2,car,502,591,509,563,89,54,0.7096379
49,2,car,514,602,494,554,88,60,0.31047094
50,2,car,517,600,504,563,83,59,0.8491415
51,2,car,502,590,508,564,88,56,0.7944646
52,2,car,502,590,509,564,88,55,0.8253944
53,2,car,491,574,495,555,83,60,0.8099735
54,2,car,498,589,509,564,91,55,0.87746143
55,2,car,516,598,504,561,82,57,0.8511085
56,2,car,514,598,507,564,84,57,0.8401219
57,2,car,504,593,510,564,89,54,0.9110706
58,2,car,497,583,508,566,86,58,0.8351104
59,2,car,502,595,509,565,93,56,0.9387687
60,2,car,504,593,510,564,89,54,0.8912073
61,2,car,502,594,510,565,92,55,0.9285165
62,2,car,502,592,510,565,90,55,0.89384234
63,2,car,515,598,504,560,83,56,0.4257941
64,2,car,514,598,507,564,84,57,0.31927696
65,2,car,501,590,510,567,89,57,0.72163993
66,2,car,501,591,509,564,90,55,0.88262093
67,2,car,502,593,510,565,91,55,0.89309627
68,2,car,506,594,506,566,88,60,0.76903325
69,2,car,507,593,509,566,86,57,0.7786368
70,2,car,507,594,508,565,87,57,0.7380539
71,2,car,495,585,509,566,90,57,0.8718345
72,2,car,502,592,508,565,90,57,0.76711863
73,2,car,501,591,508,565,90,57,0.5544183
74,2,car,502,594,508,564,92,56,0.87572163
75,2,car,4294967271,1075,377,560,-4294966196,183,0.3504756
76,2,car,4294967278,1089,361,549,-4294966189,188,0.28828707
77,2,car,4294967277,1090,365,555,-4294966187,190,0.21405561
78,2,car,4294967294,1076,365,560,-4294966218,195,0.28676075
79,2,car,4294967275,1087,380,566,-4294966188,186,0.22077179
80,2,car,4294967273,1061,378,575,-4294966212,197,0.31963575
81,2,car,13,1082,373,578,1069,205,0.5401667
82,2,car,14,1056,383,578,1042,195,0.2695259
83,2,car,4294967270,1099,386,564,-4294966171,178,0.24828371
84,2,car,4294967286,966,380,574,-4294966320,194,0.26321974
0,2,car,515,598,508,565,83,57,0.47647023
1,2,car,506,590,510,564,84,54,0.83923197
2,2,car,506,590,510,565,84,55,0.9022778
3,2,car,506,591,509,564,85,55,0.8705986
4,2,car,505,591,508,564,86,56,0.8463685
5,2,car,506,590,508,564,84,56,0.8422107
6,2,car,507,590,509,563,83,54,0.78095347
7,2,car,507,590,508,565,83,57,0.700404
8,2,car,514,598,505,565,84,60,0.7235904
9,2,car,515,598,507,565,83,58,0.68271416
10,2,car,501,589,506,562,88,56,0.81126976
11,2,car,501,589,505,562,88,57,0.7960909
12,2,car,502,590,507,562,88,55,0.94661033
13,2,car,502,590,505,561,88,56,0.8724688
14,2,car,503,590,506,562,87,56,0.9390719
15,2,car,502,590,507,562,88,55,0.91756964
16,2,car,502,590,506,562,88,56,0.8507978
17,2,car,502,590,507,562,88,55,0.84904313
18,2,car,501,589,506,562,88,56,0.8766702
19,2,car,502,589,505,562,87,57,0.7969156
20,2,car,503,590,506,562,87,56,0.86517256
21,2,car,502,590,506,562,88,56,0.88858736
22,2,car,503,590,506,563,87,57,0.907217
23,2,car,502,590,505,561,88,56,0.86747587
24,2,car,502,589,506,562,87,56,0.87762594
25,2,car,501,589,506,562,88,56,0.8497129
26,2,car,501,589,505,562,88,57,0.8479053
27,2,car,502,590,505,562,88,57,0.8950311
28,2,car,502,590,507,562,88,55,0.9228381
29,2,car,502,589,505,561,87,56,0.90627426
30,2,car,502,590,505,562,88,57,0.8459921
31,2,car,503,590,506,562,87,56,0.8665674
32,2,car,501,589,505,561,88,56,0.88724774
33,2,car,502,590,505,561,88,56,0.84265935
34,2,car,503,590,507,562,87,55,0.910038
35,2,car,501,589,505,562,88,57,0.8158088
36,2,car,502,589,506,562,87,56,0.90897566
37,2,car,502,590,506,562,88,56,0.8953387
38,2,car,501,589,506,562,88,56,0.8826827
39,2,car,501,589,506,562,88,56,0.868128
40,2,car,502,589,507,562,87,55,0.87911797
41,2,car,502,590,506,562,88,56,0.92112195
42,2,car,502,590,506,562,88,56,0.8553335
43,2,car,502,589,506,563,87,57,0.8359229
44,2,car,502,589,506,562,87,56,0.8541347
45,2,car,501,589,506,562,88,56,0.79819185
46,2,car,501,589,506,563,88,57,0.85617733
47,2,car,501,589,507,564,88,57,0.8935997
48,2,car,501,589,507,563,88,56,0.75885755
49,2,car,502,591,509,563,89,54,0.7096379
50,2,car,514,602,494,554,88,60,0.31047094
51,2,car,517,600,504,563,83,59,0.8491415
52,2,car,502,590,508,564,88,56,0.7944646
53,2,car,502,590,509,564,88,55,0.8253944
54,2,car,491,574,495,555,83,60,0.8099735
55,2,car,498,589,509,564,91,55,0.87746143
56,2,car,516,598,504,561,82,57,0.8511085
57,2,car,514,598,507,564,84,57,0.8401219
58,2,car,504,593,510,564,89,54,0.9110706
59,2,car,497,583,508,566,86,58,0.8351104
60,2,car,502,595,509,565,93,56,0.9387687
61,2,car,504,593,510,564,89,54,0.8912073
62,2,car,502,594,510,565,92,55,0.9285165
63,2,car,502,592,510,565,90,55,0.89384234
64,2,car,515,598,504,560,83,56,0.4257941
65,2,car,514,598,507,564,84,57,0.31927696
66,2,car,501,590,510,567,89,57,0.72163993
67,2,car,501,591,509,564,90,55,0.88262093
68,2,car,502,593,510,565,91,55,0.89309627
69,2,car,506,594,506,566,88,60,0.76903325
70,2,car,507,593,509,566,86,57,0.7786368
71,2,car,507,594,508,565,87,57,0.7380539
72,2,car,495,585,509,566,90,57,0.8718345
73,2,car,502,592,508,565,90,57,0.76711863
74,2,car,501,591,508,565,90,57,0.5544183
75,2,car,502,594,508,564,92,56,0.87572163
76,2,car,4294967271,1075,377,560,-4294966196,183,0.3504756
77,2,car,4294967278,1089,361,549,-4294966189,188,0.28828707
78,2,car,4294967277,1090,365,555,-4294966187,190,0.21405561
79,2,car,4294967294,1076,365,560,-4294966218,195,0.28676075
80,2,car,4294967275,1087,380,566,-4294966188,186,0.22077179
81,2,car,4294967273,1061,378,575,-4294966212,197,0.31963575
82,2,car,13,1082,373,578,1069,205,0.5401667
83,2,car,14,1056,383,578,1042,195,0.2695259
84,2,car,4294967270,1099,386,564,-4294966171,178,0.24828371
85,2,car,4294967286,966,380,574,-4294966320,194,0.26321974
0,2,car,514,598,492,550,84,58,0.43632865
1,2,car,515,598,508,565,83,57,0.47647023
2,2,car,506,590,510,564,84,54,0.83923197
3,2,car,506,590,510,565,84,55,0.9022778
4,2,car,506,591,509,564,85,55,0.8705986
5,2,car,505,591,508,564,86,56,0.8463685
6,2,car,506,590,508,564,84,56,0.8422107
7,2,car,507,590,509,563,83,54,0.78095347
8,2,car,507,590,508,565,83,57,0.700404
9,2,car,514,598,505,565,84,60,0.7235904
10,2,car,515,598,507,565,83,58,0.68271416
11,2,car,501,589,506,562,88,56,0.81126976
12,2,car,501,589,505,562,88,57,0.7960909
13,2,car,502,590,507,562,88,55,0.94661033
14,2,car,502,590,505,561,88,56,0.8724688
15,2,car,503,590,506,562,87,56,0.9390719
16,2,car,502,590,507,562,88,55,0.91756964
17,2,car,502,590,506,562,88,56,0.8507978
18,2,car,502,590,507,562,88,55,0.84904313
19,2,car,501,589,506,562,88,56,0.8766702
20,2,car,502,589,505,562,87,57,0.7969156
21,2,car,503,590,506,562,87,56,0.86517256
22,2,car,502,590,506,562,88,56,0.88858736
23,2,car,503,590,506,563,87,57,0.907217
24,2,car,502,590,505,561,88,56,0.86747587
25,2,car,502,589,506,562,87,56,0.87762594
26,2,car,501,589,506,562,88,56,0.8497129
27,2,car,501,589,505,562,88,57,0.8479053
28,2,car,502,590,505,562,88,57,0.8950311
29,2,car,502,590,507,562,88,55,0.9228381
30,2,car,502,589,505,561,87,56,0.90627426
31,2,car,502,590,505,562,88,57,0.8459921
32,2,car,503,590,506,562,87,56,0.8665674
33,2,car,501,589,505,561,88,56,0.88724774
34,2,car,502,590,505,561,88,56,0.84265935
35,2,car,503,590,507,562,87,55,0.910038
36,2,car,501,589,505,562,88,57,0.8158088
37,2,car,502,589,506,562,87,56,0.90897566
38,2,car,502,590,506,562,88,56,0.8953387
39,2,car,501,589,506,562,88,56,0.8826827
40,2,car,501,589,506,562,88,56,0.868128
41,2,car,502,589,507,562,87,55,0.87911797
42,2,car,502,590,506,562,88,56,0.92112195
43,2,car,502,590,506,562,88,56,0.8553335
44,2,car,502,589,506,563,87,57,0.8359229
45,2,car,502,589,506,562,87,56,0.8541347
46,2,car,501,589,506,562,88,56,0.79819185
47,2,car,501,589,506,563,88,57,0.85617733
48,2,car,501,589,507,564,88,57,0.8935997
49,2,car,501,589,507,563,88,56,0.75885755
50,2,car,502,591,509,563,89,54,0.7096379
51,2,car,514,602,494,554,88,60,0.31047094
52,2,car,517,600,504,563,83,59,0.8491415
53,2,car,502,590,508,564,88,56,0.7944646
54,2,car,502,590,509,564,88,55,0.8253944
55,2,car,491,574,495,555,83,60,0.8099735
56,2,car,498,589,509,564,91,55,0.87746143
57,2,car,516,598,504,561,82,57,0.8511085
58,2,car,514,598,507,564,84,57,0.8401219
59,2,car,504,593,510,564,89,54,0.9110706
60,2,car,497,583,508,566,86,58,0.8351104
61,2,car,502,595,509,565,93,56,0.9387687
62,2,car,504,593,510,564,89,54,0.8912073
63,2,car,502,594,510,565,92,55,0.9285165
64,2,car,502,592,510,565,90,55,0.89384234
65,2,car,515,598,504,560,83,56,0.4257941
66,2,car,514,598,507,564,84,57,0.31927696
67,2,car,501,590,510,567,89,57,0.72163993
68,2,car,501,591,509,564,90,55,0.88262093
69,2,car,502,593,510,565,91,55,0.89309627
70,2,car,506,594,506,566,88,60,0.76903325
71,2,car,507,593,509,566,86,57,0.7786368
72,2,car,507,594,508,565,87,57,0.7380539
73,2,car,495,585,509,566,90,57,0.8718345
74,2,car,502,592,508,565,90,57,0.76711863
75,2,car,501,591,508,565,90,57,0.5544183
76,2,car,502,594,508,564,92,56,0.87572163
77,2,car,4294967271,1075,377,560,-4294966196,183,0.3504756
78,2,car,4294967278,1089,361,549,-4294966189,188,0.28828707
79,2,car,4294967277,1090,365,555,-4294966187,190,0.21405561
80,2,car,4294967294,1076,365,560,-4294966218,195,0.28676075
81,2,car,4294967275,1087,380,566,-4294966188,186,0.22077179
82,2,car,4294967273,1061,378,575,-4294966212,197,0.31963575
83,2,car,13,1082,373,578,1069,205,0.5401667
84,2,car,14,1056,383,578,1042,195,0.2695259
85,2,car,4294967270,1099,386,564,-4294966171,178,0.24828371
86,2,car,4294967286,966,380,574,-4294966320,194,0.26321974
0,2,car,515,600,501,557,85,56,0.7599205
1,2,car,514,598,492,550,84,58,0.43632865
2,2,car,515,598,508,565,83,57,0.47647023
3,2,car,506,590,510,564,84,54,0.83923197
4,2,car,506,590,510,565,84,55,0.9022778
5,2,car,506,591,509,564,85,55,0.8705986
6,2,car,505,591,508,564,86,56,0.8463685
7,2,car,506,590,508,564,84,56,0.8422107
8,2,car,507,590,509,563,83,54,0.78095347
9,2,car,507,590,508,565,83,57,0.700404
10,2,car,514,598,505,565,84,60,0.7235904
11,2,car,515,598,507,565,83,58,0.68271416
12,2,car,501,589,506,562,88,56,0.81126976
13,2,car,501,589,505,562,88,57,0.7960909
14,2,car,502,590,507,562,88,55,0.94661033
15,2,car,502,590,505,561,88,56,0.8724688
16,2,car,503,590,506,562,87,56,0.9390719
17,2,car,502,590,507,562,88,55,0.91756964
18,2,car,502,590,506,562,88,56,0.8507978
19,2,car,502,590,507,562,88,55,0.84904313
20,2,car,501,589,506,562,88,56,0.8766702
21,2,car,502,589,505,562,87,57,0.7969156
22,2,car,503,590,506,562,87,56,0.86517256
23,2,car,502,590,506,562,88,56,0.88858736
24,2,car,503,590,506,563,87,57,0.907217
25,2,car,502,590,505,561,88,56,0.86747587
26,2,car,502,589,506,562,87,56,0.87762594
27,2,car,501,589,506,562,88,56,0.8497129
28,2,car,501,589,505,562,88,57,0.8479053
29,2,car,502,590,505,562,88,57,0.8950311
30,2,car,502,590,507,562,88,55,0.9228381
31,2,car,502,589,505,561,87,56,0.90627426
32,2,car,502,590,505,562,88,57,0.8459921
33,2,car,503,590,506,562,87,56,0.8665674
34,2,car,501,589,505,561,88,56,0.88724774
35,2,car,502,590,505,561,88,56,0.84265935
36,2,car,503,590,507,562,87,55,0.910038
37,2,car,501,589,505,562,88,57,0.8158088
38,2,car,502,589,506,562,87,56,0.90897566
39,2,car,502,590,506,562,88,56,0.8953387
40,2,car,501,589,506,562,88,56,0.8826827
41,2,car,501,589,506,562,88,56,0.868128
42,2,car,502,589,507,562,87,55,0.87911797
43,2,car,502,590,506,562,88,56,0.92112195
44,2,car,502,590,506,562,88,56,0.8553335
45,2,car,502,589,506,563,87,57,0.8359229
46,2,car,502,589,506,562,87,56,0.8541347
47,2,car,501,589,506,562,88,56,0.79819185
48,2,car,501,589,506,563,88,57,0.85617733
49,2,car,501,589,507,564,88,57,0.8935997
50,2,car,501,589,507,563,88,56,0.75885755
51,2,car,502,591,509,563,89,54,0.7096379
52,2,car,514,602,494,554,88,60,0.31047094
53,2,car,517,600,504,563,83,59,0.8491415
54,2,car,502,590,508,564,88,56,0.7944646
55,2,car,502,590,509,564,88,55,0.8253944
56,2,car,491,574,495,555,83,60,0.8099735
57,2,car,498,589,509,564,91,55,0.87746143
58,2,car,516,598,504,561,82,57,0.8511085
59,2,car,514,598,507,564,84,57,0.8401219
60,2,car,504,593,510,564,89,54,0.9110706
61,2,car,497,583,508,566,86,58,0.8351104
62,2,car,502,595,509,565,93,56,0.9387687
63,2,car,504,593,510,564,89,54,0.8912073
64,2,car,502,594,510,565,92,55,0.9285165
65,2,car,502,592,510,565,90,55,0.89384234
66,2,car,515,598,504,560,83,56,0.4257941
67,2,car,514,598,507,564,84,57,0.31927696
68,2,car,501,590,510,567,89,57,0.72163993
69,2,car,501,591,509,564,90,55,0.88262093
70,2,car,502,593,510,565,91,55,0.89309627
71,2,car,506,594,506,566,88,60,0.76903325
72,2,car,507,593,509,566,86,57,0.7786368
73,2,car,507,594,508,565,87,57,0.7380539
74,2,car,495,585,509,566,90,57,0.8718345
75,2,car,502,592,508,565,90,57,0.76711863
76,2,car,501,591,508,565,90,57,0.5544183
77,2,car,502,594,508,564,92,56,0.87572163
78,2,car,4294967271,1075,377,560,-4294966196,183,0.3504756
79,2,car,4294967278,1089,361,549,-4294966189,188,0.28828707
80,2,car,4294967277,1090,365,555,-4294966187,190,0.21405561
81,2,car,4294967294,1076,365,560,-4294966218,195,0.28676075
82,2,car,4294967275,1087,380,566,-4294966188,186,0.22077179
83,2,car,4294967273,1061,378,575,-4294966212,197,0.31963575
84,2,car,13,1082,373,578,1069,205,0.5401667
85,2,car,14,1056,383,578,1042,195,0.2695259
86,2,car,4294967270,1099,386,564,-4294966171,178,0.24828371
87,2,car,4294967286,966,380,574,-4294966320,194,0.26321974
0,2,car,514,603,493,553,89,60,0.2825035
1,2,car,515,600,501,557,85,56,0.7599205
2,2,car,514,598,492,550,84,58,0.43632865
3,2,car,515,598,508,565,83,57,0.47647023
4,2,car,506,590,510,564,84,54,0.83923197
5,2,car,506,590,510,565,84,55,0.9022778
6,2,car,506,591,509,564,85,55,0.8705986
7,2,car,505,591,508,564,86,56,0.8463685
8,2,car,506,590,508,564,84,56,0.8422107
9,2,car,507,590,509,563,83,54,0.78095347
10,2,car,507,590,508,565,83,57,0.700404
11,2,car,514,598,505,565,84,60,0.7235904
12,2,car,515,598,507,565,83,58,0.68271416
13,2,car,501,589,506,562,88,56,0.81126976
14,2,car,501,589,505,562,88,57,0.7960909
15,2,car,502,590,507,562,88,55,0.94661033
16,2,car,502,590,505,561,88,56,0.8724688
17,2,car,503,590,506,562,87,56,0.9390719
18,2,car,502,590,507,562,88,55,0.91756964
19,2,car,502,590,506,562,88,56,0.8507978
20,2,car,502,590,507,562,88,55,0.84904313
21,2,car,501,589,506,562,88,56,0.8766702
22,2,car,502,589,505,562,87,57,0.7969156
23,2,car,503,590,506,562,87,56,0.86517256
24,2,car,502,590,506,562,88,56,0.88858736
25,2,car,503,590,506,563,87,57,0.907217
26,2,car,502,590,505,561,88,56,0.86747587
27,2,car,502,589,506,562,87,56,0.87762594
28,2,car,501,589,506,562,88,56,0.8497129
29,2,car,501,589,505,562,88,57,0.8479053
30,2,car,502,590,505,562,88,57,0.8950311
31,2,car,502,590,507,562,88,55,0.9228381
32,2,car,502,589,505,561,87,56,0.90627426
33,2,car,502,590,505,562,88,57,0.8459921
34,2,car,503,590,506,562,87,56,0.8665674
35,2,car,501,589,505,561,88,56,0.88724774
36,2,car,502,590,505,561,88,56,0.84265935
37,2,car,503,590,507,562,87,55,0.910038
38,2,car,501,589,505,562,88,57,0.8158088
39,2,car,502,589,506,562,87,56,0.90897566
40,2,car,502,590,506,562,88,56,0.8953387
41,2,car,501,589,506,562,88,56,0.8826827
42,2,car,501,589,506,562,88,56,0.868128
43,2,car,502,589,507,562,87,55,0.87911797
44,2,car,502,590,506,562,88,56,0.92112195
45,2,car,502,590,506,562,88,56,0.8553335
46,2,car,502,589,506,563,87,57,0.8359229
47,2,car,502,589,506,562,87,56,0.8541347
48,2,car,501,589,506,562,88,56,0.79819185
49,2,car,501,589,506,563,88,57,0.85617733
50,2,car,501,589,507,564,88,57,0.8935997
51,2,car,501,589,507,563,88,56,0.75885755
52,2,car,502,591,509,563,89,54,0.7096379
53,2,car,514,602,494,554,88,60,0.31047094
54,2,car,517,600,504,563,83,59,0.8491415
55,2,car,502,590,508,564,88,56,0.7944646
56,2,car,502,590,509,564,88,55,0.8253944
57,2,car,491,574,495,555,83,60,0.8099735
58,2,car,498,589,509,564,91,55,0.87746143
59,2,car,516,598,504,561,82,57,0.8511085
60,2,car,514,598,507,564,84,57,0.8401219
61,2,car,504,593,510,564,89,54,0.9110706
62,2,car,497,583,508,566,86,58,0.8351104
63,2,car,502,595,509,565,93,56,0.9387687
64,2,car,504,593,510,564,89,54,0.8912073
65,2,car,502,594,510,565,92,55,0.9285165
66,2,car,502,592,510,565,90,55,0.89384234
67,2,car,515,598,504,560,83,56,0.4257941
68,2,car,514,598,507,564,84,57,0.31927696
69,2,car,501,590,510,567,89,57,0.72163993
70,2,car,501,591,509,564,90,55,0.88262093
71,2,car,502,593,510,565,91,55,0.89309627
72,2,car,506,594,506,566,88,60,0.76903325
73,2,car,507,593,509,566,86,57,0.7786368
74,2,car,507,594,508,565,87,57,0.7380539
75,2,car,495,585,509,566,90,57,0.8718345
76,2,car,502,592,508,565,90,57,0.76711863
77,2,car,501,591,508,565,90,57,0.5544183
78,2,car,502,594,508,564,92,56,0.87572163
79,2,car,4294967271,1075,377,560,-4294966196,183,0.3504756
80,2,car,4294967278,1089,361,549,-4294966189,188,0.28828707
81,2,car,4294967277,1090,365,555,-4294966187,190,0.21405561
82,2,car,4294967294,1076,365,560,-4294966218,195,0.28676075
83,2,car,4294967275,1087,380,566,-4294966188,186,0.22077179
84,2,car,4294967273,1061,378,575,-4294966212,197,0.31963575
85,2,car,13,1082,373,578,1069,205,0.5401667
86,2,car,14,1056,383,578,1042,195,0.2695259
87,2,car,4294967270,1099,386,564,-4294966171,178,0.24828371
88,2,car,4294967286,966,380,574,-4294966320,194,0.26321974
0,2,car,516,601,501,558,85,57,0.5533195
1,2,car,514,603,493,553,89,60,0.2825035
2,2,car,515,600,501,557,85,56,0.7599205
3,2,car,514,598,492,550,84,58,0.43632865
4,2,car,515,598,508,565,83,57,0.47647023
5,2,car,506,590,510,564,84,54,0.83923197
6,2,car,506,590,510,565,84,55,0.9022778
7,2,car,506,591,509,564,85,55,0.8705986
8,2,car,505,591,508,564,86,56,0.8463685
9,2,car,506,590,508,564,84,56,0.8422107
10,2,car,507,590,509,563,83,54,0.78095347
11,2,car,507,590,508,565,83,57,0.700404
12,2,car,514,598,505,565,84,60,0.7235904
13,2,car,515,598,507,565,83,58,0.68271416
14,2,car,501,589,506,562,88,56,0.81126976
15,2,car,501,589,505,562,88,57,0.7960909
16,2,car,502,590,507,562,88,55,0.94661033
17,2,car,502,590,505,561,88,56,0.8724688
18,2,car,503,590,506,562,87,56,0.9390719
19,2,car,502,590,507,562,88,55,0.91756964
20,2,car,502,590,506,562,88,56,0.8507978
21,2,car,502,590,507,562,88,55,0.84904313
22,2,car,501,589,506,562,88,56,0.8766702
23,2,car,502,589,505,562,87,57,0.7969156
24,2,car,503,590,506,562,87,56,0.86517256
25,2,car,502,590,506,562,88,56,0.88858736
26,2,car,503,590,506,563,87,57,0.907217
27,2,car,502,590,505,561,88,56,0.86747587
28,2,car,502,589,506,562,87,56,0.87762594
29,2,car,501,589,506,562,88,56,0.8497129
30,2,car,501,589,505,562,88,57,0.8479053
31,2,car,502,590,505,562,88,57,0.8950311
32,2,car,502,590,507,562,88,55,0.9228381
33,2,car,502,589,505,561,87,56,0.90627426
34,2,car,502,590,505,562,88,57,0.8459921
35,2,car,503,590,506,562,87,56,0.8665674
36,2,car,501,589,505,561,88,56,0.88724774
37,2,car,502,590,505,561,88,56,0.84265935
38,2,car,503,590,507,562,87,55,0.910038
39,2,car,501,589,505,562,88,57,0.8158088
40,2,car,502,589,506,562,87,56,0.90897566
41,2,car,502,590,506,562,88,56,0.8953387
42,2,car,501,589,506,562,88,56,0.8826827
43,2,car,501,589,506,562,88,56,0.868128
44,2,car,502,589,507,562,87,55,0.87911797
45,2,car,502,590,506,562,88,56,0.92112195
46,2,car,502,590,506,562,88,56,0.8553335
47,2,car,502,589,506,563,87,57,0.8359229
48,2,car,502,589,506,562,87,56,0.8541347
49,2,car,501,589,506,562,88,56,0.79819185
50,2,car,501,589,506,563,88,57,0.85617733
51,2,car,501,589,507,564,88,57,0.8935997
52,2,car,501,589,507,563,88,56,0.75885755
53,2,car,502,591,509,563,89,54,0.7096379
54,2,car,514,602,494,554,88,60,0.31047094
55,2,car,517,600,504,563,83,59,0.8491415
56,2,car,502,590,508,564,88,56,0.7944646
57,2,car,502,590,509,564,88,55,0.8253944
58,2,car,491,574,495,555,83,60,0.8099735
59,2,car,498,589,509,564,91,55,0.87746143
60,2,car,516,598,504,561,82,57,0.8511085
61,2,car,514,598,507,564,84,57,0.8401219
62,2,car,504,593,510,564,89,54,0.9110706
63,2,car,497,583,508,566,86,58,0.8351104
64,2,car,502,595,509,565,93,56,0.9387687
65,2,car,504,593,510,564,89,54,0.8912073
66,2,car,502,594,510,565,92,55,0.9285165
67,2,car,502,592,510,565,90,55,0.89384234
68,2,car,515,598,504,560,83,56,0.4257941
69,2,car,514,598,507,564,84,57,0.31927696
70,2,car,501,590,510,567,89,57,0.72163993
71,2,car,501,591,509,564,90,55,0.88262093
72,2,car,502,593,510,565,91,55,0.89309627
73,2,car,506,594,506,566,88,60,0.76903325
74,2,car,507,593,509,566,86,57,0.7786368
75,2,car,507,594,508,565,87,57,0.7380539
76,2,car,495,585,509,566,90,57,0.8718345
77,2,car,502,592,508,565,90,57,0.76711863
78,2,car,501,591,508,565,90,57,0.5544183
79,2,car,502,594,508,564,92,56,0.87572163
80,2,car,4294967271,1075,377,560,-4294966196,183,0.3504756
81,2,car,4294967278,1089,361,549,-4294966189,188,0.28828707
82,2,car,4294967277,1090,365,555,-4294966187,190,0.21405561
83,2,car,4294967294,1076,365,560,-4294966218,195,0.28676075
84,2,car,4294967275,1087,380,566,-4294966188,186,0.22077179
85,2,car,4294967273,1061,378,575,-4294966212,197,0.31963575
86,2,car,13,1082,373,578,1069,205,0.5401667
87,2,car,14,1056,383,578,1042,195,0.2695259
88,2,car,4294967270,1099,386,564,-4294966171,178,0.24828371
89,2,car,4294967286,966,380,574,-4294966320,194,0.26321974
0,2,car,515,599,498,557,84,59,0.7085072
1,2,car,516,601,501,558,85,57,0.5533195
2,2,car,514,603,493,553,89,60,0.2825035
3,2,car,515,600,501,557,85,56,0.7599205
4,2,car,514,598,492,550,84,58,0.43632865
5,2,car,515,598,508,565,83,57,0.47647023
6,2,car,506,590,510,564,84,54,0.83923197
7,2,car,506,590,510,565,84,55,0.9022778
8,2,car,506,591,509,564,85,55,0.8705986
9,2,car,505,591,508,564,86,56,0.8463685
10,2,car,506,590,508,564,84,56,0.8422107
11,2,car,507,590,509,563,83,54,0.78095347
12,2,car,507,590,508,565,83,57,0.700404
13,2,car,514,598,505,565,84,60,0.7235904
14,2,car,515,598,507,565,83,58,0.68271416
15,2,car,501,589,506,562,88,56,0.81126976
16,2,car,501,589,505,562,88,57,0.7960909
17,2,car,502,590,507,562,88,55,0.94661033
18,2,car,502,590,505,561,88,56,0.8724688
19,2,car,503,590,506,562,87,56,0.9390719
20,2,car,502,590,507,562,88,55,0.91756964
21,2,car,502,590,506,562,88,56,0.8507978
22,2,car,502,590,507,562,88,55,0.84904313
23,2,car,501,589,506,562,88,56,0.8766702
24,2,car,502,589,505,562,87,57,0.7969156
25,2,car,503,590,506,562,87,56,0.86517256
26,2,car,502,590,506,562,88,56,0.88858736
27,2,car,503,590,506,563,87,57,0.907217
28,2,car,502,590,505,561,88,56,0.86747587
29,2,car,502,589,506,562,87,56,0.87762594
30,2,car,501,589,506,562,88,56,0.8497129
31,2,car,501,589,505,562,88,57,0.8479053
32,2,car,502,590,505,562,88,57,0.8950311
33,2,car,502,590,507,562,88,55,0.9228381
34,2,car,502,589,505,561,87,56,0.90627426
35,2,car,502,590,505,562,88,57,0.8459921
36,2,car,503,590,506,562,87,56,0.8665674
37,2,car,501,589,505,561,88,56,0.88724774
38,2,car,502,590,505,561,88,56,0.84265935
39,2,car,503,590,507,562,87,55,0.910038
40,2,car,501,589,505,562,88,57,0.8158088
41,2,car,502,589,506,562,87,56,0.90897566
42,2,car,502,590,506,562,88,56,0.8953387
43,2,car,501,589,506,562,88,56,0.8826827
44,2,car,501,589,506,562,88,56,0.868128
45,2,car,502,589,507,562,87,55,0.87911797
46,2,car,502,590,506,562,88,56,0.92112195
47,2,car,502,590,506,562,88,56,0.8553335
48,2,car,502,589,506,563,87,57,0.8359229
49,2,car,502,589,506,562,87,56,0.8541347
50,2,car,501,589,506,562,88,56,0.79819185
51,2,car,501,589,506,563,88,57,0.85617733
52,2,car,501,589,507,564,88,57,0.8935997
53,2,car,501,589,507,563,88,56,0.75885755
54,2,car,502,591,509,563,89,54,0.7096379
55,2,car,514,602,494,554,88,60,0.31047094
56,2,car,517,600,504,563,83,59,0.8491415
57,2,car,502,590,508,564,88,56,0.7944646
58,2,car,502,590,509,564,88,55,0.8253944
59,2,car,491,574,495,555,83,60,0.8099735
60,2,car,498,589,509,564,91,55,0.87746143
61,2,car,516,598,504,561,82,57,0.8511085
62,2,car,514,598,507,564,84,57,0.8401219
63,2,car,504,593,510,564,89,54,0.9110706
64,2,car,497,583,508,566,86,58,0.8351104
65,2,car,502,595,509,565,93,56,0.9387687
66,2,car,504,593,510,564,89,54,0.8912073
67,2,car,502,594,510,565,92,55,0.9285165
68,2,car,502,592,510,565,90,55,0.89384234
69,2,car,515,598,504,560,83,56,0.4257941
70,2,car,514,598,507,564,84,57,0.31927696
71,2,car,501,590,510,567,89,57,0.72163993
72,2,car,501,591,509,564,90,55,0.88262093
73,2,car,502,593,510,565,91,55,0.89309627
74,2,car,506,594,506,566,88,60,0.76903325
75,2,car,507,593,509,566,86,57,0.7786368
76,2,car,507,594,508,565,87,57,0.7380539
77,2,car,495,585,509,566,90,57,0.8718345
78,2,car,502,592,508,565,90,57,0.76711863
79,2,car,501,591,508,565,90,57,0.5544183
80,2,car,502,594,508,564,92,56,0.87572163
81,2,car,4294967271,1075,377,560,-4294966196,183,0.3504756
82,2,car,4294967278,1089,361,549,-4294966189,188,0.28828707
83,2,car,4294967277,1090,365,555,-4294966187,190,0.21405561
84,2,car,4294967294,1076,365,560,-4294966218,195,0.28676075
85,2,car,4294967275,1087,380,566,-4294966188,186,0.22077179
86,2,car,4294967273,1061,378,575,-4294966212,197,0.31963575
87,2,car,13,1082,373,578,1069,205,0.5401667
88,2,car,14,1056,383,578,1042,195,0.2695259
89,2,car,4294967270,1099,386,564,-4294966171,178,0.24828371
90,2,car,4294967286,966,380,574,-4294966320,194,0.26321974
0,2,car,502,591,510,564,89,54,0.9008823
1,2,car,515,599,498,557,84,59,0.7085072
2,2,car,516,601,501,558,85,57,0.5533195
3,2,car,514,603,493,553,89,60,0.2825035
4,2,car,515,600,501,557,85,56,0.7599205
5,2,car,514,598,492,550,84,58,0.43632865
6,2,car,515,598,508,565,83,57,0.47647023
7,2,car,506,590,510,564,84,54,0.83923197
8,2,car,506,590,510,565,84,55,0.9022778
9,2,car,506,591,509,564,85,55,0.8705986
10,2,car,505,591,508,564,86,56,0.8463685
11,2,car,506,590,508,564,84,56,0.8422107
12,2,car,507,590,509,563,83,54,0.78095347
13,2,car,507,590,508,565,83,57,0.700404
14,2,car,514,598,505,565,84,60,0.7235904
15,2,car,515,598,507,565,83,58,0.68271416
16,2,car,501,589,506,562,88,56,0.81126976
17,2,car,501,589,505,562,88,57,0.7960909
18,2,car,502,590,507,562,88,55,0.94661033
19,2,car,502,590,505,561,88,56,0.8724688
20,2,car,503,590,506,562,87,56,0.9390719
21,2,car,502,590,507,562,88,55,0.91756964
22,2,car,502,590,506,562,88,56,0.8507978
23,2,car,502,590,507,562,88,55,0.84904313
24,2,car,501,589,506,562,88,56,0.8766702
25,2,car,502,589,505,562,87,57,0.7969156
26,2,car,503,590,506,562,87,56,0.86517256
27,2,car,502,590,506,562,88,56,0.88858736
28,2,car,503,590,506,563,87,57,0.907217
29,2,car,502,590,505,561,88,56,0.86747587
30,2,car,502,589,506,562,87,56,0.87762594
31,2,car,501,589,506,562,88,56,0.8497129
32,2,car,501,589,505,562,88,57,0.8479053
33,2,car,502,590,505,562,88,57,0.8950311
34,2,car,502,590,507,562,88,55,0.9228381
35,2,car,502,589,505,561,87,56,0.90627426
36,2,car,502,590,505,562,88,57,0.8459921
37,2,car,503,590,506,562,87,56,0.8665674
38,2,car,501,589,505,561,88,56,0.88724774
39,2,car,502,590,505,561,88,56,0.84265935
40,2,car,503,590,507,562,87,55,0.910038
41,2,car,501,589,505,562,88,57,0.8158088
42,2,car,502,589,506,562,87,56,0.90897566
43,2,car,502,590,506,562,88,56,0.8953387
44,2,car,501,589,506,562,88,56,0.8826827
45,2,car,501,589,506,562,88,56,0.868128
46,2,car,502,589,507,562,87,55,0.87911797
47,2,car,502,590,506,562,88,56,0.92112195
48,2,car,502,590,506,562,88,56,0.8553335
49,2,car,502,589,506,563,87,57,0.8359229
50,2,car,502,589,506,562,87,56,0.8541347
51,2,car,501,589,506,562,88,56,0.79819185
52,2,car,501,589,506,563,88,57,0.85617733
53,2,car,501,589,507,564,88,57,0.8935997
54,2,car,501,589,507,563,88,56,0.75885755
55,2,car,502,591,509,563,89,54,0.7096379
56,2,car,514,602,494,554,88,60,0.31047094
57,2,car,517,600,504,563,83,59,0.8491415
58,2,car,502,590,508,564,88,56,0.7944646
59,2,car,502,590,509,564,88,55,0.8253944
60,2,car,491,574,495,555,83,60,0.8099735
61,2,car,498,589,509,564,91,55,0.87746143
62,2,car,516,598,504,561,82,57,0.8511085
63,2,car,514,598,507,564,84,57,0.8401219
64,2,car,504,593,510,564,89,54,0.9110706
65,2,car,497,583,508,566,86,58,0.8351104
66,2,car,502,595,509,565,93,56,0.9387687
67,2,car,504,593,510,564,89,54,0.8912073
68,2,car,502,594,510,565,92,55,0.9285165
69,2,car,502,592,510,565,90,55,0.89384234
70,2,car,515,598,504,560,83,56,0.4257941
71,2,car,514,598,507,564,84,57,0.31927696
72,2,car,501,590,510,567,89,57,0.72163993
73,2,car,501,591,509,564,90,55,0.88262093
74,2,car,502,593,510,565,91,55,0.89309627
75,2,car,506,594,506,566,88,60,0.76903325
76,2,car,507,593,509,566,86,57,0.7786368
77,2,car,507,594,508,565,87,57,0.7380539
78,2,car,495,585,509,566,90,57,0.8718345
79,2,car,502,592,508,565,90,57,0.76711863
80,2,car,501,591,508,565,90,57,0.5544183
81,2,car,502,594,508,564,92,56,0.87572163
82,2,car,4294967271,1075,377,560,-4294966196,183,0.3504756
83,2,car,4294967278,1089,361,549,-4294966189,188,0.28828707
84,2,car,4294967277,1090,365,555,-4294966187,190,0.21405561
85,2,car,4294967294,1076,365,560,-4294966218,195,0.28676075
86,2,car,4294967275,1087,380,566,-4294966188,186,0.22077179
87,2,car,4294967273,1061,378,575,-4294966212,197,0.31963575
88,2,car,13,1082,373,578,1069,205,0.5401667
89,2,car,14,1056,383,578,1042,195,0.2695259
90,2,car,4294967270,1099,386,564,-4294966171,178,0.24828371
91,2,car,4294967286,966,380,574,-4294966320,194,0.26321974
0,2,car,501,589,508,564,88,56,0.8016756
1,2,car,502,591,510,564,89,54,0.9008823
2,2,car,515,599,498,557,84,59,0.7085072
3,2,car,516,601,501,558,85,57,0.5533195
4,2,car,514,603,493,553,89,60,0.2825035
5,2,car,515,600,501,557,85,56,0.7599205
6,2,car,514,598,492,550,84,58,0.43632865
7,2,car,515,598,508,565,83,57,0.47647023
8,2,car,506,590,510,564,84,54,0.83923197
9,2,car,506,590,510,565,84,55,0.9022778
10,2,car,506,591,509,564,85,55,0.8705986
11,2,car,505,591,508,564,86,56,0.8463685
12,2,car,506,590,508,564,84,56,0.8422107
13,2,car,507,590,509,563,83,54,0.78095347
14,2,car,507,590,508,565,83,57,0.700404
15,2,car,514,598,505,565,84,60,0.7235904
16,2,car,515,598,507,565,83,58,0.68271416
17,2,car,501,589,506,562,88,56,0.81126976
18,2,car,501,589,505,562,88,57,0.7960909
19,2,car,502,590,507,562,88,55,0.94661033
20,2,car,502,590,505,561,88,56,0.8724688
21,2,car,503,590,506,562,87,56,0.9390719
22,2,car,502,590,507,562,88,55,0.91756964
23,2,car,502,590,506,562,88,56,0.8507978
24,2,car,502,590,507,562,88,55,0.84904313
25,2,car,501,589,506,562,88,56,0.8766702
26,2,car,502,589,505,562,87,57,0.7969156
27,2,car,503,590,506,562,87,56,0.86517256
28,2,car,502,590,506,562,88,56,0.88858736
29,2,car,503,590,506,563,87,57,0.907217
30,2,car,502,590,505,561,88,56,0.86747587
31,2,car,502,589,506,562,87,56,0.87762594
32,2,car,501,589,506,562,88,56,0.8497129
33,2,car,501,589,505,562,88,57,0.8479053
34,2,car,502,590,505,562,88,57,0.8950311
35,2,car,502,590,507,562,88,55,0.9228381
36,2,car,502,589,505,561,87,56,0.90627426
37,2,car,502,590,505,562,88,57,0.8459921
38,2,car,503,590,506,562,87,56,0.8665674
39,2,car,501,589,505,561,88,56,0.88724774
40,2,car,502,590,505,561,88,56,0.84265935
41,2,car,503,590,507,562,87,55,0.910038
42,2,car,501,589,505,562,88,57,0.8158088
43,2,car,502,589,506,562,87,56,0.90897566
44,2,car,502,590,506,562,88,56,0.8953387
45,2,car,501,589,506,562,88,56,0.8826827
46,2,car,501,589,506,562,88,56,0.868128
47,2,car,502,589,507,562,87,55,0.87911797
48,2,car,502,590,506,562,88,56,0.92112195
49,2,car,502,590,506,562,88,56,0.8553335
50,2,car,502,589,506,563,87,57,0.8359229
51,2,car,502,589,506,562,87,56,0.8541347
52,2,car,501,589,506,562,88,56,0.79819185
53,2,car,501,589,506,563,88,57,0.85617733
54,2,car,501,589,507,564,88,57,0.8935997
55,2,car,501,589,507,563,88,56,0.75885755
56,2,car,502,591,509,563,89,54,0.7096379
57,2,car,514,602,494,554,88,60,0.31047094
58,2,car,517,600,504,563,83,59,0.8491415
59,2,car,502,590,508,564,88,56,0.7944646
60,2,car,502,590,509,564,88,55,0.8253944
61,2,car,491,574,495,555,83,60,0.8099735
62,2,car,498,589,509,564,91,55,0.87746143
63,2,car,516,598,504,561,82,57,0.8511085
64,2,car,514,598,507,564,84,57,0.8401219
65,2,car,504,593,510,564,89,54,0.9110706
66,2,car,497,583,508,566,86,58,0.8351104
67,2,car,502,595,509,565,93,56,0.9387687
68,2,car,504,593,510,564,89,54,0.8912073
69,2,car,502,594,510,565,92,55,0.9285165
70,2,car,502,592,510,565,90,55,0.89384234
71,2,car,515,598,504,560,83,56,0.4257941
72,2,car,514,598,507,564,84,57,0.31927696
73,2,car,501,590,510,567,89,57,0.72163993
74,2,car,501,591,509,564,90,55,0.88262093
75,2,car,502,593,510,565,91,55,0.89309627
76,2,car,506,594,506,566,88,60,0.76903325
77,2,car,507,593,509,566,86,57,0.7786368
78,2,car,507,594,508,565,87,57,0.7380539
79,2,car,495,585,509,566,90,57,0.8718345
80,2,car,502,592,508,565,90,57,0.76711863
81,2,car,501,591,508,565,90,57,0.5544183
82,2,car,502,594,508,564,92,56,0.87572163
83,2,car,4294967271,1075,377,560,-4294966196,183,0.3504756
84,2,car,4294967278,1089,361,549,-4294966189,188,0.28828707
85,2,car,4294967277,1090,365,555,-4294966187,190,0.21405561
86,2,car,4294967294,1076,365,560,-4294966218,195,0.28676075
87,2,car,4294967275,1087,380,566,-4294966188,186,0.22077179
88,2,car,4294967273,1061,378,575,-4294966212,197,0.31963575
89,2,car,13,1082,373,578,1069,205,0.5401667
90,2,car,14,1056,383,578,1042,195,0.2695259
91,2,car,4294967270,1099,386,564,-4294966171,178,0.24828371
92,2,car,4294967286,966,380,574,-4294966320,194,0.26321974
0,2,car,503,590,507,564,87,57,0.88757277
1,2,car,501,589,508,564,88,56,0.8016756
2,2,car,502,591,510,564,89,54,0.9008823
3,2,car,515,599,498,557,84,59,0.7085072
4,2,car,516,601,501,558,85,57,0.5533195
5,2,car,514,603,493,553,89,60,0.2825035
6,2,car,515,600,501,557,85,56,0.7599205
7,2,car,514,598,492,550,84,58,0.43632865
8,2,car,515,598,508,565,83,57,0.47647023
9,2,car,506,590,510,564,84,54,0.83923197
10,2,car,506,590,510,565,84,55,0.9022778
11,2,car,506,591,509,564,85,55,0.8705986
12,2,car,505,591,508,564,86,56,0.8463685
13,2,car,506,590,508,564,84,56,0.8422107
14,2,car,507,590,509,563,83,54,0.78095347
15,2,car,507,590,508,565,83,57,0.700404
16,2,car,514,598,505,565,84,60,0.7235904
17,2,car,515,598,507,565,83,58,0.68271416
18,2,car,501,589,506,562,88,56,0.81126976
19,2,car,501,589,505,562,88,57,0.7960909
20,2,car,502,590,507,562,88,55,0.94661033
21,2,car,502,590,505,561,88,56,0.8724688
22,2,car,503,590,506,562,87,56,0.9390719
23,2,car,502,590,507,562,88,55,0.91756964
24,2,car,502,590,506,562,88,56,0.8507978
25,2,car,502,590,507,562,88,55,0.84904313
26,2,car,501,589,506,562,88,56,0.8766702
27,2,car,502,589,505,562,87,57,0.7969156
28,2,car,503,590,506,562,87,56,0.86517256
29,2,car,502,590,506,562,88,56,0.88858736
30,2,car,503,590,506,563,87,57,0.907217
31,2,car,502,590,505,561,88,56,0.86747587
32,2,car,502,589,506,562,87,56,0.87762594
33,2,car,501,589,506,562,88,56,0.8497129
34,2,car,501,589,505,562,88,57,0.8479053
35,2,car,502,590,505,562,88,57,0.8950311
36,2,car,502,590,507,562,88,55,0.9228381
37,2,car,502,589,505,561,87,56,0.90627426
38,2,car,502,590,505,562,88,57,0.8459921
39,2,car,503,590,506,562,87,56,0.8665674
40,2,car,501,589,505,561,88,56,0.88724774
41,2,car,502,590,505,561,88,56,0.84265935
42,2,car,503,590,507,562,87,55,0.910038
43,2,car,501,589,505,562,88,57,0.8158088
44,2,car,502,589,506,562,87,56,0.90897566
45,2,car,502,590,506,562,88,56,0.8953387
46,2,car,501,589,506,562,88,56,0.8826827
47,2,car,501,589,506,562,88,56,0.868128
48,2,car,502,589,507,562,87,55,0.87911797
49,2,car,502,590,506,562,88,56,0.92112195
50,2,car,502,590,506,562,88,56,0.8553335
51,2,car,502,589,506,563,87,57,0.8359229
52,2,car,502,589,506,562,87,56,0.8541347
53,2,car,501,589,506,562,88,56,0.79819185
54,2,car,501,589,506,563,88,57,0.85617733
55,2,car,501,589,507,564,88,57,0.8935997
56,2,car,501,589,507,563,88,56,0.75885755
57,2,car,502,591,509,563,89,54,0.7096379
58,2,car,514,602,494,554,88,60,0.31047094
59,2,car,517,600,504,563,83,59,0.8491415
60,2,car,502,590,508,564,88,56,0.7944646
61,2,car,502,590,509,564,88,55,0.8253944
62,2,car,491,574,495,555,83,60,0.8099735
63,2,car,498,589,509,564,91,55,0.87746143
64,2,car,516,598,504,561,82,57,0.8511085
65,2,car,514,598,507,564,84,57,0.8401219
66,2,car,504,593,510,564,89,54,0.9110706
67,2,car,497,583,508,566,86,58,0.8351104
68,2,car,502,595,509,565,93,56,0.9387687
69,2,car,504,593,510,564,89,54,0.8912073
70,2,car,502,594,510,565,92,55,0.9285165
71,2,car,502,592,510,565,90,55,0.89384234
72,2,car,515,598,504,560,83,56,0.4257941
73,2,car,514,598,507,564,84,57,0.31927696
74,2,car,501,590,510,567,89,57,0.72163993
75,2,car,501,591,509,564,90,55,0.88262093
76,2,car,502,593,510,565,91,55,0.89309627
77,2,car,506,594,506,566,88,60,0.76903325
78,2,car,507,593,509,566,86,57,0.7786368
79,2,car,507,594,508,565,87,57,0.7380539
80,2,car,495,585,509,566,90,57,0.8718345
81,2,car,502,592,508,565,90,57,0.76711863
82,2,car,501,591,508,565,90,57,0.5544183
83,2,car,502,594,508,564,92,56,0.87572163
84,2,car,4294967271,1075,377,560,-4294966196,183,0.3504756
85,2,car,4294967278,1089,361,549,-4294966189,188,0.28828707
86,2,car,4294967277,1090,365,555,-4294966187,190,0.21405561
87,2,car,4294967294,1076,365,560,-4294966218,195,0.28676075
88,2,car,4294967275,1087,380,566,-4294966188,186,0.22077179
89,2,car,4294967273,1061,378,575,-4294966212,197,0.31963575
90,2,car,13,1082,373,578,1069,205,0.5401667
91,2,car,14,1056,383,578,1042,195,0.2695259
92,2,car,4294967270,1099,386,564,-4294966171,178,0.24828371
93,2,car,4294967286,966,380,574,-4294966320,194,0.26321974
0,2,car,503,590,507,563,87,56,0.91502047
1,2,car,503,590,507,564,87,57,0.88757277
2,2,car,501,589,508,564,88,56,0.8016756
3,2,car,502,591,510,564,89,54,0.9008823
4,2,car,515,599,498,557,84,59,0.7085072
5,2,car,516,601,501,558,85,57,0.5533195
6,2,car,514,603,493,553,89,60,0.2825035
7,2,car,515,600,501,557,85,56,0.7599205
8,2,car,514,598,492,550,84,58,0.43632865
9,2,car,515,598,508,565,83,57,0.47647023
10,2,car,506,590,510,564,84,54,0.83923197
11,2,car,506,590,510,565,84,55,0.9022778
12,2,car,506,591,509,564,85,55,0.8705986
13,2,car,505,591,508,564,86,56,0.8463685
14,2,car,506,590,508,564,84,56,0.8422107
15,2,car,507,590,509,563,83,54,0.78095347
16,2,car,507,590,508,565,83,57,0.700404
17,2,car,514,598,505,565,84,60,0.7235904
18,2,car,515,598,507,565,83,58,0.68271416
19,2,car,501,589,506,562,88,56,0.81126976
20,2,car,501,589,505,562,88,57,0.7960909
21,2,car,502,590,507,562,88,55,0.94661033
22,2,car,502,590,505,561,88,56,0.8724688
23,2,car,503,590,506,562,87,56,0.9390719
24,2,car,502,590,507,562,88,55,0.91756964
25,2,car,502,590,506,562,88,56,0.8507978
26,2,car,502,590,507,562,88,55,0.84904313
27,2,car,501,589,506,562,88,56,0.8766702
28,2,car,502,589,505,562,87,57,0.7969156
29,2,car,503,590,506,562,87,56,0.86517256
30,2,car,502,590,506,562,88,56,0.88858736
31,2,car,503,590,506,563,87,57,0.907217
32,2,car,502,590,505,561,88,56,0.86747587
33,2,car,502,589,506,562,87,56,0.87762594
34,2,car,501,589,506,562,88,56,0.8497129
35,2,car,501,589,505,562,88,57,0.8479053
36,2,car,502,590,505,562,88,57,0.8950311
37,2,car,502,590,507,562,88,55,0.9228381
38,2,car,502,589,505,561,87,56,0.90627426
39,2,car,502,590,505,562,88,57,0.8459921
40,2,car,503,590,506,562,87,56,0.8665674
41,2,car,501,589,505,561,88,56,0.88724774
42,2,car,502,590,505,561,88,56,0.84265935
43,2,car,503,590,507,562,87,55,0.910038
44,2,car,501,589,505,562,88,57,0.8158088
45,2,car,502,589,506,562,87,56,0.90897566
46,2,car,502,590,506,562,88,56,0.8953387
47,2,car,501,589,506,562,88,56,0.8826827
48,2,car,501,589,506,562,88,56,0.868128
49,2,car,502,589,507,562,87,55,0.87911797
50,2,car,502,590,506,562,88,56,0.92112195
51,2,car,502,590,506,562,88,56,0.8553335
52,2,car,502,589,506,563,87,57,0.8359229
53,2,car,502,589,506,562,87,56,0.8541347
54,2,car,501,589,506,562,88,56,0.79819185
55,2,car,501,589,506,563,88,57,0.85617733
56,2,car,501,589,507,564,88,57,0.8935997
57,2,car,501,589,507,563,88,56,0.75885755
58,2,car,502,591,509,563,89,54,0.7096379
59,2,car,514,602,494,554,88,60,0.31047094
60,2,car,517,600,504,563,83,59,0.8491415
61,2,car,502,590,508,564,88,56,0.7944646
62,2,car,502,590,509,564,88,55,0.8253944
63,2,car,491,574,495,555,83,60,0.8099735
64,2,car,498,589,509,564,91,55,0.87746143
65,2,car,516,598,504,561,82,57,0.8511085
66,2,car,514,598,507,564,84,57,0.8401219
67,2,car,504,593,510,564,89,54,0.9110706
68,2,car,497,583,508,566,86,58,0.8351104
69,2,car,502,595,509,565,93,56,0.9387687
70,2,car,504,593,510,564,89,54,0.8912073
71,2,car,502,594,510,565,92,55,0.9285165
72,2,car,502,592,510,565,90,55,0.89384234
73,2,car,515,598,504,560,83,56,0.4257941
74,2,car,514,598,507,564,84,57,0.31927696
75,2,car,501,590,510,567,89,57,0.72163993
76,2,car,501,591,509,564,90,55,0.88262093
77,2,car,502,593,510,565,91,55,0.89309627
78,2,car,506,594,506,566,88,60,0.76903325
79,2,car,507,593,509,566,86,57,0.7786368
80,2,car,507,594,508,565,87,57,0.7380539
81,2,car,495,585,509,566,90,57,0.8718345
82,2,car,502,592,508,565,90,57,0.76711863
83,2,car,501,591,508,565,90,57,0.5544183
84,2,car,502,594,508,564,92,56,0.87572163
85,2,car,4294967271,1075,377,560,-4294966196,183,0.3504756
86,2,car,4294967278,1089,361,549,-4294966189,188,0.28828707
87,2,car,4294967277,1090,365,555,-4294966187,190,0.21405561
88,2,car,4294967294,1076,365,560,-4294966218,195,0.28676075
89,2,car,4294967275,1087,380,566,-4294966188,186,0.22077179
90,2,car,4294967273,1061,378,575,-4294966212,197,0.31963575
91,2,car,13,1082,373,578,1069,205,0.5401667
92,2,car,14,1056,383,578,1042,195,0.2695259
93,2,car,4294967270,1099,386,564,-4294966171,178,0.24828371
94,2,car,4294967286,966,380,574,-4294966320,194,0.26321974
0,2,car,503,589,508,563,86,55,0.9123322
1,2,car,503,590,507,563,87,56,0.91502047
2,2,car,503,590,507,564,87,57,0.88757277
3,2,car,501,589,508,564,88,56,0.8016756
4,2,car,502,591,510,564,89,54,0.9008823
5,2,car,515,599,498,557,84,59,0.7085072
6,2,car,516,601,501,558,85,57,0.5533195
7,2,car,514,603,493,553,89,60,0.2825035
8,2,car,515,600,501,557,85,56,0.7599205
9,2,car,514,598,492,550,84,58,0.43632865
10,2,car,515,598,508,565,83,57,0.47647023
11,2,car,506,590,510,564,84,54,0.83923197
12,2,car,506,590,510,565,84,55,0.9022778
13,2,car,506,591,509,564,85,55,0.8705986
14,2,car,505,591,508,564,86,56,0.8463685
15,2,car,506,590,508,564,84,56,0.8422107
16,2,car,507,590,509,563,83,54,0.78095347
17,2,car,507,590,508,565,83,57,0.700404
18,2,car,514,598,505,565,84,60,0.7235904
19,2,car,515,598,507,565,83,58,0.68271416
20,2,car,501,589,506,562,88,56,0.81126976
21,2,car,501,589,505,562,88,57,0.7960909
22,2,car,502,590,507,562,88,55,0.94661033
23,2,car,502,590,505,561,88,56,0.8724688
24,2,car,503,590,506,562,87,56,0.9390719
25,2,car,502,590,507,562,88,55,0.91756964
26,2,car,502,590,506,562,88,56,0.8507978
27,2,car,502,590,507,562,88,55,0.84904313
28,2,car,501,589,506,562,88,56,0.8766702
29,2,car,502,589,505,562,87,57,0.7969156
30,2,car,503,590,506,562,87,56,0.86517256
31,2,car,502,590,506,562,88,56,0.88858736
32,2,car,503,590,506,563,87,57,0.907217
33,2,car,502,590,505,561,88,56,0.86747587
34,2,car,502,589,506,562,87,56,0.87762594
35,2,car,501,589,506,562,88,56,0.8497129
36,2,car,501,589,505,562,88,57,0.8479053
37,2,car,502,590,505,562,88,57,0.8950311
38,2,car,502,590,507,562,88,55,0.9228381
39,2,car,502,589,505,561,87,56,0.90627426
40,2,car,502,590,505,562,88,57,0.8459921
41,2,car,503,590,506,562,87,56,0.8665674
42,2,car,501,589,505,561,88,56,0.88724774
43,2,car,502,590,505,561,88,56,0.84265935
44,2,car,503,590,507,562,87,55,0.910038
45,2,car,501,589,505,562,88,57,0.8158088
46,2,car,502,589,506,562,87,56,0.90897566
47,2,car,502,590,506,562,88,56,0.8953387
48,2,car,501,589,506,562,88,56,0.8826827
49,2,car,501,589,506,562,88,56,0.868128
50,2,car,502,589,507,562,87,55,0.87911797
51,2,car,502,590,506,562,88,56,0.92112195
52,2,car,502,590,506,562,88,56,0.8553335
53,2,car,502,589,506,563,87,57,0.8359229
54,2,car,502,589,506,562,87,56,0.8541347
55,2,car,501,589,506,562,88,56,0.79819185
56,2,car,501,589,506,563,88,57,0.85617733
57,2,car,501,589,507,564,88,57,0.8935997
58,2,car,501,589,507,563,88,56,0.75885755
59,2,car,502,591,509,563,89,54,0.7096379
60,2,car,514,602,494,554,88,60,0.31047094
61,2,car,517,600,504,563,83,59,0.8491415
62,2,car,502,590,508,564,88,56,0.7944646
63,2,car,502,590,509,564,88,55,0.8253944
64,2,car,491,574,495,555,83,60,0.8099735
65,2,car,498,589,509,564,91,55,0.87746143
66,2,car,516,598,504,561,82,57,0.8511085
67,2,car,514,598,507,564,84,57,0.8401219
68,2,car,504,593,510,564,89,54,0.9110706
69,2,car,497,583,508,566,86,58,0.8351104
70,2,car,502,595,509,565,93,56,0.9387687
71,2,car,504,593,510,564,89,54,0.8912073
72,2,car,502,594,510,565,92,55,0.9285165
73,2,car,502,592,510,565,90,55,0.89384234
74,2,car,515,598,504,560,83,56,0.4257941
75,2,car,514,598,507,564,84,57,0.31927696
76,2,car,501,590,510,567,89,57,0.72163993
77,2,car,501,591,509,564,90,55,0.88262093
78,2,car,502,593,510,565,91,55,0.89309627
79,2,car,506,594,506,566,88,60,0.76903325
80,2,car,507,593,509,566,86,57,0.7786368
81,2,car,507,594,508,565,87,57,0.7380539
82,2,car,495,585,509,566,90,57,0.8718345
83,2,car,502,592,508,565,90,57,0.76711863
84,2,car,501,591,508,565,90,57,0.5544183
85,2,car,502,594,508,564,92,56,0.87572163
86,2,car,4294967271,1075,377,560,-4294966196,183,0.3504756
87,2,car,4294967278,1089,361,549,-4294966189,188,0.28828707
88,2,car,4294967277,1090,365,555,-4294966187,190,0.21405561
89,2,car,4294967294,1076,365,560,-4294966218,195,0.28676075
90,2,car,4294967275,1087,380,566,-4294966188,186,0.22077179
91,2,car,4294967273,1061,378,575,-4294966212,197,0.31963575
92,2,car,13,1082,373,578,1069,205,0.5401667
93,2,car,14,1056,383,578,1042,195,0.2695259
94,2,car,4294967270,1099,386,564,-4294966171,178,0.24828371
95,2,car,4294967286,966,380,574,-4294966320,194,0.26321974
0,2,car,504,589,508,563,85,55,0.898007
1,2,car,503,589,508,563,86,55,0.9123322
2,2,car,503,590,507,563,87,56,0.91502047
3,2,car,503,590,507,564,87,57,0.88757277
4,2,car,501,589,508,564,88,56,0.8016756
5,2,car,502,591,510,564,89,54,0.9008823
6,2,car,515,599,498,557,84,59,0.7085072
7,2,car,516,601,501,558,85,57,0.5533195
8,2,car,514,603,493,553,89,60,0.2825035
9,2,car,515,600,501,557,85,56,0.7599205
10,2,car,514,598,492,550,84,58,0.43632865
11,2,car,515,598,508,565,83,57,0.47647023
12,2,car,506,590,510,564,84,54,0.83923197
13,2,car,506,590,510,565,84,55,0.9022778
14,2,car,506,591,509,564,85,55,0.8705986
15,2,car,505,591,508,564,86,56,0.8463685
16,2,car,506,590,508,564,84,56,0.8422107
17,2,car,507,590,509,563,83,54,0.78095347
18,2,car,507,590,508,565,83,57,0.700404
19,2,car,514,598,505,565,84,60,0.7235904
20,2,car,515,598,507,565,83,58,0.68271416
21,2,car,501,589,506,562,88,56,0.81126976
22,2,car,501,589,505,562,88,57,0.7960909
23,2,car,502,590,507,562,88,55,0.94661033
24,2,car,502,590,505,561,88,56,0.8724688
25,2,car,503,590,506,562,87,56,0.9390719
26,2,car,502,590,507,562,88,55,0.91756964
27,2,car,502,590,506,562,88,56,0.8507978
28,2,car,502,590,507,562,88,55,0.84904313
29,2,car,501,589,506,562,88,56,0.8766702
30,2,car,502,589,505,562,87,57,0.7969156
31,2,car,503,590,506,562,87,56,0.86517256
32,2,car,502,590,506,562,88,56,0.88858736
33,2,car,503,590,506,563,87,57,0.907217
34,2,car,502,590,505,561,88,56,0.86747587
35,2,car,502,589,506,562,87,56,0.87762594
36,2,car,501,589,506,562,88,56,0.8497129
37,2,car,501,589,505,562,88,57,0.8479053
38,2,car,502,590,505,562,88,57,0.8950311
39,2,car,502,590,507,562,88,55,0.9228381
40,2,car,502,589,505,561,87,56,0.90627426
41,2,car,502,590,505,562,88,57,0.8459921
42,2,car,503,590,506,562,87,56,0.8665674
43,2,car,501,589,505,561,88,56,0.88724774
44,2,car,502,590,505,561,88,56,0.84265935
45,2,car,503,590,507,562,87,55,0.910038
46,2,car,501,589,505,562,88,57,0.8158088
47,2,car,502,589,506,562,87,56,0.90897566
48,2,car,502,590,506,562,88,56,0.8953387
49,2,car,501,589,506,562,88,56,0.8826827
50,2,car,501,589,506,562,88,56,0.868128
51,2,car,502,589,507,562,87,55,0.87911797
52,2,car,502,590,506,562,88,56,0.92112195
53,2,car,502,590,506,562,88,56,0.8553335
54,2,car,502,589,506,563,87,57,0.8359229
55,2,car,502,589,506,562,87,56,0.8541347
56,2,car,501,589,506,562,88,56,0.79819185
57,2,car,501,589,506,563,88,57,0.85617733
58,2,car,501,589,507,564,88,57,0.8935997
59,2,car,501,589,507,563,88,56,0.75885755
60,2,car,502,591,509,563,89,54,0.7096379
61,2,car,514,602,494,554,88,60,0.31047094
62,2,car,517,600,504,563,83,59,0.8491415
63,2,car,502,590,508,564,88,56,0.7944646
64,2,car,502,590,509,564,88,55,0.8253944
65,2,car,491,574,495,555,83,60,0.8099735
66,2,car,498,589,509,564,91,55,0.87746143
67,2,car,516,598,504,561,82,57,0.8511085
68,2,car,514,598,507,564,84,57,0.8401219
69,2,car,504,593,510,564,89,54,0.9110706
70,2,car,497,583,508,566,86,58,0.8351104
71,2,car,502,595,509,565,93,56,0.9387687
72,2,car,504,593,510,564,89,54,0.8912073
73,2,car,502,594,510,565,92,55,0.9285165
74,2,car,502,592,510,565,90,55,0.89384234
75,2,car,515,598,504,560,83,56,0.4257941
76,2,car,514,598,507,564,84,57,0.31927696
77,2,car,501,590,510,567,89,57,0.72163993
78,2,car,501,591,509,564,90,55,0.88262093
79,2,car,502,593,510,565,91,55,0.89309627
80,2,car,506,594,506,566,88,60,0.76903325
81,2,car,507,593,509,566,86,57,0.7786368
82,2,car,507,594,508,565,87,57,0.7380539
83,2,car,495,585,509,566,90,57,0.8718345
84,2,car,502,592,508,565,90,57,0.76711863
85,2,car,501,591,508,565,90,57,0.5544183
86,2,car,502,594,508,564,92,56,0.87572163
87,2,car,4294967271,1075,377,560,-4294966196,183,0.3504756
88,2,car,4294967278,1089,361,549,-4294966189,188,0.28828707
89,2,car,4294967277,1090,365,555,-4294966187,190,0.21405561
90,2,car,4294967294,1076,365,560,-4294966218,195,0.28676075
91,2,car,4294967275,1087,380,566,-4294966188,186,0.22077179
92,2,car,4294967273,1061,378,575,-4294966212,197,0.31963575
93,2,car,13,1082,373,578,1069,205,0.5401667
94,2,car,14,1056,383,578,1042,195,0.2695259
95,2,car,4294967270,1099,386,564,-4294966171,178,0.24828371
96,2,car,4294967286,966,380,574,-4294966320,194,0.26321974
0,2,car,503,589,507,563,86,56,0.8983436
1,2,car,504,589,508,563,85,55,0.898007
2,2,car,503,589,508,563,86,55,0.9123322
3,2,car,503,590,507,563,87,56,0.91502047
4,2,car,503,590,507,564,87,57,0.88757277
5,2,car,501,589,508,564,88,56,0.8016756
6,2,car,502,591,510,564,89,54,0.9008823
7,2,car,515,599,498,557,84,59,0.7085072
8,2,car,516,601,501,558,85,57,0.5533195
9,2,car,514,603,493,553,89,60,0.2825035
10,2,car,515,600,501,557,85,56,0.7599205
11,2,car,514,598,492,550,84,58,0.43632865
12,2,car,515,598,508,565,83,57,0.47647023
13,2,car,506,590,510,564,84,54,0.83923197
14,2,car,506,590,510,565,84,55,0.9022778
15,2,car,506,591,509,564,85,55,0.8705986
16,2,car,505,591,508,564,86,56,0.8463685
17,2,car,506,590,508,564,84,56,0.8422107
18,2,car,507,590,509,563,83,54,0.78095347
19,2,car,507,590,508,565,83,57,0.700404
20,2,car,514,598,505,565,84,60,0.7235904
21,2,car,515,598,507,565,83,58,0.68271416
22,2,car,501,589,506,562,88,56,0.81126976
23,2,car,501,589,505,562,88,57,0.7960909
24,2,car,502,590,507,562,88,55,0.94661033
25,2,car,502,590,505,561,88,56,0.8724688
26,2,car,503,590,506,562,87,56,0.9390719
27,2,car,502,590,507,562,88,55,0.91756964
28,2,car,502,590,506,562,88,56,0.8507978
29,2,car,502,590,507,562,88,55,0.84904313
30,2,car,501,589,506,562,88,56,0.8766702
31,2,car,502,589,505,562,87,57,0.7969156
32,2,car,503,590,506,562,87,56,0.86517256
33,2,car,502,590,506,562,88,56,0.88858736
34,2,car,503,590,506,563,87,57,0.907217
35,2,car,502,590,505,561,88,56,0.86747587
36,2,car,502,589,506,562,87,56,0.87762594
37,2,car,501,589,506,562,88,56,0.8497129
38,2,car,501,589,505,562,88,57,0.8479053
39,2,car,502,590,505,562,88,57,0.8950311
40,2,car,502,590,507,562,88,55,0.9228381
41,2,car,502,589,505,561,87,56,0.90627426
42,2,car,502,590,505,562,88,57,0.8459921
43,2,car,503,590,506,562,87,56,0.8665674
44,2,car,501,589,505,561,88,56,0.88724774
45,2,car,502,590,505,561,88,56,0.84265935
46,2,car,503,590,507,562,87,55,0.910038
47,2,car,501,589,505,562,88,57,0.8158088
48,2,car,502,589,506,562,87,56,0.90897566
49,2,car,502,590,506,562,88,56,0.8953387
50,2,car,501,589,506,562,88,56,0.8826827
51,2,car,501,589,506,562,88,56,0.868128
52,2,car,502,589,507,562,87,55,0.87911797
53,2,car,502,590,506,562,88,56,0.92112195
54,2,car,502,590,506,562,88,56,0.8553335
55,2,car,502,589,506,563,87,57,0.8359229
56,2,car,502,589,506,562,87,56,0.8541347
57,2,car,501,589,506,562,88,56,0.79819185
58,2,car,501,589,506,563,88,57,0.85617733
59,2,car,501,589,507,564,88,57,0.8935997
60,2,car,501,589,507,563,88,56,0.75885755
61,2,car,502,591,509,563,89,54,0.7096379
62,2,car,514,602,494,554,88,60,0.31047094
63,2,car,517,600,504,563,83,59,0.8491415
64,2,car,502,590,508,564,88,56,0.7944646
65,2,car,502,590,509,564,88,55,0.8253944
66,2,car,491,574,495,555,83,60,0.8099735
67,2,car,498,589,509,564,91,55,0.87746143
68,2,car,516,598,504,561,82,57,0.8511085
69,2,car,514,598,507,564,84,57,0.8401219
70,2,car,504,593,510,564,89,54,0.9110706
71,2,car,497,583,508,566,86,58,0.8351104
72,2,car,502,595,509,565,93,56,0.9387687
73,2,car,504,593,510,564,89,54,0.8912073
74,2,car,502,594,510,565,92,55,0.9285165
75,2,car,502,592,510,565,90,55,0.89384234
76,2,car,515,598,504,560,83,56,0.4257941
77,2,car,514,598,507,564,84,57,0.31927696
78,2,car,501,590,510,567,89,57,0.72163993
79,2,car,501,591,509,564,90,55,0.88262093
80,2,car,502,593,510,565,91,55,0.89309627
81,2,car,506,594,506,566,88,60,0.76903325
82,2,car,507,593,509,566,86,57,0.7786368
83,2,car,507,594,508,565,87,57,0.7380539
84,2,car,495,585,509,566,90,57,0.8718345
85,2,car,502,592,508,565,90,57,0.76711863
86,2,car,501,591,508,565,90,57,0.5544183
87,2,car,502,594,508,564,92,56,0.87572163
88,2,car,4294967271,1075,377,560,-4294966196,183,0.3504756
89,2,car,4294967278,1089,361,549,-4294966189,188,0.28828707
90,2,car,4294967277,1090,365,555,-4294966187,190,0.21405561
91,2,car,4294967294,1076,365,560,-4294966218,195,0.28676075
92,2,car,4294967275,1087,380,566,-4294966188,186,0.22077179
93,2,car,4294967273,1061,378,575,-4294966212,197,0.31963575
94,2,car,13,1082,373,578,1069,205,0.5401667
95,2,car,14,1056,383,578,1042,195,0.2695259
96,2,car,4294967270,1099,386,564,-4294966171,178,0.24828371
97,2,car,4294967286,966,380,574,-4294966320,194,0.26321974
0,2,car,503,589,507,563,86,56,0.9146501
1,2,car,503,589,507,563,86,56,0.8983436
2,2,car,504,589,508,563,85,55,0.898007
3,2,car,503,589,508,563,86,55,0.9123322
4,2,car,503,590,507,563,87,56,0.91502047
5,2,car,503,590,507,564,87,57,0.88757277
6,2,car,501,589,508,564,88,56,0.8016756
7,2,car,502,591,510,564,89,54,0.9008823
8,2,car,515,599,498,557,84,59,0.7085072
9,2,car,516,601,501,558,85,57,0.5533195
10,2,car,514,603,493,553,89,60,0.2825035
11,2,car,515,600,501,557,85,56,0.7599205
12,2,car,514,598,492,550,84,58,0.43632865
13,2,car,515,598,508,565,83,57,0.47647023
14,2,car,506,590,510,564,84,54,0.83923197
15,2,car,506,590,510,565,84,55,0.9022778
16,2,car,506,591,509,564,85,55,0.8705986
17,2,car,505,591,508,564,86,56,0.8463685
18,2,car,506,590,508,564,84,56,0.8422107
19,2,car,507,590,509,563,83,54,0.78095347
20,2,car,507,590,508,565,83,57,0.700404
21,2,car,514,598,505,565,84,60,0.7235904
22,2,car,515,598,507,565,83,58,0.68271416
23,2,car,501,589,506,562,88,56,0.81126976
24,2,car,501,589,505,562,88,57,0.7960909
25,2,car,502,590,507,562,88,55,0.94661033
26,2,car,502,590,505,561,88,56,0.8724688
27,2,car,503,590,506,562,87,56,0.9390719
28,2,car,502,590,507,562,88,55,0.91756964
29,2,car,502,590,506,562,88,56,0.8507978
30,2,car,502,590,507,562,88,55,0.84904313
31,2,car,501,589,506,562,88,56,0.8766702
32,2,car,502,589,505,562,87,57,0.7969156
33,2,car,503,590,506,562,87,56,0.86517256
34,2,car,502,590,506,562,88,56,0.88858736
35,2,car,503,590,506,563,87,57,0.907217
36,2,car,502,590,505,561,88,56,0.86747587
37,2,car,502,589,506,562,87,56,0.87762594
38,2,car,501,589,506,562,88,56,0.8497129
39,2,car,501,589,505,562,88,57,0.8479053
40,2,car,502,590,505,562,88,57,0.8950311
41,2,car,502,590,507,562,88,55,0.9228381
42,2,car,502,589,505,561,87,56,0.90627426
43,2,car,502,590,505,562,88,57,0.8459921
44,2,car,503,590,506,562,87,56,0.8665674
45,2,car,501,589,505,561,88,56,0.88724774
46,2,car,502,590,505,561,88,56,0.84265935
47,2,car,503,590,507,562,87,55,0.910038
48,2,car,501,589,505,562,88,57,0.8158088
49,2,car,502,589,506,562,87,56,0.90897566
50,2,car,502,590,506,562,88,56,0.8953387
51,2,car,501,589,506,562,88,56,0.8826827
52,2,car,501,589,506,562,88,56,0.868128
53,2,car,502,589,507,562,87,55,0.87911797
54,2,car,502,590,506,562,88,56,0.92112195
55,2,car,502,590,506,562,88,56,0.8553335
56,2,car,502,589,506,563,87,57,0.8359229
57,2,car,502,589,506,562,87,56,0.8541347
58,2,car,501,589,506,562,88,56,0.79819185
59,2,car,501,589,506,563,88,57,0.85617733
60,2,car,501,589,507,564,88,57,0.8935997
61,2,car,501,589,507,563,88,56,0.75885755
62,2,car,502,591,509,563,89,54,0.7096379
63,2,car,514,602,494,554,88,60,0.31047094
64,2,car,517,600,504,563,83,59,0.8491415
65,2,car,502,590,508,564,88,56,0.7944646
66,2,car,502,590,509,564,88,55,0.8253944
67,2,car,491,574,495,555,83,60,0.8099735
68,2,car,498,589,509,564,91,55,0.87746143
69,2,car,516,598,504,561,82,57,0.8511085
70,2,car,514,598,507,564,84,57,0.8401219
71,2,car,504,593,510,564,89,54,0.9110706
72,2,car,497,583,508,566,86,58,0.8351104
73,2,car,502,595,509,565,93,56,0.9387687
74,2,car,504,593,510,564,89,54,0.8912073
75,2,car,502,594,510,565,92,55,0.9285165
76,2,car,502,592,510,565,90,55,0.89384234
77,2,car,515,598,504,560,83,56,0.4257941
78,2,car,514,598,507,564,84,57,0.31927696
79,2,car,501,590,510,567,89,57,0.72163993
80,2,car,501,591,509,564,90,55,0.88262093
81,2,car,502,593,510,565,91,55,0.89309627
82,2,car,506,594,506,566,88,60,0.76903325
83,2,car,507,593,509,566,86,57,0.7786368
84,2,car,507,594,508,565,87,57,0.7380539
85,2,car,495,585,509,566,90,57,0.8718345
86,2,car,502,592,508,565,90,57,0.76711863
87,2,car,501,591,508,565,90,57,0.5544183
88,2,car,502,594,508,564,92,56,0.87572163
89,2,car,4294967271,1075,377,560,-4294966196,183,0.3504756
90,2,car,4294967278,1089,361,549,-4294966189,188,0.28828707
91,2,car,4294967277,1090,365,555,-4294966187,190,0.21405561
92,2,car,4294967294,1076,365,560,-4294966218,195,0.28676075
93,2,car,4294967275,1087,380,566,-4294966188,186,0.22077179
94,2,car,4294967273,1061,378,575,-4294966212,197,0.31963575
95,2,car,13,1082,373,578,1069,205,0.5401667
96,2,car,14,1056,383,578,1042,195,0.2695259
97,2,car,4294967270,1099,386,564,-4294966171,178,0.24828371
98,2,car,4294967286,966,380,574,-4294966320,194,0.26321974
0,2,car,504,589,506,562,85,56,0.8903001
1,2,car,503,589,507,563,86,56,0.9146501
2,2,car,503,589,507,563,86,56,0.8983436
3,2,car,504,589,508,563,85,55,0.898007
4,2,car,503,589,508,563,86,55,0.9123322
5,2,car,503,590,507,563,87,56,0.91502047
6,2,car,503,590,507,564,87,57,0.88757277
7,2,car,501,589,508,564,88,56,0.8016756
8,2,car,502,591,510,564,89,54,0.9008823
9,2,car,515,599,498,557,84,59,0.7085072
10,2,car,516,601,501,558,85,57,0.5533195
11,2,car,514,603,493,553,89,60,0.2825035
12,2,car,515,600,501,557,85,56,0.7599205
13,2,car,514,598,492,550,84,58,0.43632865
14,2,car,515,598,508,565,83,57,0.47647023
15,2,car,506,590,510,564,84,54,0.83923197
16,2,car,506,590,510,565,84,55,0.9022778
17,2,car,506,591,509,564,85,55,0.8705986
18,2,car,505,591,508,564,86,56,0.8463685
19,2,car,506,590,508,564,84,56,0.8422107
20,2,car,507,590,509,563,83,54,0.78095347
21,2,car,507,590,508,565,83,57,0.700404
22,2,car,514,598,505,565,84,60,0.7235904
23,2,car,515,598,507,565,83,58,0.68271416
24,2,car,501,589,506,562,88,56,0.81126976
25,2,car,501,589,505,562,88,57,0.7960909
26,2,car,502,590,507,562,88,55,0.94661033
27,2,car,502,590,505,561,88,56,0.8724688
28,2,car,503,590,506,562,87,56,0.9390719
29,2,car,502,590,507,562,88,55,0.91756964
30,2,car,502,590,506,562,88,56,0.8507978
31,2,car,502,590,507,562,88,55,0.84904313
32,2,car,501,589,506,562,88,56,0.8766702
33,2,car,502,589,505,562,87,57,0.7969156
34,2,car,503,590,506,562,87,56,0.86517256
35,2,car,502,590,506,562,88,56,0.88858736
36,2,car,503,590,506,563,87,57,0.907217
37,2,car,502,590,505,561,88,56,0.86747587
38,2,car,502,589,506,562,87,56,0.87762594
39,2,car,501,589,506,562,88,56,0.8497129
40,2,car,501,589,505,562,88,57,0.8479053
41,2,car,502,590,505,562,88,57,0.8950311
42,2,car,502,590,507,562,88,55,0.9228381
43,2,car,502,589,505,561,87,56,0.90627426
44,2,car,502,590,505,562,88,57,0.8459921
45,2,car,503,590,506,562,87,56,0.8665674
46,2,car,501,589,505,561,88,56,0.88724774
47,2,car,502,590,505,561,88,56,0.84265935
48,2,car,503,590,507,562,87,55,0.910038
49,2,car,501,589,505,562,88,57,0.8158088
50,2,car,502,589,506,562,87,56,0.90897566
51,2,car,502,590,506,562,88,56,0.8953387
52,2,car,501,589,506,562,88,56,0.8826827
53,2,car,501,589,506,562,88,56,0.868128
54,2,car,502,589,507,562,87,55,0.87911797
55,2,car,502,590,506,562,88,56,0.92112195
56,2,car,502,590,506,562,88,56,0.8553335
57,2,car,502,589,506,563,87,57,0.8359229
58,2,car,502,589,506,562,87,56,0.8541347
59,2,car,501,589,506,562,88,56,0.79819185
60,2,car,501,589,506,563,88,57,0.85617733
61,2,car,501,589,507,564,88,57,0.8935997
62,2,car,501,589,507,563,88,56,0.75885755
63,2,car,502,591,509,563,89,54,0.7096379
64,2,car,514,602,494,554,88,60,0.31047094
65,2,car,517,600,504,563,83,59,0.8491415
66,2,car,502,590,508,564,88,56,0.7944646
67,2,car,502,590,509,564,88,55,0.8253944
68,2,car,491,574,495,555,83,60,0.8099735
69,2,car,498,589,509,564,91,55,0.87746143
70,2,car,516,598,504,561,82,57,0.8511085
71,2,car,514,598,507,564,84,57,0.8401219
72,2,car,504,593,510,564,89,54,0.9110706
73,2,car,497,583,508,566,86,58,0.8351104
74,2,car,502,595,509,565,93,56,0.9387687
75,2,car,504,593,510,564,89,54,0.8912073
76,2,car,502,594,510,565,92,55,0.9285165
77,2,car,502,592,510,565,90,55,0.89384234
78,2,car,515,598,504,560,83,56,0.4257941
79,2,car,514,598,507,564,84,57,0.31927696
80,2,car,501,590,510,567,89,57,0.72163993
81,2,car,501,591,509,564,90,55,0.88262093
82,2,car,502,593,510,565,91,55,0.89309627
83,2,car,506,594,506,566,88,60,0.76903325
84,2,car,507,593,509,566,86,57,0.7786368
85,2,car,507,594,508,565,87,57,0.7380539
86,2,car,495,585,509,566,90,57,0.8718345
87,2,car,502,592,508,565,90,57,0.76711863
88,2,car,501,591,508,565,90,57,0.5544183
89,2,car,502,594,508,564,92,56,0.87572163
90,2,car,4294967271,1075,377,560,-4294966196,183,0.3504756
91,2,car,4294967278,1089,361,549,-4294966189,188,0.28828707
92,2,car,4294967277,1090,365,555,-4294966187,190,0.21405561
93,2,car,4294967294,1076,365,560,-4294966218,195,0.28676075
94,2,car,4294967275,1087,380,566,-4294966188,186,0.22077179
95,2,car,4294967273,1061,378,575,-4294966212,197,0.31963575
96,2,car,13,1082,373,578,1069,205,0.5401667
97,2,car,14,1056,383,578,1042,195,0.2695259
98,2,car,4294967270,1099,386,564,-4294966171,178,0.24828371
99,2,car,4294967286,966,380,574,-4294966320,194,0.26321974
0,2,car,502,588,507,563,86,56,0.87097466
1,2,car,504,589,506,562,85,56,0.8903001
2,2,car,503,589,507,563,86,56,0.9146501
3,2,car,503,589,507,563,86,56,0.8983436
4,2,car,504,589,508,563,85,55,0.898007
5,2,car,503,589,508,563,86,55,0.9123322
6,2,car,503,590,507,563,87,56,0.91502047
7,2,car,503,590,507,564,87,57,0.88757277
8,2,car,501,589,508,564,88,56,0.8016756
9,2,car,502,591,510,564,89,54,0.9008823
10,2,car,515,599,498,557,84,59,0.7085072
11,2,car,516,601,501,558,85,57,0.5533195
12,2,car,514,603,493,553,89,60,0.2825035
13,2,car,515,600,501,557,85,56,0.7599205
14,2,car,514,598,492,550,84,58,0.43632865
15,2,car,515,598,508,565,83,57,0.47647023
16,2,car,506,590,510,564,84,54,0.83923197
17,2,car,506,590,510,565,84,55,0.9022778
18,2,car,506,591,509,564,85,55,0.8705986
19,2,car,505,591,508,564,86,56,0.8463685
20,2,car,506,590,508,564,84,56,0.8422107
21,2,car,507,590,509,563,83,54,0.78095347
22,2,car,507,590,508,565,83,57,0.700404
23,2,car,514,598,505,565,84,60,0.7235904
24,2,car,515,598,507,565,83,58,0.68271416
25,2,car,501,589,506,562,88,56,0.81126976
26,2,car,501,589,505,562,88,57,0.7960909
27,2,car,502,590,507,562,88,55,0.94661033
28,2,car,502,590,505,561,88,56,0.8724688
29,2,car,503,590,506,562,87,56,0.9390719
30,2,car,502,590,507,562,88,55,0.91756964
31,2,car,502,590,506,562,88,56,0.8507978
32,2,car,502,590,507,562,88,55,0.84904313
33,2,car,501,589,506,562,88,56,0.8766702
34,2,car,502,589,505,562,87,57,0.7969156
35,2,car,503,590,506,562,87,56,0.86517256
36,2,car,502,590,506,562,88,56,0.88858736
37,2,car,503,590,506,563,87,57,0.907217
38,2,car,502,590,505,561,88,56,0.86747587
39,2,car,502,589,506,562,87,56,0.87762594
40,2,car,501,589,506,562,88,56,0.8497129
41,2,car,501,589,505,562,88,57,0.8479053
42,2,car,502,590,505,562,88,57,0.8950311
43,2,car,502,590,507,562,88,55,0.9228381
44,2,car,502,589,505,561,87,56,0.90627426
45,2,car,502,590,505,562,88,57,0.8459921
46,2,car,503,590,506,562,87,56,0.8665674
47,2,car,501,589,505,561,88,56,0.88724774
48,2,car,502,590,505,561,88,56,0.84265935
49,2,car,503,590,507,562,87,55,0.910038
50,2,car,501,589,505,562,88,57,0.8158088
51,2,car,502,589,506,562,87,56,0.90897566
52,2,car,502,590,506,562,88,56,0.8953387
53,2,car,501,589,506,562,88,56,0.8826827
54,2,car,501,589,506,562,88,56,0.868128
55,2,car,502,589,507,562,87,55,0.87911797
56,2,car,502,590,506,562,88,56,0.92112195
57,2,car,502,590,506,562,88,56,0.8553335
58,2,car,502,589,506,563,87,57,0.8359229
59,2,car,502,589,506,562,87,56,0.8541347
60,2,car,501,589,506,562,88,56,0.79819185
61,2,car,501,589,506,563,88,57,0.85617733
62,2,car,501,589,507,564,88,57,0.8935997
63,2,car,501,589,507,563,88,56,0.75885755
64,2,car,502,591,509,563,89,54,0.7096379
65,2,car,514,602,494,554,88,60,0.31047094
66,2,car,517,600,504,563,83,59,0.8491415
67,2,car,502,590,508,564,88,56,0.7944646
68,2,car,502,590,509,564,88,55,0.8253944
69,2,car,491,574,495,555,83,60,0.8099735
70,2,car,498,589,509,564,91,55,0.87746143
71,2,car,516,598,504,561,82,57,0.8511085
72,2,car,514,598,507,564,84,57,0.8401219
73,2,car,504,593,510,564,89,54,0.9110706
74,2,car,497,583,508,566,86,58,0.8351104
75,2,car,502,595,509,565,93,56,0.9387687
76,2,car,504,593,510,564,89,54,0.8912073
77,2,car,502,594,510,565,92,55,0.9285165
78,2,car,502,592,510,565,90,55,0.89384234
79,2,car,515,598,504,560,83,56,0.4257941
80,2,car,514,598,507,564,84,57,0.31927696
81,2,car,501,590,510,567,89,57,0.72163993
82,2,car,501,591,509,564,90,55,0.88262093
83,2,car,502,593,510,565,91,55,0.89309627
84,2,car,506,594,506,566,88,60,0.76903325
85,2,car,507,593,509,566,86,57,0.7786368
86,2,car,507,594,508,565,87,57,0.7380539
87,2,car,495,585,509,566,90,57,0.8718345
88,2,car,502,592,508,565,90,57,0.76711863
89,2,car,501,591,508,565,90,57,0.5544183
90,2,car,502,594,508,564,92,56,0.87572163
91,2,car,4294967271,1075,377,560,-4294966196,183,0.3504756
92,2,car,4294967278,1089,361,549,-4294966189,188,0.28828707
93,2,car,4294967277,1090,365,555,-4294966187,190,0.21405561
94,2,car,4294967294,1076,365,560,-4294966218,195,0.28676075
95,2,car,4294967275,1087,380,566,-4294966188,186,0.22077179
96,2,car,4294967273,1061,378,575,-4294966212,197,0.31963575
97,2,car,13,1082,373,578,1069,205,0.5401667
98,2,car,14,1056,383,578,1042,195,0.2695259
99,2,car,4294967270,1099,386,564,-4294966171,178,0.24828371
100,2,car,4294967286,966,380,574,-4294966320,194,0.26321974
0,2,car,503,589,506,562,86,56,0.90716016
1,2,car,502,588,507,563,86,56,0.87097466
2,2,car,504,589,506,562,85,56,0.8903001
3,2,car,503,589,507,563,86,56,0.9146501
4,2,car,503,589,507,563,86,56,0.8983436
5,2,car,504,589,508,563,85,55,0.898007
6,2,car,503,589,508,563,86,55,0.9123322
7,2,car,503,590,507,563,87,56,0.91502047
8,2,car,503,590,507,564,87,57,0.88757277
9,2,car,501,589,508,564,88,56,0.8016756
10,2,car,502,591,510,564,89,54,0.9008823
11,2,car,515,599,498,557,84,59,0.7085072
12,2,car,516,601,501,558,85,57,0.5533195
13,2,car,514,603,493,553,89,60,0.2825035
14,2,car,515,600,501,557,85,56,0.7599205
15,2,car,514,598,492,550,84,58,0.43632865
16,2,car,515,598,508,565,83,57,0.47647023
17,2,car,506,590,510,564,84,54,0.83923197
18,2,car,506,590,510,565,84,55,0.9022778
19,2,car,506,591,509,564,85,55,0.8705986
20,2,car,505,591,508,564,86,56,0.8463685
21,2,car,506,590,508,564,84,56,0.8422107
22,2,car,507,590,509,563,83,54,0.78095347
23,2,car,507,590,508,565,83,57,0.700404
24,2,car,514,598,505,565,84,60,0.7235904
25,2,car,515,598,507,565,83,58,0.68271416
26,2,car,501,589,506,562,88,56,0.81126976
27,2,car,501,589,505,562,88,57,0.7960909
28,2,car,502,590,507,562,88,55,0.94661033
29,2,car,502,590,505,561,88,56,0.8724688
30,2,car,503,590,506,562,87,56,0.9390719
31,2,car,502,590,507,562,88,55,0.91756964
32,2,car,502,590,506,562,88,56,0.8507978
33,2,car,502,590,507,562,88,55,0.84904313
34,2,car,501,589,506,562,88,56,0.8766702
35,2,car,502,589,505,562,87,57,0.7969156
36,2,car,503,590,506,562,87,56,0.86517256
37,2,car,502,590,506,562,88,56,0.88858736
38,2,car,503,590,506,563,87,57,0.907217
39,2,car,502,590,505,561,88,56,0.86747587
40,2,car,502,589,506,562,87,56,0.87762594
41,2,car,501,589,506,562,88,56,0.8497129
42,2,car,501,589,505,562,88,57,0.8479053
43,2,car,502,590,505,562,88,57,0.8950311
44,2,car,502,590,507,562,88,55,0.9228381
45,2,car,502,589,505,561,87,56,0.90627426
46,2,car,502,590,505,562,88,57,0.8459921
47,2,car,503,590,506,562,87,56,0.8665674
48,2,car,501,589,505,561,88,56,0.88724774
49,2,car,502,590,505,561,88,56,0.84265935
50,2,car,503,590,507,562,87,55,0.910038
51,2,car,501,589,505,562,88,57,0.8158088
52,2,car,502,589,506,562,87,56,0.90897566
53,2,car,502,590,506,562,88,56,0.8953387
54,2,car,501,589,506,562,88,56,0.8826827
55,2,car,501,589,506,562,88,56,0.868128
56,2,car,502,589,507,562,87,55,0.87911797
57,2,car,502,590,506,562,88,56,0.92112195
58,2,car,502,590,506,562,88,56,0.8553335
59,2,car,502,589,506,563,87,57,0.8359229
60,2,car,502,589,506,562,87,56,0.8541347
61,2,car,501,589,506,562,88,56,0.79819185
62,2,car,501,589,506,563,88,57,0.85617733
63,2,car,501,589,507,564,88,57,0.8935997
64,2,car,501,589,507,563,88,56,0.75885755
65,2,car,502,591,509,563,89,54,0.7096379
66,2,car,514,602,494,554,88,60,0.31047094
67,2,car,517,600,504,563,83,59,0.8491415
68,2,car,502,590,508,564,88,56,0.7944646
69,2,car,502,590,509,564,88,55,0.8253944
70,2,car,491,574,495,555,83,60,0.8099735
71,2,car,498,589,509,564,91,55,0.87746143
72,2,car,516,598,504,561,82,57,0.8511085
73,2,car,514,598,507,564,84,57,0.8401219
74,2,car,504,593,510,564,89,54,0.9110706
75,2,car,497,583,508,566,86,58,0.8351104
76,2,car,502,595,509,565,93,56,0.9387687
77,2,car,504,593,510,564,89,54,0.8912073
78,2,car,502,594,510,565,92,55,0.9285165
79,2,car,502,592,510,565,90,55,0.89384234
80,2,car,515,598,504,560,83,56,0.4257941
81,2,car,514,598,507,564,84,57,0.31927696
82,2,car,501,590,510,567,89,57,0.72163993
83,2,car,501,591,509,564,90,55,0.88262093
84,2,car,502,593,510,565,91,55,0.89309627
85,2,car,506,594,506,566,88,60,0.76903325
86,2,car,507,593,509,566,86,57,0.7786368
87,2,car,507,594,508,565,87,57,0.7380539
88,2,car,495,585,509,566,90,57,0.8718345
89,2,car,502,592,508,565,90,57,0.76711863
90,2,car,501,591,508,565,90,57,0.5544183
91,2,car,502,594,508,564,92,56,0.87572163
92,2,car,4294967271,1075,377,560,-4294966196,183,0.3504756
93,2,car,4294967278,1089,361,549,-4294966189,188,0.28828707
94,2,car,4294967277,1090,365,555,-4294966187,190,0.21405561
95,2,car,4294967294,1076,365,560,-4294966218,195,0.28676075
96,2,car,4294967275,1087,380,566,-4294966188,186,0.22077179
97,2,car,4294967273,1061,378,575,-4294966212,197,0.31963575
98,2,car,13,1082,373,578,1069,205,0.5401667
99,2,car,14,1056,383,578,1042,195,0.2695259
100,2,car,4294967270,1099,386,564,-4294966171,178,0.24828371
101,2,car,4294967286,966,380,574,-4294966320,194,0.26321974
0,2,car,503,589,508,563,86,55,0.90133715
1,2,car,503,589,506,562,86,56,0.90716016
2,2,car,502,588,507,563,86,56,0.87097466
3,2,car,504,589,506,562,85,56,0.8903001
4,2,car,503,589,507,563,86,56,0.9146501
5,2,car,503,589,507,563,86,56,0.8983436
6,2,car,504,589,508,563,85,55,0.898007
7,2,car,503,589,508,563,86,55,0.9123322
8,2,car,503,590,507,563,87,56,0.91502047
9,2,car,503,590,507,564,87,57,0.88757277
10,2,car,501,589,508,564,88,56,0.8016756
11,2,car,502,591,510,564,89,54,0.9008823
12,2,car,515,599,498,557,84,59,0.7085072
13,2,car,516,601,501,558,85,57,0.5533195
14,2,car,514,603,493,553,89,60,0.2825035
15,2,car,515,600,501,557,85,56,0.7599205
16,2,car,514,598,492,550,84,58,0.43632865
17,2,car,515,598,508,565,83,57,0.47647023
18,2,car,506,590,510,564,84,54,0.83923197
19,2,car,506,590,510,565,84,55,0.9022778
20,2,car,506,591,509,564,85,55,0.8705986
21,2,car,505,591,508,564,86,56,0.8463685
22,2,car,506,590,508,564,84,56,0.8422107
23,2,car,507,590,509,563,83,54,0.78095347
24,2,car,507,590,508,565,83,57,0.700404
25,2,car,514,598,505,565,84,60,0.7235904
26,2,car,515,598,507,565,83,58,0.68271416
27,2,car,501,589,506,562,88,56,0.81126976
28,2,car,501,589,505,562,88,57,0.7960909
29,2,car,502,590,507,562,88,55,0.94661033
30,2,car,502,590,505,561,88,56,0.8724688
31,2,car,503,590,506,562,87,56,0.9390719
32,2,car,502,590,507,562,88,55,0.91756964
33,2,car,502,590,506,562,88,56,0.8507978
34,2,car,502,590,507,562,88,55,0.84904313
35,2,car,501,589,506,562,88,56,0.8766702
36,2,car,502,589,505,562,87,57,0.7969156
37,2,car,503,590,506,562,87,56,0.86517256
38,2,car,502,590,506,562,88,56,0.88858736
39,2,car,503,590,506,563,87,57,0.907217
40,2,car,502,590,505,561,88,56,0.86747587
41,2,car,502,589,506,562,87,56,0.87762594
42,2,car,501,589,506,562,88,56,0.8497129
43,2,car,501,589,505,562,88,57,0.8479053
44,2,car,502,590,505,562,88,57,0.8950311
45,2,car,502,590,507,562,88,55,0.9228381
46,2,car,502,589,505,561,87,56,0.90627426
47,2,car,502,590,505,562,88,57,0.8459921
48,2,car,503,590,506,562,87,56,0.8665674
49,2,car,501,589,505,561,88,56,0.88724774
50,2,car,502,590,505,561,88,56,0.84265935
51,2,car,503,590,507,562,87,55,0.910038
52,2,car,501,589,505,562,88,57,0.8158088
53,2,car,502,589,506,562,87,56,0.90897566
54,2,car,502,590,506,562,88,56,0.8953387
55,2,car,501,589,506,562,88,56,0.8826827
56,2,car,501,589,506,562,88,56,0.868128
57,2,car,502,589,507,562,87,55,0.87911797
58,2,car,502,590,506,562,88,56,0.92112195
59,2,car,502,590,506,562,88,56,0.8553335
60,2,car,502,589,506,563,87,57,0.8359229
61,2,car,502,589,506,562,87,56,0.8541347
62,2,car,501,589,506,562,88,56,0.79819185
63,2,car,501,589,506,563,88,57,0.85617733
64,2,car,501,589,507,564,88,57,0.8935997
65,2,car,501,589,507,563,88,56,0.75885755
66,2,car,502,591,509,563,89,54,0.7096379
67,2,car,514,602,494,554,88,60,0.31047094
68,2,car,517,600,504,563,83,59,0.8491415
69,2,car,502,590,508,564,88,56,0.7944646
70,2,car,502,590,509,564,88,55,0.8253944
71,2,car,491,574,495,555,83,60,0.8099735
72,2,car,498,589,509,564,91,55,0.87746143
73,2,car,516,598,504,561,82,57,0.8511085
74,2,car,514,598,507,564,84,57,0.8401219
75,2,car,504,593,510,564,89,54,0.9110706
76,2,car,497,583,508,566,86,58,0.8351104
77,2,car,502,595,509,565,93,56,0.9387687
78,2,car,504,593,510,564,89,54,0.8912073
79,2,car,502,594,510,565,92,55,0.9285165
80,2,car,502,592,510,565,90,55,0.89384234
81,2,car,515,598,504,560,83,56,0.4257941
82,2,car,514,598,507,564,84,57,0.31927696
83,2,car,501,590,510,567,89,57,0.72163993
84,2,car,501,591,509,564,90,55,0.88262093
85,2,car,502,593,510,565,91,55,0.89309627
86,2,car,506,594,506,566,88,60,0.76903325
87,2,car,507,593,509,566,86,57,0.7786368
88,2,car,507,594,508,565,87,57,0.7380539
89,2,car,495,585,509,566,90,57,0.8718345
90,2,car,502,592,508,565,90,57,0.76711863
91,2,car,501,591,508,565,90,57,0.5544183
92,2,car,502,594,508,564,92,56,0.87572163
93,2,car,4294967271,1075,377,560,-4294966196,183,0.3504756
94,2,car,4294967278,1089,361,549,-4294966189,188,0.28828707
95,2,car,4294967277,1090,365,555,-4294966187,190,0.21405561
96,2,car,4294967294,1076,365,560,-4294966218,195,0.28676075
97,2,car,4294967275,1087,380,566,-4294966188,186,0.22077179
98,2,car,4294967273,1061,378,575,-4294966212,197,0.31963575
99,2,car,13,1082,373,578,1069,205,0.5401667
100,2,car,14,1056,383,578,1042,195,0.2695259
101,2,car,4294967270,1099,386,564,-4294966171,178,0.24828371
102,2,car,4294967286,966,380,574,-4294966320,194,0.26321974
0,2,car,503,588,507,563,85,56,0.9239149
1,2,car,503,589,508,563,86,55,0.90133715
2,2,car,503,589,506,562,86,56,0.90716016
3,2,car,502,588,507,563,86,56,0.87097466
4,2,car,504,589,506,562,85,56,0.8903001
5,2,car,503,589,507,563,86,56,0.9146501
6,2,car,503,589,507,563,86,56,0.8983436
7,2,car,504,589,508,563,85,55,0.898007
8,2,car,503,589,508,563,86,55,0.9123322
9,2,car,503,590,507,563,87,56,0.91502047
10,2,car,503,590,507,564,87,57,0.88757277
11,2,car,501,589,508,564,88,56,0.8016756
12,2,car,502,591,510,564,89,54,0.9008823
13,2,car,515,599,498,557,84,59,0.7085072
14,2,car,516,601,501,558,85,57,0.5533195
15,2,car,514,603,493,553,89,60,0.2825035
16,2,car,515,600,501,557,85,56,0.7599205
17,2,car,514,598,492,550,84,58,0.43632865
18,2,car,515,598,508,565,83,57,0.47647023
19,2,car,506,590,510,564,84,54,0.83923197
20,2,car,506,590,510,565,84,55,0.9022778
21,2,car,506,591,509,564,85,55,0.8705986
22,2,car,505,591,508,564,86,56,0.8463685
23,2,car,506,590,508,564,84,56,0.8422107
24,2,car,507,590,509,563,83,54,0.78095347
25,2,car,507,590,508,565,83,57,0.700404
26,2,car,514,598,505,565,84,60,0.7235904
27,2,car,515,598,507,565,83,58,0.68271416
28,2,car,501,589,506,562,88,56,0.81126976
29,2,car,501,589,505,562,88,57,0.7960909
30,2,car,502,590,507,562,88,55,0.94661033
31,2,car,502,590,505,561,88,56,0.8724688
32,2,car,503,590,506,562,87,56,0.9390719
33,2,car,502,590,507,562,88,55,0.91756964
34,2,car,502,590,506,562,88,56,0.8507978
35,2,car,502,590,507,562,88,55,0.84904313
36,2,car,501,589,506,562,88,56,0.8766702
37,2,car,502,589,505,562,87,57,0.7969156
38,2,car,503,590,506,562,87,56,0.86517256
39,2,car,502,590,506,562,88,56,0.88858736
40,2,car,503,590,506,563,87,57,0.907217
41,2,car,502,590,505,561,88,56,0.86747587
42,2,car,502,589,506,562,87,56,0.87762594
43,2,car,501,589,506,562,88,56,0.8497129
44,2,car,501,589,505,562,88,57,0.8479053
45,2,car,502,590,505,562,88,57,0.8950311
46,2,car,502,590,507,562,88,55,0.9228381
47,2,car,502,589,505,561,87,56,0.90627426
48,2,car,502,590,505,562,88,57,0.8459921
49,2,car,503,590,506,562,87,56,0.8665674
50,2,car,501,589,505,561,88,56,0.88724774
51,2,car,502,590,505,561,88,56,0.84265935
52,2,car,503,590,507,562,87,55,0.910038
53,2,car,501,589,505,562,88,57,0.8158088
54,2,car,502,589,506,562,87,56,0.90897566
55,2,car,502,590,506,562,88,56,0.8953387
56,2,car,501,589,506,562,88,56,0.8826827
57,2,car,501,589,506,562,88,56,0.868128
58,2,car,502,589,507,562,87,55,0.87911797
59,2,car,502,590,506,562,88,56,0.92112195
60,2,car,502,590,506,562,88,56,0.8553335
61,2,car,502,589,506,563,87,57,0.8359229
62,2,car,502,589,506,562,87,56,0.8541347
63,2,car,501,589,506,562,88,56,0.79819185
64,2,car,501,589,506,563,88,57,0.85617733
65,2,car,501,589,507,564,88,57,0.8935997
66,2,car,501,589,507,563,88,56,0.75885755
67,2,car,502,591,509,563,89,54,0.7096379
68,2,car,514,602,494,554,88,60,0.31047094
69,2,car,517,600,504,563,83,59,0.8491415
70,2,car,502,590,508,564,88,56,0.7944646
71,2,car,502,590,509,564,88,55,0.8253944
72,2,car,491,574,495,555,83,60,0.8099735
73,2,car,498,589,509,564,91,55,0.87746143
74,2,car,516,598,504,561,82,57,0.8511085
75,2,car,514,598,507,564,84,57,0.8401219
76,2,car,504,593,510,564,89,54,0.9110706
77,2,car,497,583,508,566,86,58,0.8351104
78,2,car,502,595,509,565,93,56,0.9387687
79,2,car,504,593,510,564,89,54,0.8912073
80,2,car,502,594,510,565,92,55,0.9285165
81,2,car,502,592,510,565,90,55,0.89384234
82,2,car,515,598,504,560,83,56,0.4257941
83,2,car,514,598,507,564,84,57,0.31927696
84,2,car,501,590,510,567,89,57,0.72163993
85,2,car,501,591,509,564,90,55,0.88262093
86,2,car,502,593,510,565,91,55,0.89309627
87,2,car,506,594,506,566,88,60,0.76903325
88,2,car,507,593,509,566,86,57,0.7786368
89,2,car,507,594,508,565,87,57,0.7380539
90,2,car,495,585,509,566,90,57,0.8718345
91,2,car,502,592,508,565,90,57,0.76711863
92,2,car,501,591,508,565,90,57,0.5544183
93,2,car,502,594,508,564,92,56,0.87572163
94,2,car,4294967271,1075,377,560,-4294966196,183,0.3504756
95,2,car,4294967278,1089,361,549,-4294966189,188,0.28828707
96,2,car,4294967277,1090,365,555,-4294966187,190,0.21405561
97,2,car,4294967294,1076,365,560,-4294966218,195,0.28676075
98,2,car,4294967275,1087,380,566,-4294966188,186,0.22077179
99,2,car,4294967273,1061,378,575,-4294966212,197,0.31963575
100,2,car,13,1082,373,578,1069,205,0.5401667
101,2,car,14,1056,383,578,1042,195,0.2695259
102,2,car,4294967270,1099,386,564,-4294966171,178,0.24828371
103,2,car,4294967286,966,380,574,-4294966320,194,0.26321974
0,2,car,503,589,508,563,86,55,0.9142641
1,2,car,503,588,507,563,85,56,0.9239149
2,2,car,503,589,508,563,86,55,0.90133715
3,2,car,503,589,506,562,86,56,0.90716016
4,2,car,502,588,507,563,86,56,0.87097466
5,2,car,504,589,506,562,85,56,0.8903001
6,2,car,503,589,507,563,86,56,0.9146501
7,2,car,503,589,507,563,86,56,0.8983436
8,2,car,504,589,508,563,85,55,0.898007
9,2,car,503,589,508,563,86,55,0.9123322
10,2,car,503,590,507,563,87,56,0.91502047
11,2,car,503,590,507,564,87,57,0.88757277
12,2,car,501,589,508,564,88,56,0.8016756
13,2,car,502,591,510,564,89,54,0.9008823
14,2,car,515,599,498,557,84,59,0.7085072
15,2,car,516,601,501,558,85,57,0.5533195
16,2,car,514,603,493,553,89,60,0.2825035
17,2,car,515,600,501,557,85,56,0.7599205
18,2,car,514,598,492,550,84,58,0.43632865
19,2,car,515,598,508,565,83,57,0.47647023
20,2,car,506,590,510,564,84,54,0.83923197
21,2,car,506,590,510,565,84,55,0.9022778
22,2,car,506,591,509,564,85,55,0.8705986
23,2,car,505,591,508,564,86,56,0.8463685
24,2,car,506,590,508,564,84,56,0.8422107
25,2,car,507,590,509,563,83,54,0.78095347
26,2,car,507,590,508,565,83,57,0.700404
27,2,car,514,598,505,565,84,60,0.7235904
28,2,car,515,598,507,565,83,58,0.68271416
29,2,car,501,589,506,562,88,56,0.81126976
30,2,car,501,589,505,562,88,57,0.7960909
31,2,car,502,590,507,562,88,55,0.94661033
32,2,car,502,590,505,561,88,56,0.8724688
33,2,car,503,590,506,562,87,56,0.9390719
34,2,car,502,590,507,562,88,55,0.91756964
35,2,car,502,590,506,562,88,56,0.8507978
36,2,car,502,590,507,562,88,55,0.84904313
37,2,car,501,589,506,562,88,56,0.8766702
38,2,car,502,589,505,562,87,57,0.7969156
39,2,car,503,590,506,562,87,56,0.86517256
40,2,car,502,590,506,562,88,56,0.88858736
41,2,car,503,590,506,563,87,57,0.907217
42,2,car,502,590,505,561,88,56,0.86747587
43,2,car,502,589,506,562,87,56,0.87762594
44,2,car,501,589,506,562,88,56,0.8497129
45,2,car,501,589,505,562,88,57,0.8479053
46,2,car,502,590,505,562,88,57,0.8950311
47,2,car,502,590,507,562,88,55,0.9228381
48,2,car,502,589,505,561,87,56,0.90627426
49,2,car,502,590,505,562,88,57,0.8459921
50,2,car,503,590,506,562,87,56,0.8665674
51,2,car,501,589,505,561,88,56,0.88724774
52,2,car,502,590,505,561,88,56,0.84265935
53,2,car,503,590,507,562,87,55,0.910038
54,2,car,501,589,505,562,88,57,0.8158088
55,2,car,502,589,506,562,87,56,0.90897566
56,2,car,502,590,506,562,88,56,0.8953387
57,2,car,501,589,506,562,88,56,0.8826827
58,2,car,501,589,506,562,88,56,0.868128
59,2,car,502,589,507,562,87,55,0.87911797
60,2,car,502,590,506,562,88,56,0.92112195
61,2,car,502,590,506,562,88,56,0.8553335
62,2,car,502,589,506,563,87,57,0.8359229
63,2,car,502,589,506,562,87,56,0.8541347
64,2,car,501,589,506,562,88,56,0.79819185
65,2,car,501,589,506,563,88,57,0.85617733
66,2,car,501,589,507,564,88,57,0.8935997
67,2,car,501,589,507,563,88,56,0.75885755
68,2,car,502,591,509,563,89,54,0.7096379
69,2,car,514,602,494,554,88,60,0.31047094
70,2,car,517,600,504,563,83,59,0.8491415
71,2,car,502,590,508,564,88,56,0.7944646
72,2,car,502,590,509,564,88,55,0.8253944
73,2,car,491,574,495,555,83,60,0.8099735
74,2,car,498,589,509,564,91,55,0.87746143
75,2,car,516,598,504,561,82,57,0.8511085
76,2,car,514,598,507,564,84,57,0.8401219
77,2,car,504,593,510,564,89,54,0.9110706
78,2,car,497,583,508,566,86,58,0.8351104
79,2,car,502,595,509,565,93,56,0.9387687
80,2,car,504,593,510,564,89,54,0.8912073
81,2,car,502,594,510,565,92,55,0.9285165
82,2,car,502,592,510,565,90,55,0.89384234
83,2,car,515,598,504,560,83,56,0.4257941
84,2,car,514,598,507,564,84,57,0.31927696
85,2,car,501,590,510,567,89,57,0.72163993
86,2,car,501,591,509,564,90,55,0.88262093
87,2,car,502,593,510,565,91,55,0.89309627
88,2,car,506,594,506,566,88,60,0.76903325
89,2,car,507,593,509,566,86,57,0.7786368
90,2,car,507,594,508,565,87,57,0.7380539
91,2,car,495,585,509,566,90,57,0.8718345
92,2,car,502,592,508,565,90,57,0.76711863
93,2,car,501,591,508,565,90,57,0.5544183
94,2,car,502,594,508,564,92,56,0.87572163
95,2,car,4294967271,1075,377,560,-4294966196,183,0.3504756
96,2,car,4294967278,1089,361,549,-4294966189,188,0.28828707
97,2,car,4294967277,1090,365,555,-4294966187,190,0.21405561
98,2,car,4294967294,1076,365,560,-4294966218,195,0.28676075
99,2,car,4294967275,1087,380,566,-4294966188,186,0.22077179
100,2,car,4294967273,1061,378,575,-4294966212,197,0.31963575
101,2,car,13,1082,373,578,1069,205,0.5401667
102,2,car,14,1056,383,578,1042,195,0.2695259
103,2,car,4294967270,1099,386,564,-4294966171,178,0.24828371
104,2,car,4294967286,966,380,574,-4294966320,194,0.26321974
