,cid,label,vehicle,left,right,top,bottom,width,height,score,distance_estimate,angle_estimate,real_distance,ratio,elapsed_time
0,2,car,crv,580,1118,412,736,538,324,0.97944313,3,30,3,0.6022304832713755,
0,2,car,crv,585,1120,414,732,535,318,0.9790969,3,30,3,0.594392523364486,
1,2,car,crv,580,1118,412,736,538,324,0.97944313,3,30,3,0.6022304832713755,
0,2,car,crv,576,1114,415,729,538,314,0.9831566,3,30,3,0.5836431226765799,
1,2,car,crv,585,1120,414,732,535,318,0.9790969,3,30,3,0.594392523364486,
2,2,car,crv,580,1118,412,736,538,324,0.97944313,3,30,3,0.6022304832713755,
0,2,car,crv,677,1123,458,686,446,228,0.93931526,3,30,3,0.5112107623318386,
1,2,car,crv,576,1114,415,729,538,314,0.9831566,3,30,3,0.5836431226765799,
2,2,car,crv,585,1120,414,732,535,318,0.9790969,3,30,3,0.594392523364486,
3,2,car,crv,580,1118,412,736,538,324,0.97944313,3,30,3,0.6022304832713755,
0,2,car,crv,658,1104,451,682,446,231,0.9144128,3,30,3,0.5179372197309418,
1,2,car,crv,677,1123,458,686,446,228,0.93931526,3,30,3,0.5112107623318386,
2,2,car,crv,576,1114,415,729,538,314,0.9831566,3,30,3,0.5836431226765799,
3,2,car,crv,585,1120,414,732,535,318,0.9790969,3,30,3,0.594392523364486,
4,2,car,crv,580,1118,412,736,538,324,0.97944313,3,30,3,0.6022304832713755,
0,2,car,crv,657,1104,453,676,447,223,0.93199766,3,30,3,0.4988814317673378,
1,2,car,crv,658,1104,451,682,446,231,0.9144128,3,30,3,0.5179372197309418,
2,2,car,crv,677,1123,458,686,446,228,0.93931526,3,30,3,0.5112107623318386,
3,2,car,crv,576,1114,415,729,538,314,0.9831566,3,30,3,0.5836431226765799,
4,2,car,crv,585,1120,414,732,535,318,0.9790969,3,30,3,0.594392523364486,
5,2,car,crv,580,1118,412,736,538,324,0.97944313,3,30,3,0.6022304832713755,
0,2,car,crv,682,1118,457,688,436,231,0.906731,3,30,3,0.5298165137614679,
1,2,car,crv,657,1104,453,676,447,223,0.93199766,3,30,3,0.4988814317673378,
2,2,car,crv,658,1104,451,682,446,231,0.9144128,3,30,3,0.5179372197309418,
3,2,car,crv,677,1123,458,686,446,228,0.93931526,3,30,3,0.5112107623318386,
4,2,car,crv,576,1114,415,729,538,314,0.9831566,3,30,3,0.5836431226765799,
5,2,car,crv,585,1120,414,732,535,318,0.9790969,3,30,3,0.594392523364486,
6,2,car,crv,580,1118,412,736,538,324,0.97944313,3,30,3,0.6022304832713755,
0,2,car,crv,679,1126,457,685,447,228,0.93751395,3,30,3,0.5100671140939598,
1,2,car,crv,682,1118,457,688,436,231,0.906731,3,30,3,0.5298165137614679,
2,2,car,crv,657,1104,453,676,447,223,0.93199766,3,30,3,0.4988814317673378,
3,2,car,crv,658,1104,451,682,446,231,0.9144128,3,30,3,0.5179372197309418,
4,2,car,crv,677,1123,458,686,446,228,0.93931526,3,30,3,0.5112107623318386,
5,2,car,crv,576,1114,415,729,538,314,0.9831566,3,30,3,0.5836431226765799,
6,2,car,crv,585,1120,414,732,535,318,0.9790969,3,30,3,0.594392523364486,
7,2,car,crv,580,1118,412,736,538,324,0.97944313,3,30,3,0.6022304832713755,
0,2,car,crv,680,1120,459,684,440,225,0.9350177,3,30,3,0.5113636363636364,
1,2,car,crv,679,1126,457,685,447,228,0.93751395,3,30,3,0.5100671140939598,
2,2,car,crv,682,1118,457,688,436,231,0.906731,3,30,3,0.5298165137614679,
3,2,car,crv,657,1104,453,676,447,223,0.93199766,3,30,3,0.4988814317673378,
4,2,car,crv,658,1104,451,682,446,231,0.9144128,3,30,3,0.5179372197309418,
5,2,car,crv,677,1123,458,686,446,228,0.93931526,3,30,3,0.5112107623318386,
6,2,car,crv,576,1114,415,729,538,314,0.9831566,3,30,3,0.5836431226765799,
7,2,car,crv,585,1120,414,732,535,318,0.9790969,3,30,3,0.594392523364486,
8,2,car,crv,580,1118,412,736,538,324,0.97944313,3,30,3,0.6022304832713755,
0,2,car,crv,660,1100,454,678,440,224,0.9024779,3,30,3,0.509090909090909,
1,2,car,crv,680,1120,459,684,440,225,0.9350177,3,30,3,0.5113636363636364,
2,2,car,crv,679,1126,457,685,447,228,0.93751395,3,30,3,0.5100671140939598,
3,2,car,crv,682,1118,457,688,436,231,0.906731,3,30,3,0.5298165137614679,
4,2,car,crv,657,1104,453,676,447,223,0.93199766,3,30,3,0.4988814317673378,
5,2,car,crv,658,1104,451,682,446,231,0.9144128,3,30,3,0.5179372197309418,
6,2,car,crv,677,1123,458,686,446,228,0.93931526,3,30,3,0.5112107623318386,
7,2,car,crv,576,1114,415,729,538,314,0.9831566,3,30,3,0.5836431226765799,
8,2,car,crv,585,1120,414,732,535,318,0.9790969,3,30,3,0.594392523364486,
9,2,car,crv,580,1118,412,736,538,324,0.97944313,3,30,3,0.6022304832713755,
0,2,car,crv,677,1124,457,685,447,228,0.92194945,3,30,3,0.5100671140939598,
1,2,car,crv,660,1100,454,678,440,224,0.9024779,3,30,3,0.509090909090909,
2,2,car,crv,680,1120,459,684,440,225,0.9350177,3,30,3,0.5113636363636364,
3,2,car,crv,679,1126,457,685,447,228,0.93751395,3,30,3,0.5100671140939598,
4,2,car,crv,682,1118,457,688,436,231,0.906731,3,30,3,0.5298165137614679,
5,2,car,crv,657,1104,453,676,447,223,0.93199766,3,30,3,0.4988814317673378,
6,2,car,crv,658,1104,451,682,446,231,0.9144128,3,30,3,0.5179372197309418,
7,2,car,crv,677,1123,458,686,446,228,0.93931526,3,30,3,0.5112107623318386,
8,2,car,crv,576,1114,415,729,538,314,0.9831566,3,30,3,0.5836431226765799,
9,2,car,crv,585,1120,414,732,535,318,0.9790969,3,30,3,0.594392523364486,
10,2,car,crv,580,1118,412,736,538,324,0.97944313,3,30,3,0.6022304832713755,
0,2,car,crv,680,1120,457,685,440,228,0.9319029,3,30,3,0.5181818181818182,
1,2,car,crv,677,1124,457,685,447,228,0.92194945,3,30,3,0.5100671140939598,
2,2,car,crv,660,1100,454,678,440,224,0.9024779,3,30,3,0.509090909090909,
3,2,car,crv,680,1120,459,684,440,225,0.9350177,3,30,3,0.5113636363636364,
4,2,car,crv,679,1126,457,685,447,228,0.93751395,3,30,3,0.5100671140939598,
5,2,car,crv,682,1118,457,688,436,231,0.906731,3,30,3,0.5298165137614679,
6,2,car,crv,657,1104,453,676,447,223,0.93199766,3,30,3,0.4988814317673378,
7,2,car,crv,658,1104,451,682,446,231,0.9144128,3,30,3,0.5179372197309418,
8,2,car,crv,677,1123,458,686,446,228,0.93931526,3,30,3,0.5112107623318386,
9,2,car,crv,576,1114,415,729,538,314,0.9831566,3,30,3,0.5836431226765799,
10,2,car,crv,585,1120,414,732,535,318,0.9790969,3,30,3,0.594392523364486,
11,2,car,crv,580,1118,412,736,538,324,0.97944313,3,30,3,0.6022304832713755,
0,2,car,crv,666,1097,456,676,431,220,0.9296913,3,30,3,0.5104408352668214,
1,2,car,crv,680,1120,457,685,440,228,0.9319029,3,30,3,0.5181818181818182,
2,2,car,crv,677,1124,457,685,447,228,0.92194945,3,30,3,0.5100671140939598,
3,2,car,crv,660,1100,454,678,440,224,0.9024779,3,30,3,0.509090909090909,
4,2,car,crv,680,1120,459,684,440,225,0.9350177,3,30,3,0.5113636363636364,
5,2,car,crv,679,1126,457,685,447,228,0.93751395,3,30,3,0.5100671140939598,
6,2,car,crv,682,1118,457,688,436,231,0.906731,3,30,3,0.5298165137614679,
7,2,car,crv,657,1104,453,676,447,223,0.93199766,3,30,3,0.4988814317673378,
8,2,car,crv,658,1104,451,682,446,231,0.9144128,3,30,3,0.5179372197309418,
9,2,car,crv,677,1123,458,686,446,228,0.93931526,3,30,3,0.5112107623318386,
10,2,car,crv,576,1114,415,729,538,314,0.9831566,3,30,3,0.5836431226765799,
11,2,car,crv,585,1120,414,732,535,318,0.9790969,3,30,3,0.594392523364486,
12,2,car,crv,580,1118,412,736,538,324,0.97944313,3,30,3,0.6022304832713755,
0,2,car,crv,683,1121,460,685,438,225,0.9232924,3,30,3,0.5136986301369864,
1,2,car,crv,666,1097,456,676,431,220,0.9296913,3,30,3,0.5104408352668214,
2,2,car,crv,680,1120,457,685,440,228,0.9319029,3,30,3,0.5181818181818182,
3,2,car,crv,677,1124,457,685,447,228,0.92194945,3,30,3,0.5100671140939598,
4,2,car,crv,660,1100,454,678,440,224,0.9024779,3,30,3,0.509090909090909,
5,2,car,crv,680,1120,459,684,440,225,0.9350177,3,30,3,0.5113636363636364,
6,2,car,crv,679,1126,457,685,447,228,0.93751395,3,30,3,0.5100671140939598,
7,2,car,crv,682,1118,457,688,436,231,0.906731,3,30,3,0.5298165137614679,
8,2,car,crv,657,1104,453,676,447,223,0.93199766,3,30,3,0.4988814317673378,
9,2,car,crv,658,1104,451,682,446,231,0.9144128,3,30,3,0.5179372197309418,
10,2,car,crv,677,1123,458,686,446,228,0.93931526,3,30,3,0.5112107623318386,
11,2,car,crv,576,1114,415,729,538,314,0.9831566,3,30,3,0.5836431226765799,
12,2,car,crv,585,1120,414,732,535,318,0.9790969,3,30,3,0.594392523364486,
13,2,car,crv,580,1118,412,736,538,324,0.97944313,3,30,3,0.6022304832713755,
0,2,car,crv,683,1116,459,686,433,227,0.9467467,3,30,3,0.5242494226327945,
1,2,car,crv,683,1121,460,685,438,225,0.9232924,3,30,3,0.5136986301369864,
2,2,car,crv,666,1097,456,676,431,220,0.9296913,3,30,3,0.5104408352668214,
3,2,car,crv,680,1120,457,685,440,228,0.9319029,3,30,3,0.5181818181818182,
4,2,car,crv,677,1124,457,685,447,228,0.92194945,3,30,3,0.5100671140939598,
5,2,car,crv,660,1100,454,678,440,224,0.9024779,3,30,3,0.509090909090909,
6,2,car,crv,680,1120,459,684,440,225,0.9350177,3,30,3,0.5113636363636364,
7,2,car,crv,679,1126,457,685,447,228,0.93751395,3,30,3,0.5100671140939598,
8,2,car,crv,682,1118,457,688,436,231,0.906731,3,30,3,0.5298165137614679,
9,2,car,crv,657,1104,453,676,447,223,0.93199766,3,30,3,0.4988814317673378,
10,2,car,crv,658,1104,451,682,446,231,0.9144128,3,30,3,0.5179372197309418,
11,2,car,crv,677,1123,458,686,446,228,0.93931526,3,30,3,0.5112107623318386,
12,2,car,crv,576,1114,415,729,538,314,0.9831566,3,30,3,0.5836431226765799,
13,2,car,crv,585,1120,414,732,535,318,0.9790969,3,30,3,0.594392523364486,
14,2,car,crv,580,1118,412,736,538,324,0.97944313,3,30,3,0.6022304832713755,
0,2,car,crv,659,1103,457,677,444,220,0.9314719,3,30,3,0.4954954954954955,
1,2,car,crv,683,1116,459,686,433,227,0.9467467,3,30,3,0.5242494226327945,
2,2,car,crv,683,1121,460,685,438,225,0.9232924,3,30,3,0.5136986301369864,
3,2,car,crv,666,1097,456,676,431,220,0.9296913,3,30,3,0.5104408352668214,
4,2,car,crv,680,1120,457,685,440,228,0.9319029,3,30,3,0.5181818181818182,
5,2,car,crv,677,1124,457,685,447,228,0.92194945,3,30,3,0.5100671140939598,
6,2,car,crv,660,1100,454,678,440,224,0.9024779,3,30,3,0.509090909090909,
7,2,car,crv,680,1120,459,684,440,225,0.9350177,3,30,3,0.5113636363636364,
8,2,car,crv,679,1126,457,685,447,228,0.93751395,3,30,3,0.5100671140939598,
9,2,car,crv,682,1118,457,688,436,231,0.906731,3,30,3,0.5298165137614679,
10,2,car,crv,657,1104,453,676,447,223,0.93199766,3,30,3,0.4988814317673378,
11,2,car,crv,658,1104,451,682,446,231,0.9144128,3,30,3,0.5179372197309418,
12,2,car,crv,677,1123,458,686,446,228,0.93931526,3,30,3,0.5112107623318386,
13,2,car,crv,576,1114,415,729,538,314,0.9831566,3,30,3,0.5836431226765799,
14,2,car,crv,585,1120,414,732,535,318,0.9790969,3,30,3,0.594392523364486,
15,2,car,crv,580,1118,412,736,538,324,0.97944313,3,30,3,0.6022304832713755,
0,2,car,crv,680,1123,460,683,443,223,0.9232944,3,30,3,0.5033860045146726,
1,2,car,crv,659,1103,457,677,444,220,0.9314719,3,30,3,0.4954954954954955,
2,2,car,crv,683,1116,459,686,433,227,0.9467467,3,30,3,0.5242494226327945,
3,2,car,crv,683,1121,460,685,438,225,0.9232924,3,30,3,0.5136986301369864,
4,2,car,crv,666,1097,456,676,431,220,0.9296913,3,30,3,0.5104408352668214,
5,2,car,crv,680,1120,457,685,440,228,0.9319029,3,30,3,0.5181818181818182,
6,2,car,crv,677,1124,457,685,447,228,0.92194945,3,30,3,0.5100671140939598,
7,2,car,crv,660,1100,454,678,440,224,0.9024779,3,30,3,0.509090909090909,
8,2,car,crv,680,1120,459,684,440,225,0.9350177,3,30,3,0.5113636363636364,
9,2,car,crv,679,1126,457,685,447,228,0.93751395,3,30,3,0.5100671140939598,
10,2,car,crv,682,1118,457,688,436,231,0.906731,3,30,3,0.5298165137614679,
11,2,car,crv,657,1104,453,676,447,223,0.93199766,3,30,3,0.4988814317673378,
12,2,car,crv,658,1104,451,682,446,231,0.9144128,3,30,3,0.5179372197309418,
13,2,car,crv,677,1123,458,686,446,228,0.93931526,3,30,3,0.5112107623318386,
14,2,car,crv,576,1114,415,729,538,314,0.9831566,3,30,3,0.5836431226765799,
15,2,car,crv,585,1120,414,732,535,318,0.9790969,3,30,3,0.594392523364486,
16,2,car,crv,580,1118,412,736,538,324,0.97944313,3,30,3,0.6022304832713755,
0,2,car,crv,681,1121,460,685,440,225,0.919954,3,30,3,0.5113636363636364,
1,2,car,crv,680,1123,460,683,443,223,0.9232944,3,30,3,0.5033860045146726,
2,2,car,crv,659,1103,457,677,444,220,0.9314719,3,30,3,0.4954954954954955,
3,2,car,crv,683,1116,459,686,433,227,0.9467467,3,30,3,0.5242494226327945,
4,2,car,crv,683,1121,460,685,438,225,0.9232924,3,30,3,0.5136986301369864,
5,2,car,crv,666,1097,456,676,431,220,0.9296913,3,30,3,0.5104408352668214,
6,2,car,crv,680,1120,457,685,440,228,0.9319029,3,30,3,0.5181818181818182,
7,2,car,crv,677,1124,457,685,447,228,0.92194945,3,30,3,0.5100671140939598,
8,2,car,crv,660,1100,454,678,440,224,0.9024779,3,30,3,0.509090909090909,
9,2,car,crv,680,1120,459,684,440,225,0.9350177,3,30,3,0.5113636363636364,
10,2,car,crv,679,1126,457,685,447,228,0.93751395,3,30,3,0.5100671140939598,
11,2,car,crv,682,1118,457,688,436,231,0.906731,3,30,3,0.5298165137614679,
12,2,car,crv,657,1104,453,676,447,223,0.93199766,3,30,3,0.4988814317673378,
13,2,car,crv,658,1104,451,682,446,231,0.9144128,3,30,3,0.5179372197309418,
14,2,car,crv,677,1123,458,686,446,228,0.93931526,3,30,3,0.5112107623318386,
15,2,car,crv,576,1114,415,729,538,314,0.9831566,3,30,3,0.5836431226765799,
16,2,car,crv,585,1120,414,732,535,318,0.9790969,3,30,3,0.594392523364486,
17,2,car,crv,580,1118,412,736,538,324,0.97944313,3,30,3,0.6022304832713755,
0,2,car,crv,683,1121,462,685,438,223,0.89638394,3,30,3,0.5091324200913242,
1,2,car,crv,681,1121,460,685,440,225,0.919954,3,30,3,0.5113636363636364,
2,2,car,crv,680,1123,460,683,443,223,0.9232944,3,30,3,0.5033860045146726,
3,2,car,crv,659,1103,457,677,444,220,0.9314719,3,30,3,0.4954954954954955,
4,2,car,crv,683,1116,459,686,433,227,0.9467467,3,30,3,0.5242494226327945,
5,2,car,crv,683,1121,460,685,438,225,0.9232924,3,30,3,0.5136986301369864,
6,2,car,crv,666,1097,456,676,431,220,0.9296913,3,30,3,0.5104408352668214,
7,2,car,crv,680,1120,457,685,440,228,0.9319029,3,30,3,0.5181818181818182,
8,2,car,crv,677,1124,457,685,447,228,0.92194945,3,30,3,0.5100671140939598,
9,2,car,crv,660,1100,454,678,440,224,0.9024779,3,30,3,0.509090909090909,
10,2,car,crv,680,1120,459,684,440,225,0.9350177,3,30,3,0.5113636363636364,
11,2,car,crv,679,1126,457,685,447,228,0.93751395,3,30,3,0.5100671140939598,
12,2,car,crv,682,1118,457,688,436,231,0.906731,3,30,3,0.5298165137614679,
13,2,car,crv,657,1104,453,676,447,223,0.93199766,3,30,3,0.4988814317673378,
14,2,car,crv,658,1104,451,682,446,231,0.9144128,3,30,3,0.5179372197309418,
15,2,car,crv,677,1123,458,686,446,228,0.93931526,3,30,3,0.5112107623318386,
16,2,car,crv,576,1114,415,729,538,314,0.9831566,3,30,3,0.5836431226765799,
17,2,car,crv,585,1120,414,732,535,318,0.9790969,3,30,3,0.594392523364486,
18,2,car,crv,580,1118,412,736,538,324,0.97944313,3,30,3,0.6022304832713755,
0,2,car,crv,682,1127,460,687,445,227,0.9177178,3,30,3,0.5101123595505618,
1,2,car,crv,683,1121,462,685,438,223,0.89638394,3,30,3,0.5091324200913242,
2,2,car,crv,681,1121,460,685,440,225,0.919954,3,30,3,0.5113636363636364,
3,2,car,crv,680,1123,460,683,443,223,0.9232944,3,30,3,0.5033860045146726,
4,2,car,crv,659,1103,457,677,444,220,0.9314719,3,30,3,0.4954954954954955,
5,2,car,crv,683,1116,459,686,433,227,0.9467467,3,30,3,0.5242494226327945,
6,2,car,crv,683,1121,460,685,438,225,0.9232924,3,30,3,0.5136986301369864,
7,2,car,crv,666,1097,456,676,431,220,0.9296913,3,30,3,0.5104408352668214,
8,2,car,crv,680,1120,457,685,440,228,0.9319029,3,30,3,0.5181818181818182,
9,2,car,crv,677,1124,457,685,447,228,0.92194945,3,30,3,0.5100671140939598,
10,2,car,crv,660,1100,454,678,440,224,0.9024779,3,30,3,0.509090909090909,
11,2,car,crv,680,1120,459,684,440,225,0.9350177,3,30,3,0.5113636363636364,
12,2,car,crv,679,1126,457,685,447,228,0.93751395,3,30,3,0.5100671140939598,
13,2,car,crv,682,1118,457,688,436,231,0.906731,3,30,3,0.5298165137614679,
14,2,car,crv,657,1104,453,676,447,223,0.93199766,3,30,3,0.4988814317673378,
15,2,car,crv,658,1104,451,682,446,231,0.9144128,3,30,3,0.5179372197309418,
16,2,car,crv,677,1123,458,686,446,228,0.93931526,3,30,3,0.5112107623318386,
17,2,car,crv,576,1114,415,729,538,314,0.9831566,3,30,3,0.5836431226765799,
18,2,car,crv,585,1120,414,732,535,318,0.9790969,3,30,3,0.594392523364486,
19,2,car,crv,580,1118,412,736,538,324,0.97944313,3,30,3,0.6022304832713755,
0,2,car,crv,681,1119,459,683,438,224,0.9075155,3,30,3,0.5114155251141552,
1,2,car,crv,682,1127,460,687,445,227,0.9177178,3,30,3,0.5101123595505618,
2,2,car,crv,683,1121,462,685,438,223,0.89638394,3,30,3,0.5091324200913242,
3,2,car,crv,681,1121,460,685,440,225,0.919954,3,30,3,0.5113636363636364,
4,2,car,crv,680,1123,460,683,443,223,0.9232944,3,30,3,0.5033860045146726,
5,2,car,crv,659,1103,457,677,444,220,0.9314719,3,30,3,0.4954954954954955,
6,2,car,crv,683,1116,459,686,433,227,0.9467467,3,30,3,0.5242494226327945,
7,2,car,crv,683,1121,460,685,438,225,0.9232924,3,30,3,0.5136986301369864,
8,2,car,crv,666,1097,456,676,431,220,0.9296913,3,30,3,0.5104408352668214,
9,2,car,crv,680,1120,457,685,440,228,0.9319029,3,30,3,0.5181818181818182,
10,2,car,crv,677,1124,457,685,447,228,0.92194945,3,30,3,0.5100671140939598,
11,2,car,crv,660,1100,454,678,440,224,0.9024779,3,30,3,0.509090909090909,
12,2,car,crv,680,1120,459,684,440,225,0.9350177,3,30,3,0.5113636363636364,
13,2,car,crv,679,1126,457,685,447,228,0.93751395,3,30,3,0.5100671140939598,
14,2,car,crv,682,1118,457,688,436,231,0.906731,3,30,3,0.5298165137614679,
15,2,car,crv,657,1104,453,676,447,223,0.93199766,3,30,3,0.4988814317673378,
16,2,car,crv,658,1104,451,682,446,231,0.9144128,3,30,3,0.5179372197309418,
17,2,car,crv,677,1123,458,686,446,228,0.93931526,3,30,3,0.5112107623318386,
18,2,car,crv,576,1114,415,729,538,314,0.9831566,3,30,3,0.5836431226765799,
19,2,car,crv,585,1120,414,732,535,318,0.9790969,3,30,3,0.594392523364486,
20,2,car,crv,580,1118,412,736,538,324,0.97944313,3,30,3,0.6022304832713755,
0,2,car,crv,674,1130,457,688,456,231,0.947293,3,30,3,2.0555555555555554,
1,2,car,crv,681,1119,459,683,438,224,0.9075155,3,30,3,0.5114155251141552,
2,2,car,crv,682,1127,460,687,445,227,0.9177178,3,30,3,0.5101123595505618,
3,2,car,crv,683,1121,462,685,438,223,0.89638394,3,30,3,0.5091324200913242,
4,2,car,crv,681,1121,460,685,440,225,0.919954,3,30,3,0.5113636363636364,
5,2,car,crv,680,1123,460,683,443,223,0.9232944,3,30,3,0.5033860045146726,
6,2,car,crv,659,1103,457,677,444,220,0.9314719,3,30,3,0.4954954954954955,
7,2,car,crv,683,1116,459,686,433,227,0.9467467,3,30,3,0.5242494226327945,
8,2,car,crv,683,1121,460,685,438,225,0.9232924,3,30,3,0.5136986301369864,
9,2,car,crv,666,1097,456,676,431,220,0.9296913,3,30,3,0.5104408352668214,
10,2,car,crv,680,1120,457,685,440,228,0.9319029,3,30,3,0.5181818181818182,
11,2,car,crv,677,1124,457,685,447,228,0.92194945,3,30,3,0.5100671140939598,
12,2,car,crv,660,1100,454,678,440,224,0.9024779,3,30,3,0.509090909090909,
13,2,car,crv,680,1120,459,684,440,225,0.9350177,3,30,3,0.5113636363636364,
14,2,car,crv,679,1126,457,685,447,228,0.93751395,3,30,3,0.5100671140939598,
15,2,car,crv,682,1118,457,688,436,231,0.906731,3,30,3,0.5298165137614679,
16,2,car,crv,657,1104,453,676,447,223,0.93199766,3,30,3,0.4988814317673378,
17,2,car,crv,658,1104,451,682,446,231,0.9144128,3,30,3,0.5179372197309418,
18,2,car,crv,677,1123,458,686,446,228,0.93931526,3,30,3,0.5112107623318386,
19,2,car,crv,576,1114,415,729,538,314,0.9831566,3,30,3,0.5836431226765799,
20,2,car,crv,585,1120,414,732,535,318,0.9790969,3,30,3,0.594392523364486,
21,2,car,crv,580,1118,412,736,538,324,0.97944313,3,30,3,0.6022304832713755,
0,2,car,crv,681,1119,456,687,438,231,0.93875754,3,30,3,0.5273972602739726,
1,2,car,crv,674,1130,457,688,456,231,0.947293,3,30,3,2.0555555555555554,
2,2,car,crv,681,1119,459,683,438,224,0.9075155,3,30,3,0.5114155251141552,
3,2,car,crv,682,1127,460,687,445,227,0.9177178,3,30,3,0.5101123595505618,
4,2,car,crv,683,1121,462,685,438,223,0.89638394,3,30,3,0.5091324200913242,
5,2,car,crv,681,1121,460,685,440,225,0.919954,3,30,3,0.5113636363636364,
6,2,car,crv,680,1123,460,683,443,223,0.9232944,3,30,3,0.5033860045146726,
7,2,car,crv,659,1103,457,677,444,220,0.9314719,3,30,3,0.4954954954954955,
8,2,car,crv,683,1116,459,686,433,227,0.9467467,3,30,3,0.5242494226327945,
9,2,car,crv,683,1121,460,685,438,225,0.9232924,3,30,3,0.5136986301369864,
10,2,car,crv,666,1097,456,676,431,220,0.9296913,3,30,3,0.5104408352668214,
11,2,car,crv,680,1120,457,685,440,228,0.9319029,3,30,3,0.5181818181818182,
12,2,car,crv,677,1124,457,685,447,228,0.92194945,3,30,3,0.5100671140939598,
13,2,car,crv,660,1100,454,678,440,224,0.9024779,3,30,3,0.509090909090909,
14,2,car,crv,680,1120,459,684,440,225,0.9350177,3,30,3,0.5113636363636364,
15,2,car,crv,679,1126,457,685,447,228,0.93751395,3,30,3,0.5100671140939598,
16,2,car,crv,682,1118,457,688,436,231,0.906731,3,30,3,0.5298165137614679,
17,2,car,crv,657,1104,453,676,447,223,0.93199766,3,30,3,0.4988814317673378,
18,2,car,crv,658,1104,451,682,446,231,0.9144128,3,30,3,0.5179372197309418,
19,2,car,crv,677,1123,458,686,446,228,0.93931526,3,30,3,0.5112107623318386,
20,2,car,crv,576,1114,415,729,538,314,0.9831566,3,30,3,0.5836431226765799,
21,2,car,crv,585,1120,414,732,535,318,0.9790969,3,30,3,0.594392523364486,
22,2,car,crv,580,1118,412,736,538,324,0.97944313,3,30,3,0.6022304832713755,
0,2,car,crv,683,1117,462,682,434,220,0.9430802,3,30,3,0.5069124423963134,
1,2,car,crv,681,1119,456,687,438,231,0.93875754,3,30,3,0.5273972602739726,
2,2,car,crv,674,1130,457,688,456,231,0.947293,3,30,3,2.0555555555555554,
3,2,car,crv,681,1119,459,683,438,224,0.9075155,3,30,3,0.5114155251141552,
4,2,car,crv,682,1127,460,687,445,227,0.9177178,3,30,3,0.5101123595505618,
5,2,car,crv,683,1121,462,685,438,223,0.89638394,3,30,3,0.5091324200913242,
6,2,car,crv,681,1121,460,685,440,225,0.919954,3,30,3,0.5113636363636364,
7,2,car,crv,680,1123,460,683,443,223,0.9232944,3,30,3,0.5033860045146726,
8,2,car,crv,659,1103,457,677,444,220,0.9314719,3,30,3,0.4954954954954955,
9,2,car,crv,683,1116,459,686,433,227,0.9467467,3,30,3,0.5242494226327945,
10,2,car,crv,683,1121,460,685,438,225,0.9232924,3,30,3,0.5136986301369864,
11,2,car,crv,666,1097,456,676,431,220,0.9296913,3,30,3,0.5104408352668214,
12,2,car,crv,680,1120,457,685,440,228,0.9319029,3,30,3,0.5181818181818182,
13,2,car,crv,677,1124,457,685,447,228,0.92194945,3,30,3,0.5100671140939598,
14,2,car,crv,660,1100,454,678,440,224,0.9024779,3,30,3,0.509090909090909,
15,2,car,crv,680,1120,459,684,440,225,0.9350177,3,30,3,0.5113636363636364,
16,2,car,crv,679,1126,457,685,447,228,0.93751395,3,30,3,0.5100671140939598,
17,2,car,crv,682,1118,457,688,436,231,0.906731,3,30,3,0.5298165137614679,
18,2,car,crv,657,1104,453,676,447,223,0.93199766,3,30,3,0.4988814317673378,
19,2,car,crv,658,1104,451,682,446,231,0.9144128,3,30,3,0.5179372197309418,
20,2,car,crv,677,1123,458,686,446,228,0.93931526,3,30,3,0.5112107623318386,
21,2,car,crv,576,1114,415,729,538,314,0.9831566,3,30,3,0.5836431226765799,
22,2,car,crv,585,1120,414,732,535,318,0.9790969,3,30,3,0.594392523364486,
23,2,car,crv,580,1118,412,736,538,324,0.97944313,3,30,3,0.6022304832713755,
0,2,car,crv,657,1104,456,672,447,216,0.91418546,3,60,3,1.9821428571428572,
1,2,car,crv,683,1117,462,682,434,220,0.9430802,3,30,3,0.5069124423963134,
2,2,car,crv,681,1119,456,687,438,231,0.93875754,3,30,3,0.5273972602739726,
3,2,car,crv,674,1130,457,688,456,231,0.947293,3,30,3,2.0555555555555554,
4,2,car,crv,681,1119,459,683,438,224,0.9075155,3,30,3,0.5114155251141552,
5,2,car,crv,682,1127,460,687,445,227,0.9177178,3,30,3,0.5101123595505618,
6,2,car,crv,683,1121,462,685,438,223,0.89638394,3,30,3,0.5091324200913242,
7,2,car,crv,681,1121,460,685,440,225,0.919954,3,30,3,0.5113636363636364,
8,2,car,crv,680,1123,460,683,443,223,0.9232944,3,30,3,0.5033860045146726,
9,2,car,crv,659,1103,457,677,444,220,0.9314719,3,30,3,0.4954954954954955,
10,2,car,crv,683,1116,459,686,433,227,0.9467467,3,30,3,0.5242494226327945,
11,2,car,crv,683,1121,460,685,438,225,0.9232924,3,30,3,0.5136986301369864,
12,2,car,crv,666,1097,456,676,431,220,0.9296913,3,30,3,0.5104408352668214,
13,2,car,crv,680,1120,457,685,440,228,0.9319029,3,30,3,0.5181818181818182,
14,2,car,crv,677,1124,457,685,447,228,0.92194945,3,30,3,0.5100671140939598,
15,2,car,crv,660,1100,454,678,440,224,0.9024779,3,30,3,0.509090909090909,
16,2,car,crv,680,1120,459,684,440,225,0.9350177,3,30,3,0.5113636363636364,
17,2,car,crv,679,1126,457,685,447,228,0.93751395,3,30,3,0.5100671140939598,
18,2,car,crv,682,1118,457,688,436,231,0.906731,3,30,3,0.5298165137614679,
19,2,car,crv,657,1104,453,676,447,223,0.93199766,3,30,3,0.4988814317673378,
20,2,car,crv,658,1104,451,682,446,231,0.9144128,3,30,3,0.5179372197309418,
21,2,car,crv,677,1123,458,686,446,228,0.93931526,3,30,3,0.5112107623318386,
22,2,car,crv,576,1114,415,729,538,314,0.9831566,3,30,3,0.5836431226765799,
23,2,car,crv,585,1120,414,732,535,318,0.9790969,3,30,3,0.594392523364486,
24,2,car,crv,580,1118,412,736,538,324,0.97944313,3,30,3,0.6022304832713755,
0,2,car,crv,675,1130,459,685,455,226,0.9349686,3,30,3,0.4967032967032967,
1,2,car,crv,657,1104,456,672,447,216,0.91418546,3,60,3,1.9821428571428572,
2,2,car,crv,683,1117,462,682,434,220,0.9430802,3,30,3,0.5069124423963134,
3,2,car,crv,681,1119,456,687,438,231,0.93875754,3,30,3,0.5273972602739726,
4,2,car,crv,674,1130,457,688,456,231,0.947293,3,30,3,2.0555555555555554,
5,2,car,crv,681,1119,459,683,438,224,0.9075155,3,30,3,0.5114155251141552,
6,2,car,crv,682,1127,460,687,445,227,0.9177178,3,30,3,0.5101123595505618,
7,2,car,crv,683,1121,462,685,438,223,0.89638394,3,30,3,0.5091324200913242,
8,2,car,crv,681,1121,460,685,440,225,0.919954,3,30,3,0.5113636363636364,
9,2,car,crv,680,1123,460,683,443,223,0.9232944,3,30,3,0.5033860045146726,
10,2,car,crv,659,1103,457,677,444,220,0.9314719,3,30,3,0.4954954954954955,
11,2,car,crv,683,1116,459,686,433,227,0.9467467,3,30,3,0.5242494226327945,
12,2,car,crv,683,1121,460,685,438,225,0.9232924,3,30,3,0.5136986301369864,
13,2,car,crv,666,1097,456,676,431,220,0.9296913,3,30,3,0.5104408352668214,
14,2,car,crv,680,1120,457,685,440,228,0.9319029,3,30,3,0.5181818181818182,
15,2,car,crv,677,1124,457,685,447,228,0.92194945,3,30,3,0.5100671140939598,
16,2,car,crv,660,1100,454,678,440,224,0.9024779,3,30,3,0.509090909090909,
17,2,car,crv,680,1120,459,684,440,225,0.9350177,3,30,3,0.5113636363636364,
18,2,car,crv,679,1126,457,685,447,228,0.93751395,3,30,3,0.5100671140939598,
19,2,car,crv,682,1118,457,688,436,231,0.906731,3,30,3,0.5298165137614679,
20,2,car,crv,657,1104,453,676,447,223,0.93199766,3,30,3,0.4988814317673378,
21,2,car,crv,658,1104,451,682,446,231,0.9144128,3,30,3,0.5179372197309418,
22,2,car,crv,677,1123,458,686,446,228,0.93931526,3,30,3,0.5112107623318386,
23,2,car,crv,576,1114,415,729,538,314,0.9831566,3,30,3,0.5836431226765799,
24,2,car,crv,585,1120,414,732,535,318,0.9790969,3,30,3,0.594392523364486,
25,2,car,crv,580,1118,412,736,538,324,0.97944313,3,30,3,0.6022304832713755,
0,2,car,crv,682,1124,460,684,442,224,0.8697906,3,30,3,2.0961538461538463,
1,2,car,crv,675,1130,459,685,455,226,0.9349686,3,30,3,0.4967032967032967,
2,2,car,crv,657,1104,456,672,447,216,0.91418546,3,60,3,1.9821428571428572,
3,2,car,crv,683,1117,462,682,434,220,0.9430802,3,30,3,0.5069124423963134,
4,2,car,crv,681,1119,456,687,438,231,0.93875754,3,30,3,0.5273972602739726,
5,2,car,crv,674,1130,457,688,456,231,0.947293,3,30,3,2.0555555555555554,
6,2,car,crv,681,1119,459,683,438,224,0.9075155,3,30,3,0.5114155251141552,
7,2,car,crv,682,1127,460,687,445,227,0.9177178,3,30,3,0.5101123595505618,
8,2,car,crv,683,1121,462,685,438,223,0.89638394,3,30,3,0.5091324200913242,
9,2,car,crv,681,1121,460,685,440,225,0.919954,3,30,3,0.5113636363636364,
10,2,car,crv,680,1123,460,683,443,223,0.9232944,3,30,3,0.5033860045146726,
11,2,car,crv,659,1103,457,677,444,220,0.9314719,3,30,3,0.4954954954954955,
12,2,car,crv,683,1116,459,686,433,227,0.9467467,3,30,3,0.5242494226327945,
13,2,car,crv,683,1121,460,685,438,225,0.9232924,3,30,3,0.5136986301369864,
14,2,car,crv,666,1097,456,676,431,220,0.9296913,3,30,3,0.5104408352668214,
15,2,car,crv,680,1120,457,685,440,228,0.9319029,3,30,3,0.5181818181818182,
16,2,car,crv,677,1124,457,685,447,228,0.92194945,3,30,3,0.5100671140939598,
17,2,car,crv,660,1100,454,678,440,224,0.9024779,3,30,3,0.509090909090909,
18,2,car,crv,680,1120,459,684,440,225,0.9350177,3,30,3,0.5113636363636364,
19,2,car,crv,679,1126,457,685,447,228,0.93751395,3,30,3,0.5100671140939598,
20,2,car,crv,682,1118,457,688,436,231,0.906731,3,30,3,0.5298165137614679,
21,2,car,crv,657,1104,453,676,447,223,0.93199766,3,30,3,0.4988814317673378,
22,2,car,crv,658,1104,451,682,446,231,0.9144128,3,30,3,0.5179372197309418,
23,2,car,crv,677,1123,458,686,446,228,0.93931526,3,30,3,0.5112107623318386,
24,2,car,crv,576,1114,415,729,538,314,0.9831566,3,30,3,0.5836431226765799,
25,2,car,crv,585,1120,414,732,535,318,0.9790969,3,30,3,0.594392523364486,
26,2,car,crv,580,1118,412,736,538,324,0.97944313,3,30,3,0.6022304832713755,
0,2,car,crv,652,1108,453,677,456,224,0.91756064,3,30,3,2.1020408163265305,
1,2,car,crv,682,1124,460,684,442,224,0.8697906,3,30,3,2.0961538461538463,
2,2,car,crv,675,1130,459,685,455,226,0.9349686,3,30,3,0.4967032967032967,
3,2,car,crv,657,1104,456,672,447,216,0.91418546,3,60,3,1.9821428571428572,
4,2,car,crv,683,1117,462,682,434,220,0.9430802,3,30,3,0.5069124423963134,
5,2,car,crv,681,1119,456,687,438,231,0.93875754,3,30,3,0.5273972602739726,
6,2,car,crv,674,1130,457,688,456,231,0.947293,3,30,3,2.0555555555555554,
7,2,car,crv,681,1119,459,683,438,224,0.9075155,3,30,3,0.5114155251141552,
8,2,car,crv,682,1127,460,687,445,227,0.9177178,3,30,3,0.5101123595505618,
9,2,car,crv,683,1121,462,685,438,223,0.89638394,3,30,3,0.5091324200913242,
10,2,car,crv,681,1121,460,685,440,225,0.919954,3,30,3,0.5113636363636364,
11,2,car,crv,680,1123,460,683,443,223,0.9232944,3,30,3,0.5033860045146726,
12,2,car,crv,659,1103,457,677,444,220,0.9314719,3,30,3,0.4954954954954955,
13,2,car,crv,683,1116,459,686,433,227,0.9467467,3,30,3,0.5242494226327945,
14,2,car,crv,683,1121,460,685,438,225,0.9232924,3,30,3,0.5136986301369864,
15,2,car,crv,666,1097,456,676,431,220,0.9296913,3,30,3,0.5104408352668214,
16,2,car,crv,680,1120,457,685,440,228,0.9319029,3,30,3,0.5181818181818182,
17,2,car,crv,677,1124,457,685,447,228,0.92194945,3,30,3,0.5100671140939598,
18,2,car,crv,660,1100,454,678,440,224,0.9024779,3,30,3,0.509090909090909,
19,2,car,crv,680,1120,459,684,440,225,0.9350177,3,30,3,0.5113636363636364,
20,2,car,crv,679,1126,457,685,447,228,0.93751395,3,30,3,0.5100671140939598,
21,2,car,crv,682,1118,457,688,436,231,0.906731,3,30,3,0.5298165137614679,
22,2,car,crv,657,1104,453,676,447,223,0.93199766,3,30,3,0.4988814317673378,
23,2,car,crv,658,1104,451,682,446,231,0.9144128,3,30,3,0.5179372197309418,
24,2,car,crv,677,1123,458,686,446,228,0.93931526,3,30,3,0.5112107623318386,
25,2,car,crv,576,1114,415,729,538,314,0.9831566,3,30,3,0.5836431226765799,
26,2,car,crv,585,1120,414,732,535,318,0.9790969,3,30,3,0.594392523364486,
27,2,car,crv,580,1118,412,736,538,324,0.97944313,3,30,3,0.6022304832713755,
0,2,car,crv,682,1124,461,684,442,223,0.90869683,3,30,3,0.504524886877828,
1,2,car,crv,652,1108,453,677,456,224,0.91756064,3,30,3,2.1020408163265305,
2,2,car,crv,682,1124,460,684,442,224,0.8697906,3,30,3,2.0961538461538463,
3,2,car,crv,675,1130,459,685,455,226,0.9349686,3,30,3,0.4967032967032967,
4,2,car,crv,657,1104,456,672,447,216,0.91418546,3,60,3,1.9821428571428572,
5,2,car,crv,683,1117,462,682,434,220,0.9430802,3,30,3,0.5069124423963134,
6,2,car,crv,681,1119,456,687,438,231,0.93875754,3,30,3,0.5273972602739726,
7,2,car,crv,674,1130,457,688,456,231,0.947293,3,30,3,2.0555555555555554,
8,2,car,crv,681,1119,459,683,438,224,0.9075155,3,30,3,0.5114155251141552,
9,2,car,crv,682,1127,460,687,445,227,0.9177178,3,30,3,0.5101123595505618,
10,2,car,crv,683,1121,462,685,438,223,0.89638394,3,30,3,0.5091324200913242,
11,2,car,crv,681,1121,460,685,440,225,0.919954,3,30,3,0.5113636363636364,
12,2,car,crv,680,1123,460,683,443,223,0.9232944,3,30,3,0.5033860045146726,
13,2,car,crv,659,1103,457,677,444,220,0.9314719,3,30,3,0.4954954954954955,
14,2,car,crv,683,1116,459,686,433,227,0.9467467,3,30,3,0.5242494226327945,
15,2,car,crv,683,1121,460,685,438,225,0.9232924,3,30,3,0.5136986301369864,
16,2,car,crv,666,1097,456,676,431,220,0.9296913,3,30,3,0.5104408352668214,
17,2,car,crv,680,1120,457,685,440,228,0.9319029,3,30,3,0.5181818181818182,
18,2,car,crv,677,1124,457,685,447,228,0.92194945,3,30,3,0.5100671140939598,
19,2,car,crv,660,1100,454,678,440,224,0.9024779,3,30,3,0.509090909090909,
20,2,car,crv,680,1120,459,684,440,225,0.9350177,3,30,3,0.5113636363636364,
21,2,car,crv,679,1126,457,685,447,228,0.93751395,3,30,3,0.5100671140939598,
22,2,car,crv,682,1118,457,688,436,231,0.906731,3,30,3,0.5298165137614679,
23,2,car,crv,657,1104,453,676,447,223,0.93199766,3,30,3,0.4988814317673378,
24,2,car,crv,658,1104,451,682,446,231,0.9144128,3,30,3,0.5179372197309418,
25,2,car,crv,677,1123,458,686,446,228,0.93931526,3,30,3,0.5112107623318386,
26,2,car,crv,576,1114,415,729,538,314,0.9831566,3,30,3,0.5836431226765799,
27,2,car,crv,585,1120,414,732,535,318,0.9790969,3,30,3,0.594392523364486,
28,2,car,crv,580,1118,412,736,538,324,0.97944313,3,30,3,0.6022304832713755,
0,2,car,crv,681,1120,459,686,439,227,0.9222198,3,30,3,2.152173913043478,
1,2,car,crv,682,1124,461,684,442,223,0.90869683,3,30,3,0.504524886877828,
2,2,car,crv,652,1108,453,677,456,224,0.91756064,3,30,3,2.1020408163265305,
3,2,car,crv,682,1124,460,684,442,224,0.8697906,3,30,3,2.0961538461538463,
4,2,car,crv,675,1130,459,685,455,226,0.9349686,3,30,3,0.4967032967032967,
5,2,car,crv,657,1104,456,672,447,216,0.91418546,3,60,3,1.9821428571428572,
6,2,car,crv,683,1117,462,682,434,220,0.9430802,3,30,3,0.5069124423963134,
7,2,car,crv,681,1119,456,687,438,231,0.93875754,3,30,3,0.5273972602739726,
8,2,car,crv,674,1130,457,688,456,231,0.947293,3,30,3,2.0555555555555554,
9,2,car,crv,681,1119,459,683,438,224,0.9075155,3,30,3,0.5114155251141552,
10,2,car,crv,682,1127,460,687,445,227,0.9177178,3,30,3,0.5101123595505618,
11,2,car,crv,683,1121,462,685,438,223,0.89638394,3,30,3,0.5091324200913242,
12,2,car,crv,681,1121,460,685,440,225,0.919954,3,30,3,0.5113636363636364,
13,2,car,crv,680,1123,460,683,443,223,0.9232944,3,30,3,0.5033860045146726,
14,2,car,crv,659,1103,457,677,444,220,0.9314719,3,30,3,0.4954954954954955,
15,2,car,crv,683,1116,459,686,433,227,0.9467467,3,30,3,0.5242494226327945,
16,2,car,crv,683,1121,460,685,438,225,0.9232924,3,30,3,0.5136986301369864,
17,2,car,crv,666,1097,456,676,431,220,0.9296913,3,30,3,0.5104408352668214,
18,2,car,crv,680,1120,457,685,440,228,0.9319029,3,30,3,0.5181818181818182,
19,2,car,crv,677,1124,457,685,447,228,0.92194945,3,30,3,0.5100671140939598,
20,2,car,crv,660,1100,454,678,440,224,0.9024779,3,30,3,0.509090909090909,
21,2,car,crv,680,1120,459,684,440,225,0.9350177,3,30,3,0.5113636363636364,
22,2,car,crv,679,1126,457,685,447,228,0.93751395,3,30,3,0.5100671140939598,
23,2,car,crv,682,1118,457,688,436,231,0.906731,3,30,3,0.5298165137614679,
24,2,car,crv,657,1104,453,676,447,223,0.93199766,3,30,3,0.4988814317673378,
25,2,car,crv,658,1104,451,682,446,231,0.9144128,3,30,3,0.5179372197309418,
26,2,car,crv,677,1123,458,686,446,228,0.93931526,3,30,3,0.5112107623318386,
27,2,car,crv,576,1114,415,729,538,314,0.9831566,3,30,3,0.5836431226765799,
28,2,car,crv,585,1120,414,732,535,318,0.9790969,3,30,3,0.594392523364486,
29,2,car,crv,580,1118,412,736,538,324,0.97944313,3,30,3,0.6022304832713755,
0,2,car,crv,662,1101,455,677,439,222,0.9480402,3,30,3,0.5056947608200456,
1,2,car,crv,681,1120,459,686,439,227,0.9222198,3,30,3,2.152173913043478,
2,2,car,crv,682,1124,461,684,442,223,0.90869683,3,30,3,0.504524886877828,
3,2,car,crv,652,1108,453,677,456,224,0.91756064,3,30,3,2.1020408163265305,
4,2,car,crv,682,1124,460,684,442,224,0.8697906,3,30,3,2.0961538461538463,
5,2,car,crv,675,1130,459,685,455,226,0.9349686,3,30,3,0.4967032967032967,
6,2,car,crv,657,1104,456,672,447,216,0.91418546,3,60,3,1.9821428571428572,
7,2,car,crv,683,1117,462,682,434,220,0.9430802,3,30,3,0.5069124423963134,
8,2,car,crv,681,1119,456,687,438,231,0.93875754,3,30,3,0.5273972602739726,
9,2,car,crv,674,1130,457,688,456,231,0.947293,3,30,3,2.0555555555555554,
10,2,car,crv,681,1119,459,683,438,224,0.9075155,3,30,3,0.5114155251141552,
11,2,car,crv,682,1127,460,687,445,227,0.9177178,3,30,3,0.5101123595505618,
12,2,car,crv,683,1121,462,685,438,223,0.89638394,3,30,3,0.5091324200913242,
13,2,car,crv,681,1121,460,685,440,225,0.919954,3,30,3,0.5113636363636364,
14,2,car,crv,680,1123,460,683,443,223,0.9232944,3,30,3,0.5033860045146726,
15,2,car,crv,659,1103,457,677,444,220,0.9314719,3,30,3,0.4954954954954955,
16,2,car,crv,683,1116,459,686,433,227,0.9467467,3,30,3,0.5242494226327945,
17,2,car,crv,683,1121,460,685,438,225,0.9232924,3,30,3,0.5136986301369864,
18,2,car,crv,666,1097,456,676,431,220,0.9296913,3,30,3,0.5104408352668214,
19,2,car,crv,680,1120,457,685,440,228,0.9319029,3,30,3,0.5181818181818182,
20,2,car,crv,677,1124,457,685,447,228,0.92194945,3,30,3,0.5100671140939598,
21,2,car,crv,660,1100,454,678,440,224,0.9024779,3,30,3,0.509090909090909,
22,2,car,crv,680,1120,459,684,440,225,0.9350177,3,30,3,0.5113636363636364,
23,2,car,crv,679,1126,457,685,447,228,0.93751395,3,30,3,0.5100671140939598,
24,2,car,crv,682,1118,457,688,436,231,0.906731,3,30,3,0.5298165137614679,
25,2,car,crv,657,1104,453,676,447,223,0.93199766,3,30,3,0.4988814317673378,
26,2,car,crv,658,1104,451,682,446,231,0.9144128,3,30,3,0.5179372197309418,
27,2,car,crv,677,1123,458,686,446,228,0.93931526,3,30,3,0.5112107623318386,
28,2,car,crv,576,1114,415,729,538,314,0.9831566,3,30,3,0.5836431226765799,
29,2,car,crv,585,1120,414,732,535,318,0.9790969,3,30,3,0.594392523364486,
30,2,car,crv,580,1118,412,736,538,324,0.97944313,3,30,3,0.6022304832713755,
0,2,car,crv,657,1105,452,682,448,230,0.87961954,3,30,3,0.5133928571428571,
1,2,car,crv,662,1101,455,677,439,222,0.9480402,3,30,3,0.5056947608200456,
2,2,car,crv,681,1120,459,686,439,227,0.9222198,3,30,3,2.152173913043478,
3,2,car,crv,682,1124,461,684,442,223,0.90869683,3,30,3,0.504524886877828,
4,2,car,crv,652,1108,453,677,456,224,0.91756064,3,30,3,2.1020408163265305,
5,2,car,crv,682,1124,460,684,442,224,0.8697906,3,30,3,2.0961538461538463,
6,2,car,crv,675,1130,459,685,455,226,0.9349686,3,30,3,0.4967032967032967,
7,2,car,crv,657,1104,456,672,447,216,0.91418546,3,60,3,1.9821428571428572,
8,2,car,crv,683,1117,462,682,434,220,0.9430802,3,30,3,0.5069124423963134,
9,2,car,crv,681,1119,456,687,438,231,0.93875754,3,30,3,0.5273972602739726,
10,2,car,crv,674,1130,457,688,456,231,0.947293,3,30,3,2.0555555555555554,
11,2,car,crv,681,1119,459,683,438,224,0.9075155,3,30,3,0.5114155251141552,
12,2,car,crv,682,1127,460,687,445,227,0.9177178,3,30,3,0.5101123595505618,
13,2,car,crv,683,1121,462,685,438,223,0.89638394,3,30,3,0.5091324200913242,
14,2,car,crv,681,1121,460,685,440,225,0.919954,3,30,3,0.5113636363636364,
15,2,car,crv,680,1123,460,683,443,223,0.9232944,3,30,3,0.5033860045146726,
16,2,car,crv,659,1103,457,677,444,220,0.9314719,3,30,3,0.4954954954954955,
17,2,car,crv,683,1116,459,686,433,227,0.9467467,3,30,3,0.5242494226327945,
18,2,car,crv,683,1121,460,685,438,225,0.9232924,3,30,3,0.5136986301369864,
19,2,car,crv,666,1097,456,676,431,220,0.9296913,3,30,3,0.5104408352668214,
20,2,car,crv,680,1120,457,685,440,228,0.9319029,3,30,3,0.5181818181818182,
21,2,car,crv,677,1124,457,685,447,228,0.92194945,3,30,3,0.5100671140939598,
22,2,car,crv,660,1100,454,678,440,224,0.9024779,3,30,3,0.509090909090909,
23,2,car,crv,680,1120,459,684,440,225,0.9350177,3,30,3,0.5113636363636364,
24,2,car,crv,679,1126,457,685,447,228,0.93751395,3,30,3,0.5100671140939598,
25,2,car,crv,682,1118,457,688,436,231,0.906731,3,30,3,0.5298165137614679,
26,2,car,crv,657,1104,453,676,447,223,0.93199766,3,30,3,0.4988814317673378,
27,2,car,crv,658,1104,451,682,446,231,0.9144128,3,30,3,0.5179372197309418,
28,2,car,crv,677,1123,458,686,446,228,0.93931526,3,30,3,0.5112107623318386,
29,2,car,crv,576,1114,415,729,538,314,0.9831566,3,30,3,0.5836431226765799,
30,2,car,crv,585,1120,414,732,535,318,0.9790969,3,30,3,0.594392523364486,
31,2,car,crv,580,1118,412,736,538,324,0.97944313,3,30,3,0.6022304832713755,
0,2,car,crv,682,1119,460,686,437,226,0.8083159,3,30,3,0.517162471395881,
1,2,car,crv,657,1105,452,682,448,230,0.87961954,3,30,3,0.5133928571428571,
2,2,car,crv,662,1101,455,677,439,222,0.9480402,3,30,3,0.5056947608200456,
3,2,car,crv,681,1120,459,686,439,227,0.9222198,3,30,3,2.152173913043478,
4,2,car,crv,682,1124,461,684,442,223,0.90869683,3,30,3,0.504524886877828,
5,2,car,crv,652,1108,453,677,456,224,0.91756064,3,30,3,2.1020408163265305,
6,2,car,crv,682,1124,460,684,442,224,0.8697906,3,30,3,2.0961538461538463,
7,2,car,crv,675,1130,459,685,455,226,0.9349686,3,30,3,0.4967032967032967,
8,2,car,crv,657,1104,456,672,447,216,0.91418546,3,60,3,1.9821428571428572,
9,2,car,crv,683,1117,462,682,434,220,0.9430802,3,30,3,0.5069124423963134,
10,2,car,crv,681,1119,456,687,438,231,0.93875754,3,30,3,0.5273972602739726,
11,2,car,crv,674,1130,457,688,456,231,0.947293,3,30,3,2.0555555555555554,
12,2,car,crv,681,1119,459,683,438,224,0.9075155,3,30,3,0.5114155251141552,
13,2,car,crv,682,1127,460,687,445,227,0.9177178,3,30,3,0.5101123595505618,
14,2,car,crv,683,1121,462,685,438,223,0.89638394,3,30,3,0.5091324200913242,
15,2,car,crv,681,1121,460,685,440,225,0.919954,3,30,3,0.5113636363636364,
16,2,car,crv,680,1123,460,683,443,223,0.9232944,3,30,3,0.5033860045146726,
17,2,car,crv,659,1103,457,677,444,220,0.9314719,3,30,3,0.4954954954954955,
18,2,car,crv,683,1116,459,686,433,227,0.9467467,3,30,3,0.5242494226327945,
19,2,car,crv,683,1121,460,685,438,225,0.9232924,3,30,3,0.5136986301369864,
20,2,car,crv,666,1097,456,676,431,220,0.9296913,3,30,3,0.5104408352668214,
21,2,car,crv,680,1120,457,685,440,228,0.9319029,3,30,3,0.5181818181818182,
22,2,car,crv,677,1124,457,685,447,228,0.92194945,3,30,3,0.5100671140939598,
23,2,car,crv,660,1100,454,678,440,224,0.9024779,3,30,3,0.509090909090909,
24,2,car,crv,680,1120,459,684,440,225,0.9350177,3,30,3,0.5113636363636364,
25,2,car,crv,679,1126,457,685,447,228,0.93751395,3,30,3,0.5100671140939598,
26,2,car,crv,682,1118,457,688,436,231,0.906731,3,30,3,0.5298165137614679,
27,2,car,crv,657,1104,453,676,447,223,0.93199766,3,30,3,0.4988814317673378,
28,2,car,crv,658,1104,451,682,446,231,0.9144128,3,30,3,0.5179372197309418,
29,2,car,crv,677,1123,458,686,446,228,0.93931526,3,30,3,0.5112107623318386,
30,2,car,crv,576,1114,415,729,538,314,0.9831566,3,30,3,0.5836431226765799,
31,2,car,crv,585,1120,414,732,535,318,0.9790969,3,30,3,0.594392523364486,
32,2,car,crv,580,1118,412,736,538,324,0.97944313,3,30,3,0.6022304832713755,
0,2,car,crv,681,1117,459,686,436,227,0.9399104,3,30,3,2.1627906976744184,
1,2,car,crv,682,1119,460,686,437,226,0.8083159,3,30,3,0.517162471395881,
2,2,car,crv,657,1105,452,682,448,230,0.87961954,3,30,3,0.5133928571428571,
3,2,car,crv,662,1101,455,677,439,222,0.9480402,3,30,3,0.5056947608200456,
4,2,car,crv,681,1120,459,686,439,227,0.9222198,3,30,3,2.152173913043478,
5,2,car,crv,682,1124,461,684,442,223,0.90869683,3,30,3,0.504524886877828,
6,2,car,crv,652,1108,453,677,456,224,0.91756064,3,30,3,2.1020408163265305,
7,2,car,crv,682,1124,460,684,442,224,0.8697906,3,30,3,2.0961538461538463,
8,2,car,crv,675,1130,459,685,455,226,0.9349686,3,30,3,0.4967032967032967,
9,2,car,crv,657,1104,456,672,447,216,0.91418546,3,60,3,1.9821428571428572,
10,2,car,crv,683,1117,462,682,434,220,0.9430802,3,30,3,0.5069124423963134,
11,2,car,crv,681,1119,456,687,438,231,0.93875754,3,30,3,0.5273972602739726,
12,2,car,crv,674,1130,457,688,456,231,0.947293,3,30,3,2.0555555555555554,
13,2,car,crv,681,1119,459,683,438,224,0.9075155,3,30,3,0.5114155251141552,
14,2,car,crv,682,1127,460,687,445,227,0.9177178,3,30,3,0.5101123595505618,
15,2,car,crv,683,1121,462,685,438,223,0.89638394,3,30,3,0.5091324200913242,
16,2,car,crv,681,1121,460,685,440,225,0.919954,3,30,3,0.5113636363636364,
17,2,car,crv,680,1123,460,683,443,223,0.9232944,3,30,3,0.5033860045146726,
18,2,car,crv,659,1103,457,677,444,220,0.9314719,3,30,3,0.4954954954954955,
19,2,car,crv,683,1116,459,686,433,227,0.9467467,3,30,3,0.5242494226327945,
20,2,car,crv,683,1121,460,685,438,225,0.9232924,3,30,3,0.5136986301369864,
21,2,car,crv,666,1097,456,676,431,220,0.9296913,3,30,3,0.5104408352668214,
22,2,car,crv,680,1120,457,685,440,228,0.9319029,3,30,3,0.5181818181818182,
23,2,car,crv,677,1124,457,685,447,228,0.92194945,3,30,3,0.5100671140939598,
24,2,car,crv,660,1100,454,678,440,224,0.9024779,3,30,3,0.509090909090909,
25,2,car,crv,680,1120,459,684,440,225,0.9350177,3,30,3,0.5113636363636364,
26,2,car,crv,679,1126,457,685,447,228,0.93751395,3,30,3,0.5100671140939598,
27,2,car,crv,682,1118,457,688,436,231,0.906731,3,30,3,0.5298165137614679,
28,2,car,crv,657,1104,453,676,447,223,0.93199766,3,30,3,0.4988814317673378,
29,2,car,crv,658,1104,451,682,446,231,0.9144128,3,30,3,0.5179372197309418,
30,2,car,crv,677,1123,458,686,446,228,0.93931526,3,30,3,0.5112107623318386,
31,2,car,crv,576,1114,415,729,538,314,0.9831566,3,30,3,0.5836431226765799,
32,2,car,crv,585,1120,414,732,535,318,0.9790969,3,30,3,0.594392523364486,
33,2,car,crv,580,1118,412,736,538,324,0.97944313,3,30,3,0.6022304832713755,
0,2,car,crv,659,1104,453,678,445,225,0.9303638,3,30,3,0.5056179775280899,
1,2,car,crv,681,1117,459,686,436,227,0.9399104,3,30,3,2.1627906976744184,
2,2,car,crv,682,1119,460,686,437,226,0.8083159,3,30,3,0.517162471395881,
3,2,car,crv,657,1105,452,682,448,230,0.87961954,3,30,3,0.5133928571428571,
4,2,car,crv,662,1101,455,677,439,222,0.9480402,3,30,3,0.5056947608200456,
5,2,car,crv,681,1120,459,686,439,227,0.9222198,3,30,3,2.152173913043478,
6,2,car,crv,682,1124,461,684,442,223,0.90869683,3,30,3,0.504524886877828,
7,2,car,crv,652,1108,453,677,456,224,0.91756064,3,30,3,2.1020408163265305,
8,2,car,crv,682,1124,460,684,442,224,0.8697906,3,30,3,2.0961538461538463,
9,2,car,crv,675,1130,459,685,455,226,0.9349686,3,30,3,0.4967032967032967,
10,2,car,crv,657,1104,456,672,447,216,0.91418546,3,60,3,1.9821428571428572,
11,2,car,crv,683,1117,462,682,434,220,0.9430802,3,30,3,0.5069124423963134,
12,2,car,crv,681,1119,456,687,438,231,0.93875754,3,30,3,0.5273972602739726,
13,2,car,crv,674,1130,457,688,456,231,0.947293,3,30,3,2.0555555555555554,
14,2,car,crv,681,1119,459,683,438,224,0.9075155,3,30,3,0.5114155251141552,
15,2,car,crv,682,1127,460,687,445,227,0.9177178,3,30,3,0.5101123595505618,
16,2,car,crv,683,1121,462,685,438,223,0.89638394,3,30,3,0.5091324200913242,
17,2,car,crv,681,1121,460,685,440,225,0.919954,3,30,3,0.5113636363636364,
18,2,car,crv,680,1123,460,683,443,223,0.9232944,3,30,3,0.5033860045146726,
19,2,car,crv,659,1103,457,677,444,220,0.9314719,3,30,3,0.4954954954954955,
20,2,car,crv,683,1116,459,686,433,227,0.9467467,3,30,3,0.5242494226327945,
21,2,car,crv,683,1121,460,685,438,225,0.9232924,3,30,3,0.5136986301369864,
22,2,car,crv,666,1097,456,676,431,220,0.9296913,3,30,3,0.5104408352668214,
23,2,car,crv,680,1120,457,685,440,228,0.9319029,3,30,3,0.5181818181818182,
24,2,car,crv,677,1124,457,685,447,228,0.92194945,3,30,3,0.5100671140939598,
25,2,car,crv,660,1100,454,678,440,224,0.9024779,3,30,3,0.509090909090909,
26,2,car,crv,680,1120,459,684,440,225,0.9350177,3,30,3,0.5113636363636364,
27,2,car,crv,679,1126,457,685,447,228,0.93751395,3,30,3,0.5100671140939598,
28,2,car,crv,682,1118,457,688,436,231,0.906731,3,30,3,0.5298165137614679,
29,2,car,crv,657,1104,453,676,447,223,0.93199766,3,30,3,0.4988814317673378,
30,2,car,crv,658,1104,451,682,446,231,0.9144128,3,30,3,0.5179372197309418,
31,2,car,crv,677,1123,458,686,446,228,0.93931526,3,30,3,0.5112107623318386,
32,2,car,crv,576,1114,415,729,538,314,0.9831566,3,30,3,0.5836431226765799,
33,2,car,crv,585,1120,414,732,535,318,0.9790969,3,30,3,0.594392523364486,
34,2,car,crv,580,1118,412,736,538,324,0.97944313,3,30,3,0.6022304832713755,
0,2,car,crv,680,1121,462,683,441,221,0.9124063,3,30,3,0.5011337868480725,
1,2,car,crv,659,1104,453,678,445,225,0.9303638,3,30,3,0.5056179775280899,
2,2,car,crv,681,1117,459,686,436,227,0.9399104,3,30,3,2.1627906976744184,
3,2,car,crv,682,1119,460,686,437,226,0.8083159,3,30,3,0.517162471395881,
4,2,car,crv,657,1105,452,682,448,230,0.87961954,3,30,3,0.5133928571428571,
5,2,car,crv,662,1101,455,677,439,222,0.9480402,3,30,3,0.5056947608200456,
6,2,car,crv,681,1120,459,686,439,227,0.9222198,3,30,3,2.152173913043478,
7,2,car,crv,682,1124,461,684,442,223,0.90869683,3,30,3,0.504524886877828,
8,2,car,crv,652,1108,453,677,456,224,0.91756064,3,30,3,2.1020408163265305,
9,2,car,crv,682,1124,460,684,442,224,0.8697906,3,30,3,2.0961538461538463,
10,2,car,crv,675,1130,459,685,455,226,0.9349686,3,30,3,0.4967032967032967,
11,2,car,crv,657,1104,456,672,447,216,0.91418546,3,60,3,1.9821428571428572,
12,2,car,crv,683,1117,462,682,434,220,0.9430802,3,30,3,0.5069124423963134,
13,2,car,crv,681,1119,456,687,438,231,0.93875754,3,30,3,0.5273972602739726,
14,2,car,crv,674,1130,457,688,456,231,0.947293,3,30,3,2.0555555555555554,
15,2,car,crv,681,1119,459,683,438,224,0.9075155,3,30,3,0.5114155251141552,
16,2,car,crv,682,1127,460,687,445,227,0.9177178,3,30,3,0.5101123595505618,
17,2,car,crv,683,1121,462,685,438,223,0.89638394,3,30,3,0.5091324200913242,
18,2,car,crv,681,1121,460,685,440,225,0.919954,3,30,3,0.5113636363636364,
19,2,car,crv,680,1123,460,683,443,223,0.9232944,3,30,3,0.5033860045146726,
20,2,car,crv,659,1103,457,677,444,220,0.9314719,3,30,3,0.4954954954954955,
21,2,car,crv,683,1116,459,686,433,227,0.9467467,3,30,3,0.5242494226327945,
22,2,car,crv,683,1121,460,685,438,225,0.9232924,3,30,3,0.5136986301369864,
23,2,car,crv,666,1097,456,676,431,220,0.9296913,3,30,3,0.5104408352668214,
24,2,car,crv,680,1120,457,685,440,228,0.9319029,3,30,3,0.5181818181818182,
25,2,car,crv,677,1124,457,685,447,228,0.92194945,3,30,3,0.5100671140939598,
26,2,car,crv,660,1100,454,678,440,224,0.9024779,3,30,3,0.509090909090909,
27,2,car,crv,680,1120,459,684,440,225,0.9350177,3,30,3,0.5113636363636364,
28,2,car,crv,679,1126,457,685,447,228,0.93751395,3,30,3,0.5100671140939598,
29,2,car,crv,682,1118,457,688,436,231,0.906731,3,30,3,0.5298165137614679,
30,2,car,crv,657,1104,453,676,447,223,0.93199766,3,30,3,0.4988814317673378,
31,2,car,crv,658,1104,451,682,446,231,0.9144128,3,30,3,0.5179372197309418,
32,2,car,crv,677,1123,458,686,446,228,0.93931526,3,30,3,0.5112107623318386,
33,2,car,crv,576,1114,415,729,538,314,0.9831566,3,30,3,0.5836431226765799,
34,2,car,crv,585,1120,414,732,535,318,0.9790969,3,30,3,0.594392523364486,
35,2,car,crv,580,1118,412,736,538,324,0.97944313,3,30,3,0.6022304832713755,
0,2,car,crv,655,1105,453,675,450,222,0.9309002,3,30,3,0.49333333333333335,
1,2,car,crv,680,1121,462,683,441,221,0.9124063,3,30,3,0.5011337868480725,
2,2,car,crv,659,1104,453,678,445,225,0.9303638,3,30,3,0.5056179775280899,
3,2,car,crv,681,1117,459,686,436,227,0.9399104,3,30,3,2.1627906976744184,
4,2,car,crv,682,1119,460,686,437,226,0.8083159,3,30,3,0.517162471395881,
5,2,car,crv,657,1105,452,682,448,230,0.87961954,3,30,3,0.5133928571428571,
6,2,car,crv,662,1101,455,677,439,222,0.9480402,3,30,3,0.5056947608200456,
7,2,car,crv,681,1120,459,686,439,227,0.9222198,3,30,3,2.152173913043478,
8,2,car,crv,682,1124,461,684,442,223,0.90869683,3,30,3,0.504524886877828,
9,2,car,crv,652,1108,453,677,456,224,0.91756064,3,30,3,2.1020408163265305,
10,2,car,crv,682,1124,460,684,442,224,0.8697906,3,30,3,2.0961538461538463,
11,2,car,crv,675,1130,459,685,455,226,0.9349686,3,30,3,0.4967032967032967,
12,2,car,crv,657,1104,456,672,447,216,0.91418546,3,60,3,1.9821428571428572,
13,2,car,crv,683,1117,462,682,434,220,0.9430802,3,30,3,0.5069124423963134,
14,2,car,crv,681,1119,456,687,438,231,0.93875754,3,30,3,0.5273972602739726,
15,2,car,crv,674,1130,457,688,456,231,0.947293,3,30,3,2.0555555555555554,
16,2,car,crv,681,1119,459,683,438,224,0.9075155,3,30,3,0.5114155251141552,
17,2,car,crv,682,1127,460,687,445,227,0.9177178,3,30,3,0.5101123595505618,
18,2,car,crv,683,1121,462,685,438,223,0.89638394,3,30,3,0.5091324200913242,
19,2,car,crv,681,1121,460,685,440,225,0.919954,3,30,3,0.5113636363636364,
20,2,car,crv,680,1123,460,683,443,223,0.9232944,3,30,3,0.5033860045146726,
21,2,car,crv,659,1103,457,677,444,220,0.9314719,3,30,3,0.4954954954954955,
22,2,car,crv,683,1116,459,686,433,227,0.9467467,3,30,3,0.5242494226327945,
23,2,car,crv,683,1121,460,685,438,225,0.9232924,3,30,3,0.5136986301369864,
24,2,car,crv,666,1097,456,676,431,220,0.9296913,3,30,3,0.5104408352668214,
25,2,car,crv,680,1120,457,685,440,228,0.9319029,3,30,3,0.5181818181818182,
26,2,car,crv,677,1124,457,685,447,228,0.92194945,3,30,3,0.5100671140939598,
27,2,car,crv,660,1100,454,678,440,224,0.9024779,3,30,3,0.509090909090909,
28,2,car,crv,680,1120,459,684,440,225,0.9350177,3,30,3,0.5113636363636364,
29,2,car,crv,679,1126,457,685,447,228,0.93751395,3,30,3,0.5100671140939598,
30,2,car,crv,682,1118,457,688,436,231,0.906731,3,30,3,0.5298165137614679,
31,2,car,crv,657,1104,453,676,447,223,0.93199766,3,30,3,0.4988814317673378,
32,2,car,crv,658,1104,451,682,446,231,0.9144128,3,30,3,0.5179372197309418,
33,2,car,crv,677,1123,458,686,446,228,0.93931526,3,30,3,0.5112107623318386,
34,2,car,crv,576,1114,415,729,538,314,0.9831566,3,30,3,0.5836431226765799,
35,2,car,crv,585,1120,414,732,535,318,0.9790969,3,30,3,0.594392523364486,
36,2,car,crv,580,1118,412,736,538,324,0.97944313,3,30,3,0.6022304832713755,
