,cid,label,vehicle,left,right,top,bottom,width,height,score,distance_estimate,angle_estimate,real_distance,ratio,elapsed_time
0,2,car,crv,807,1006,489,583,199,94,0.9514729,12,60,11,0.4723618090452261,
0,2,car,crv,810,1001,490,585,191,95,0.9551184,9,30,11,0.4973821989528796,
1,2,car,crv,807,1006,489,583,199,94,0.9514729,12,60,11,0.4723618090452261,
0,2,car,crv,667,819,484,572,152,88,0.7274725,12,30,11,0.5789473684210527,
1,2,car,crv,810,1001,490,585,191,95,0.9551184,9,30,11,0.4973821989528796,
2,2,car,crv,807,1006,489,583,199,94,0.9514729,12,60,11,0.4723618090452261,
0,2,car,crv,667,820,484,572,153,88,0.7759209,12,30,11,0.5751633986928104,
1,2,car,crv,667,819,484,572,152,88,0.7274725,12,30,11,0.5789473684210527,
2,2,car,crv,810,1001,490,585,191,95,0.9551184,9,30,11,0.4973821989528796,
3,2,car,crv,807,1006,489,583,199,94,0.9514729,12,60,11,0.4723618090452261,
0,2,car,crv,668,821,485,574,153,89,0.80433,12,30,11,0.5816993464052288,
1,2,car,crv,667,820,484,572,153,88,0.7759209,12,30,11,0.5751633986928104,
2,2,car,crv,667,819,484,572,152,88,0.7274725,12,30,11,0.5789473684210527,
3,2,car,crv,810,1001,490,585,191,95,0.9551184,9,30,11,0.4973821989528796,
4,2,car,crv,807,1006,489,583,199,94,0.9514729,12,60,11,0.4723618090452261,
0,2,car,crv,667,819,483,575,152,92,0.8056975,12,30,11,0.6052631578947368,
1,2,car,crv,668,821,485,574,153,89,0.80433,12,30,11,0.5816993464052288,
2,2,car,crv,667,820,484,572,153,88,0.7759209,12,30,11,0.5751633986928104,
3,2,car,crv,667,819,484,572,152,88,0.7274725,12,30,11,0.5789473684210527,
4,2,car,crv,810,1001,490,585,191,95,0.9551184,9,30,11,0.4973821989528796,
5,2,car,crv,807,1006,489,583,199,94,0.9514729,12,60,11,0.4723618090452261,
0,2,car,crv,666,820,484,574,154,90,0.78819734,12,30,11,0.5844155844155844,
1,2,car,crv,667,819,483,575,152,92,0.8056975,12,30,11,0.6052631578947368,
2,2,car,crv,668,821,485,574,153,89,0.80433,12,30,11,0.5816993464052288,
3,2,car,crv,667,820,484,572,153,88,0.7759209,12,30,11,0.5751633986928104,
4,2,car,crv,667,819,484,572,152,88,0.7274725,12,30,11,0.5789473684210527,
5,2,car,crv,810,1001,490,585,191,95,0.9551184,9,30,11,0.4973821989528796,
6,2,car,crv,807,1006,489,583,199,94,0.9514729,12,60,11,0.4723618090452261,
0,2,car,crv,669,820,485,574,151,89,0.83562523,12,30,11,0.5894039735099338,
1,2,car,crv,666,820,484,574,154,90,0.78819734,12,30,11,0.5844155844155844,
2,2,car,crv,667,819,483,575,152,92,0.8056975,12,30,11,0.6052631578947368,
3,2,car,crv,668,821,485,574,153,89,0.80433,12,30,11,0.5816993464052288,
4,2,car,crv,667,820,484,572,153,88,0.7759209,12,30,11,0.5751633986928104,
5,2,car,crv,667,819,484,572,152,88,0.7274725,12,30,11,0.5789473684210527,
6,2,car,crv,810,1001,490,585,191,95,0.9551184,9,30,11,0.4973821989528796,
7,2,car,crv,807,1006,489,583,199,94,0.9514729,12,60,11,0.4723618090452261,
0,2,car,crv,662,810,486,571,148,85,0.7150951,12,30,11,0.5743243243243243,
1,2,car,crv,669,820,485,574,151,89,0.83562523,12,30,11,0.5894039735099338,
2,2,car,crv,666,820,484,574,154,90,0.78819734,12,30,11,0.5844155844155844,
3,2,car,crv,667,819,483,575,152,92,0.8056975,12,30,11,0.6052631578947368,
4,2,car,crv,668,821,485,574,153,89,0.80433,12,30,11,0.5816993464052288,
5,2,car,crv,667,820,484,572,153,88,0.7759209,12,30,11,0.5751633986928104,
6,2,car,crv,667,819,484,572,152,88,0.7274725,12,30,11,0.5789473684210527,
7,2,car,crv,810,1001,490,585,191,95,0.9551184,9,30,11,0.4973821989528796,
8,2,car,crv,807,1006,489,583,199,94,0.9514729,12,60,11,0.4723618090452261,
0,2,car,crv,667,819,484,575,152,91,0.7707914,12,30,11,0.5986842105263158,
1,2,car,crv,662,810,486,571,148,85,0.7150951,12,30,11,0.5743243243243243,
2,2,car,crv,669,820,485,574,151,89,0.83562523,12,30,11,0.5894039735099338,
3,2,car,crv,666,820,484,574,154,90,0.78819734,12,30,11,0.5844155844155844,
4,2,car,crv,667,819,483,575,152,92,0.8056975,12,30,11,0.6052631578947368,
5,2,car,crv,668,821,485,574,153,89,0.80433,12,30,11,0.5816993464052288,
6,2,car,crv,667,820,484,572,153,88,0.7759209,12,30,11,0.5751633986928104,
7,2,car,crv,667,819,484,572,152,88,0.7274725,12,30,11,0.5789473684210527,
8,2,car,crv,810,1001,490,585,191,95,0.9551184,9,30,11,0.4973821989528796,
9,2,car,crv,807,1006,489,583,199,94,0.9514729,12,60,11,0.4723618090452261,
0,2,car,crv,667,820,484,577,153,93,0.7404891,12,30,11,0.6078431372549019,
1,2,car,crv,667,819,484,575,152,91,0.7707914,12,30,11,0.5986842105263158,
2,2,car,crv,662,810,486,571,148,85,0.7150951,12,30,11,0.5743243243243243,
3,2,car,crv,669,820,485,574,151,89,0.83562523,12,30,11,0.5894039735099338,
4,2,car,crv,666,820,484,574,154,90,0.78819734,12,30,11,0.5844155844155844,
5,2,car,crv,667,819,483,575,152,92,0.8056975,12,30,11,0.6052631578947368,
6,2,car,crv,668,821,485,574,153,89,0.80433,12,30,11,0.5816993464052288,
7,2,car,crv,667,820,484,572,153,88,0.7759209,12,30,11,0.5751633986928104,
8,2,car,crv,667,819,484,572,152,88,0.7274725,12,30,11,0.5789473684210527,
9,2,car,crv,810,1001,490,585,191,95,0.9551184,9,30,11,0.4973821989528796,
10,2,car,crv,807,1006,489,583,199,94,0.9514729,12,60,11,0.4723618090452261,
0,2,car,crv,667,819,485,574,152,89,0.71991515,12,30,11,0.5855263157894737,
1,2,car,crv,667,820,484,577,153,93,0.7404891,12,30,11,0.6078431372549019,
2,2,car,crv,667,819,484,575,152,91,0.7707914,12,30,11,0.5986842105263158,
3,2,car,crv,662,810,486,571,148,85,0.7150951,12,30,11,0.5743243243243243,
4,2,car,crv,669,820,485,574,151,89,0.83562523,12,30,11,0.5894039735099338,
5,2,car,crv,666,820,484,574,154,90,0.78819734,12,30,11,0.5844155844155844,
6,2,car,crv,667,819,483,575,152,92,0.8056975,12,30,11,0.6052631578947368,
7,2,car,crv,668,821,485,574,153,89,0.80433,12,30,11,0.5816993464052288,
8,2,car,crv,667,820,484,572,153,88,0.7759209,12,30,11,0.5751633986928104,
9,2,car,crv,667,819,484,572,152,88,0.7274725,12,30,11,0.5789473684210527,
10,2,car,crv,810,1001,490,585,191,95,0.9551184,9,30,11,0.4973821989528796,
11,2,car,crv,807,1006,489,583,199,94,0.9514729,12,60,11,0.4723618090452261,
0,2,car,crv,668,821,485,574,153,89,0.8785678,12,30,11,0.5816993464052288,
1,2,car,crv,667,819,485,574,152,89,0.71991515,12,30,11,0.5855263157894737,
2,2,car,crv,667,820,484,577,153,93,0.7404891,12,30,11,0.6078431372549019,
3,2,car,crv,667,819,484,575,152,91,0.7707914,12,30,11,0.5986842105263158,
4,2,car,crv,662,810,486,571,148,85,0.7150951,12,30,11,0.5743243243243243,
5,2,car,crv,669,820,485,574,151,89,0.83562523,12,30,11,0.5894039735099338,
6,2,car,crv,666,820,484,574,154,90,0.78819734,12,30,11,0.5844155844155844,
7,2,car,crv,667,819,483,575,152,92,0.8056975,12,30,11,0.6052631578947368,
8,2,car,crv,668,821,485,574,153,89,0.80433,12,30,11,0.5816993464052288,
9,2,car,crv,667,820,484,572,153,88,0.7759209,12,30,11,0.5751633986928104,
10,2,car,crv,667,819,484,572,152,88,0.7274725,12,30,11,0.5789473684210527,
11,2,car,crv,810,1001,490,585,191,95,0.9551184,9,30,11,0.4973821989528796,
12,2,car,crv,807,1006,489,583,199,94,0.9514729,12,60,11,0.4723618090452261,
0,2,car,crv,667,819,484,575,152,91,0.9125865,12,30,11,0.5986842105263158,
1,2,car,crv,668,821,485,574,153,89,0.8785678,12,30,11,0.5816993464052288,
2,2,car,crv,667,819,485,574,152,89,0.71991515,12,30,11,0.5855263157894737,
3,2,car,crv,667,820,484,577,153,93,0.7404891,12,30,11,0.6078431372549019,
4,2,car,crv,667,819,484,575,152,91,0.7707914,12,30,11,0.5986842105263158,
5,2,car,crv,662,810,486,571,148,85,0.7150951,12,30,11,0.5743243243243243,
6,2,car,crv,669,820,485,574,151,89,0.83562523,12,30,11,0.5894039735099338,
7,2,car,crv,666,820,484,574,154,90,0.78819734,12,30,11,0.5844155844155844,
8,2,car,crv,667,819,483,575,152,92,0.8056975,12,30,11,0.6052631578947368,
9,2,car,crv,668,821,485,574,153,89,0.80433,12,30,11,0.5816993464052288,
10,2,car,crv,667,820,484,572,153,88,0.7759209,12,30,11,0.5751633986928104,
11,2,car,crv,667,819,484,572,152,88,0.7274725,12,30,11,0.5789473684210527,
12,2,car,crv,810,1001,490,585,191,95,0.9551184,9,30,11,0.4973821989528796,
13,2,car,crv,807,1006,489,583,199,94,0.9514729,12,60,11,0.4723618090452261,
0,2,car,crv,667,820,485,573,153,88,0.8438455,12,30,11,0.5751633986928104,
1,2,car,crv,667,819,484,575,152,91,0.9125865,12,30,11,0.5986842105263158,
2,2,car,crv,668,821,485,574,153,89,0.8785678,12,30,11,0.5816993464052288,
3,2,car,crv,667,819,485,574,152,89,0.71991515,12,30,11,0.5855263157894737,
4,2,car,crv,667,820,484,577,153,93,0.7404891,12,30,11,0.6078431372549019,
5,2,car,crv,667,819,484,575,152,91,0.7707914,12,30,11,0.5986842105263158,
6,2,car,crv,662,810,486,571,148,85,0.7150951,12,30,11,0.5743243243243243,
7,2,car,crv,669,820,485,574,151,89,0.83562523,12,30,11,0.5894039735099338,
8,2,car,crv,666,820,484,574,154,90,0.78819734,12,30,11,0.5844155844155844,
9,2,car,crv,667,819,483,575,152,92,0.8056975,12,30,11,0.6052631578947368,
10,2,car,crv,668,821,485,574,153,89,0.80433,12,30,11,0.5816993464052288,
11,2,car,crv,667,820,484,572,153,88,0.7759209,12,30,11,0.5751633986928104,
12,2,car,crv,667,819,484,572,152,88,0.7274725,12,30,11,0.5789473684210527,
13,2,car,crv,810,1001,490,585,191,95,0.9551184,9,30,11,0.4973821989528796,
14,2,car,crv,807,1006,489,583,199,94,0.9514729,12,60,11,0.4723618090452261,
0,2,car,crv,666,820,482,577,154,95,0.80031437,9,0,11,0.6168831168831169,
1,2,car,crv,667,820,485,573,153,88,0.8438455,12,30,11,0.5751633986928104,
2,2,car,crv,667,819,484,575,152,91,0.9125865,12,30,11,0.5986842105263158,
3,2,car,crv,668,821,485,574,153,89,0.8785678,12,30,11,0.5816993464052288,
4,2,car,crv,667,819,485,574,152,89,0.71991515,12,30,11,0.5855263157894737,
5,2,car,crv,667,820,484,577,153,93,0.7404891,12,30,11,0.6078431372549019,
6,2,car,crv,667,819,484,575,152,91,0.7707914,12,30,11,0.5986842105263158,
7,2,car,crv,662,810,486,571,148,85,0.7150951,12,30,11,0.5743243243243243,
8,2,car,crv,669,820,485,574,151,89,0.83562523,12,30,11,0.5894039735099338,
9,2,car,crv,666,820,484,574,154,90,0.78819734,12,30,11,0.5844155844155844,
10,2,car,crv,667,819,483,575,152,92,0.8056975,12,30,11,0.6052631578947368,
11,2,car,crv,668,821,485,574,153,89,0.80433,12,30,11,0.5816993464052288,
12,2,car,crv,667,820,484,572,153,88,0.7759209,12,30,11,0.5751633986928104,
13,2,car,crv,667,819,484,572,152,88,0.7274725,12,30,11,0.5789473684210527,
14,2,car,crv,810,1001,490,585,191,95,0.9551184,9,30,11,0.4973821989528796,
15,2,car,crv,807,1006,489,583,199,94,0.9514729,12,60,11,0.4723618090452261,
0,2,car,crv,667,819,485,574,152,89,0.8128246,12,30,11,0.5855263157894737,
1,2,car,crv,666,820,482,577,154,95,0.80031437,9,0,11,0.6168831168831169,
2,2,car,crv,667,820,485,573,153,88,0.8438455,12,30,11,0.5751633986928104,
3,2,car,crv,667,819,484,575,152,91,0.9125865,12,30,11,0.5986842105263158,
4,2,car,crv,668,821,485,574,153,89,0.8785678,12,30,11,0.5816993464052288,
5,2,car,crv,667,819,485,574,152,89,0.71991515,12,30,11,0.5855263157894737,
6,2,car,crv,667,820,484,577,153,93,0.7404891,12,30,11,0.6078431372549019,
7,2,car,crv,667,819,484,575,152,91,0.7707914,12,30,11,0.5986842105263158,
8,2,car,crv,662,810,486,571,148,85,0.7150951,12,30,11,0.5743243243243243,
9,2,car,crv,669,820,485,574,151,89,0.83562523,12,30,11,0.5894039735099338,
10,2,car,crv,666,820,484,574,154,90,0.78819734,12,30,11,0.5844155844155844,
11,2,car,crv,667,819,483,575,152,92,0.8056975,12,30,11,0.6052631578947368,
12,2,car,crv,668,821,485,574,153,89,0.80433,12,30,11,0.5816993464052288,
13,2,car,crv,667,820,484,572,153,88,0.7759209,12,30,11,0.5751633986928104,
14,2,car,crv,667,819,484,572,152,88,0.7274725,12,30,11,0.5789473684210527,
15,2,car,crv,810,1001,490,585,191,95,0.9551184,9,30,11,0.4973821989528796,
16,2,car,crv,807,1006,489,583,199,94,0.9514729,12,60,11,0.4723618090452261,
0,2,car,crv,663,810,486,569,147,83,0.7781846,12,30,11,0.564625850340136,
1,2,car,crv,667,819,485,574,152,89,0.8128246,12,30,11,0.5855263157894737,
2,2,car,crv,666,820,482,577,154,95,0.80031437,9,0,11,0.6168831168831169,
3,2,car,crv,667,820,485,573,153,88,0.8438455,12,30,11,0.5751633986928104,
4,2,car,crv,667,819,484,575,152,91,0.9125865,12,30,11,0.5986842105263158,
5,2,car,crv,668,821,485,574,153,89,0.8785678,12,30,11,0.5816993464052288,
6,2,car,crv,667,819,485,574,152,89,0.71991515,12,30,11,0.5855263157894737,
7,2,car,crv,667,820,484,577,153,93,0.7404891,12,30,11,0.6078431372549019,
8,2,car,crv,667,819,484,575,152,91,0.7707914,12,30,11,0.5986842105263158,
9,2,car,crv,662,810,486,571,148,85,0.7150951,12,30,11,0.5743243243243243,
10,2,car,crv,669,820,485,574,151,89,0.83562523,12,30,11,0.5894039735099338,
11,2,car,crv,666,820,484,574,154,90,0.78819734,12,30,11,0.5844155844155844,
12,2,car,crv,667,819,483,575,152,92,0.8056975,12,30,11,0.6052631578947368,
13,2,car,crv,668,821,485,574,153,89,0.80433,12,30,11,0.5816993464052288,
14,2,car,crv,667,820,484,572,153,88,0.7759209,12,30,11,0.5751633986928104,
15,2,car,crv,667,819,484,572,152,88,0.7274725,12,30,11,0.5789473684210527,
16,2,car,crv,810,1001,490,585,191,95,0.9551184,9,30,11,0.4973821989528796,
17,2,car,crv,807,1006,489,583,199,94,0.9514729,12,60,11,0.4723618090452261,
0,2,car,crv,667,820,484,575,153,91,0.78723717,12,30,11,0.5947712418300654,
1,2,car,crv,663,810,486,569,147,83,0.7781846,12,30,11,0.564625850340136,
2,2,car,crv,667,819,485,574,152,89,0.8128246,12,30,11,0.5855263157894737,
3,2,car,crv,666,820,482,577,154,95,0.80031437,9,0,11,0.6168831168831169,
4,2,car,crv,667,820,485,573,153,88,0.8438455,12,30,11,0.5751633986928104,
5,2,car,crv,667,819,484,575,152,91,0.9125865,12,30,11,0.5986842105263158,
6,2,car,crv,668,821,485,574,153,89,0.8785678,12,30,11,0.5816993464052288,
7,2,car,crv,667,819,485,574,152,89,0.71991515,12,30,11,0.5855263157894737,
8,2,car,crv,667,820,484,577,153,93,0.7404891,12,30,11,0.6078431372549019,
9,2,car,crv,667,819,484,575,152,91,0.7707914,12,30,11,0.5986842105263158,
10,2,car,crv,662,810,486,571,148,85,0.7150951,12,30,11,0.5743243243243243,
11,2,car,crv,669,820,485,574,151,89,0.83562523,12,30,11,0.5894039735099338,
12,2,car,crv,666,820,484,574,154,90,0.78819734,12,30,11,0.5844155844155844,
13,2,car,crv,667,819,483,575,152,92,0.8056975,12,30,11,0.6052631578947368,
14,2,car,crv,668,821,485,574,153,89,0.80433,12,30,11,0.5816993464052288,
15,2,car,crv,667,820,484,572,153,88,0.7759209,12,30,11,0.5751633986928104,
16,2,car,crv,667,819,484,572,152,88,0.7274725,12,30,11,0.5789473684210527,
17,2,car,crv,810,1001,490,585,191,95,0.9551184,9,30,11,0.4973821989528796,
18,2,car,crv,807,1006,489,583,199,94,0.9514729,12,60,11,0.4723618090452261,
0,2,car,crv,667,820,485,574,153,89,0.8488218,12,30,11,0.5816993464052288,
1,2,car,crv,667,820,484,575,153,91,0.78723717,12,30,11,0.5947712418300654,
2,2,car,crv,663,810,486,569,147,83,0.7781846,12,30,11,0.564625850340136,
3,2,car,crv,667,819,485,574,152,89,0.8128246,12,30,11,0.5855263157894737,
4,2,car,crv,666,820,482,577,154,95,0.80031437,9,0,11,0.6168831168831169,
5,2,car,crv,667,820,485,573,153,88,0.8438455,12,30,11,0.5751633986928104,
6,2,car,crv,667,819,484,575,152,91,0.9125865,12,30,11,0.5986842105263158,
7,2,car,crv,668,821,485,574,153,89,0.8785678,12,30,11,0.5816993464052288,
8,2,car,crv,667,819,485,574,152,89,0.71991515,12,30,11,0.5855263157894737,
9,2,car,crv,667,820,484,577,153,93,0.7404891,12,30,11,0.6078431372549019,
10,2,car,crv,667,819,484,575,152,91,0.7707914,12,30,11,0.5986842105263158,
11,2,car,crv,662,810,486,571,148,85,0.7150951,12,30,11,0.5743243243243243,
12,2,car,crv,669,820,485,574,151,89,0.83562523,12,30,11,0.5894039735099338,
13,2,car,crv,666,820,484,574,154,90,0.78819734,12,30,11,0.5844155844155844,
14,2,car,crv,667,819,483,575,152,92,0.8056975,12,30,11,0.6052631578947368,
15,2,car,crv,668,821,485,574,153,89,0.80433,12,30,11,0.5816993464052288,
16,2,car,crv,667,820,484,572,153,88,0.7759209,12,30,11,0.5751633986928104,
17,2,car,crv,667,819,484,572,152,88,0.7274725,12,30,11,0.5789473684210527,
18,2,car,crv,810,1001,490,585,191,95,0.9551184,9,30,11,0.4973821989528796,
19,2,car,crv,807,1006,489,583,199,94,0.9514729,12,60,11,0.4723618090452261,
0,2,car,crv,667,820,484,575,153,91,0.772995,12,30,11,0.5947712418300654,
1,2,car,crv,667,820,485,574,153,89,0.8488218,12,30,11,0.5816993464052288,
2,2,car,crv,667,820,484,575,153,91,0.78723717,12,30,11,0.5947712418300654,
3,2,car,crv,663,810,486,569,147,83,0.7781846,12,30,11,0.564625850340136,
4,2,car,crv,667,819,485,574,152,89,0.8128246,12,30,11,0.5855263157894737,
5,2,car,crv,666,820,482,577,154,95,0.80031437,9,0,11,0.6168831168831169,
6,2,car,crv,667,820,485,573,153,88,0.8438455,12,30,11,0.5751633986928104,
7,2,car,crv,667,819,484,575,152,91,0.9125865,12,30,11,0.5986842105263158,
8,2,car,crv,668,821,485,574,153,89,0.8785678,12,30,11,0.5816993464052288,
9,2,car,crv,667,819,485,574,152,89,0.71991515,12,30,11,0.5855263157894737,
10,2,car,crv,667,820,484,577,153,93,0.7404891,12,30,11,0.6078431372549019,
11,2,car,crv,667,819,484,575,152,91,0.7707914,12,30,11,0.5986842105263158,
12,2,car,crv,662,810,486,571,148,85,0.7150951,12,30,11,0.5743243243243243,
13,2,car,crv,669,820,485,574,151,89,0.83562523,12,30,11,0.5894039735099338,
14,2,car,crv,666,820,484,574,154,90,0.78819734,12,30,11,0.5844155844155844,
15,2,car,crv,667,819,483,575,152,92,0.8056975,12,30,11,0.6052631578947368,
16,2,car,crv,668,821,485,574,153,89,0.80433,12,30,11,0.5816993464052288,
17,2,car,crv,667,820,484,572,153,88,0.7759209,12,30,11,0.5751633986928104,
18,2,car,crv,667,819,484,572,152,88,0.7274725,12,30,11,0.5789473684210527,
19,2,car,crv,810,1001,490,585,191,95,0.9551184,9,30,11,0.4973821989528796,
20,2,car,crv,807,1006,489,583,199,94,0.9514729,12,60,11,0.4723618090452261,
0,2,car,crv,667,820,483,575,153,92,0.66239387,12,30,11,0.6013071895424836,
1,2,car,crv,667,820,484,575,153,91,0.772995,12,30,11,0.5947712418300654,
2,2,car,crv,667,820,485,574,153,89,0.8488218,12,30,11,0.5816993464052288,
3,2,car,crv,667,820,484,575,153,91,0.78723717,12,30,11,0.5947712418300654,
4,2,car,crv,663,810,486,569,147,83,0.7781846,12,30,11,0.564625850340136,
5,2,car,crv,667,819,485,574,152,89,0.8128246,12,30,11,0.5855263157894737,
6,2,car,crv,666,820,482,577,154,95,0.80031437,9,0,11,0.6168831168831169,
7,2,car,crv,667,820,485,573,153,88,0.8438455,12,30,11,0.5751633986928104,
8,2,car,crv,667,819,484,575,152,91,0.9125865,12,30,11,0.5986842105263158,
9,2,car,crv,668,821,485,574,153,89,0.8785678,12,30,11,0.5816993464052288,
10,2,car,crv,667,819,485,574,152,89,0.71991515,12,30,11,0.5855263157894737,
11,2,car,crv,667,820,484,577,153,93,0.7404891,12,30,11,0.6078431372549019,
12,2,car,crv,667,819,484,575,152,91,0.7707914,12,30,11,0.5986842105263158,
13,2,car,crv,662,810,486,571,148,85,0.7150951,12,30,11,0.5743243243243243,
14,2,car,crv,669,820,485,574,151,89,0.83562523,12,30,11,0.5894039735099338,
15,2,car,crv,666,820,484,574,154,90,0.78819734,12,30,11,0.5844155844155844,
16,2,car,crv,667,819,483,575,152,92,0.8056975,12,30,11,0.6052631578947368,
17,2,car,crv,668,821,485,574,153,89,0.80433,12,30,11,0.5816993464052288,
18,2,car,crv,667,820,484,572,153,88,0.7759209,12,30,11,0.5751633986928104,
19,2,car,crv,667,819,484,572,152,88,0.7274725,12,30,11,0.5789473684210527,
20,2,car,crv,810,1001,490,585,191,95,0.9551184,9,30,11,0.4973821989528796,
21,2,car,crv,807,1006,489,583,199,94,0.9514729,12,60,11,0.4723618090452261,
0,2,car,crv,668,820,484,574,152,90,0.8056128,12,30,11,0.5921052631578947,
1,2,car,crv,667,820,483,575,153,92,0.66239387,12,30,11,0.6013071895424836,
2,2,car,crv,667,820,484,575,153,91,0.772995,12,30,11,0.5947712418300654,
3,2,car,crv,667,820,485,574,153,89,0.8488218,12,30,11,0.5816993464052288,
4,2,car,crv,667,820,484,575,153,91,0.78723717,12,30,11,0.5947712418300654,
5,2,car,crv,663,810,486,569,147,83,0.7781846,12,30,11,0.564625850340136,
6,2,car,crv,667,819,485,574,152,89,0.8128246,12,30,11,0.5855263157894737,
7,2,car,crv,666,820,482,577,154,95,0.80031437,9,0,11,0.6168831168831169,
8,2,car,crv,667,820,485,573,153,88,0.8438455,12,30,11,0.5751633986928104,
9,2,car,crv,667,819,484,575,152,91,0.9125865,12,30,11,0.5986842105263158,
10,2,car,crv,668,821,485,574,153,89,0.8785678,12,30,11,0.5816993464052288,
11,2,car,crv,667,819,485,574,152,89,0.71991515,12,30,11,0.5855263157894737,
12,2,car,crv,667,820,484,577,153,93,0.7404891,12,30,11,0.6078431372549019,
13,2,car,crv,667,819,484,575,152,91,0.7707914,12,30,11,0.5986842105263158,
14,2,car,crv,662,810,486,571,148,85,0.7150951,12,30,11,0.5743243243243243,
15,2,car,crv,669,820,485,574,151,89,0.83562523,12,30,11,0.5894039735099338,
16,2,car,crv,666,820,484,574,154,90,0.78819734,12,30,11,0.5844155844155844,
17,2,car,crv,667,819,483,575,152,92,0.8056975,12,30,11,0.6052631578947368,
18,2,car,crv,668,821,485,574,153,89,0.80433,12,30,11,0.5816993464052288,
19,2,car,crv,667,820,484,572,153,88,0.7759209,12,30,11,0.5751633986928104,
20,2,car,crv,667,819,484,572,152,88,0.7274725,12,30,11,0.5789473684210527,
21,2,car,crv,810,1001,490,585,191,95,0.9551184,9,30,11,0.4973821989528796,
22,2,car,crv,807,1006,489,583,199,94,0.9514729,12,60,11,0.4723618090452261,
0,2,car,crv,667,820,484,575,153,91,0.8413766,12,30,11,0.5947712418300654,
1,2,car,crv,668,820,484,574,152,90,0.8056128,12,30,11,0.5921052631578947,
2,2,car,crv,667,820,483,575,153,92,0.66239387,12,30,11,0.6013071895424836,
3,2,car,crv,667,820,484,575,153,91,0.772995,12,30,11,0.5947712418300654,
4,2,car,crv,667,820,485,574,153,89,0.8488218,12,30,11,0.5816993464052288,
5,2,car,crv,667,820,484,575,153,91,0.78723717,12,30,11,0.5947712418300654,
6,2,car,crv,663,810,486,569,147,83,0.7781846,12,30,11,0.564625850340136,
7,2,car,crv,667,819,485,574,152,89,0.8128246,12,30,11,0.5855263157894737,
8,2,car,crv,666,820,482,577,154,95,0.80031437,9,0,11,0.6168831168831169,
9,2,car,crv,667,820,485,573,153,88,0.8438455,12,30,11,0.5751633986928104,
10,2,car,crv,667,819,484,575,152,91,0.9125865,12,30,11,0.5986842105263158,
11,2,car,crv,668,821,485,574,153,89,0.8785678,12,30,11,0.5816993464052288,
12,2,car,crv,667,819,485,574,152,89,0.71991515,12,30,11,0.5855263157894737,
13,2,car,crv,667,820,484,577,153,93,0.7404891,12,30,11,0.6078431372549019,
14,2,car,crv,667,819,484,575,152,91,0.7707914,12,30,11,0.5986842105263158,
15,2,car,crv,662,810,486,571,148,85,0.7150951,12,30,11,0.5743243243243243,
16,2,car,crv,669,820,485,574,151,89,0.83562523,12,30,11,0.5894039735099338,
17,2,car,crv,666,820,484,574,154,90,0.78819734,12,30,11,0.5844155844155844,
18,2,car,crv,667,819,483,575,152,92,0.8056975,12,30,11,0.6052631578947368,
19,2,car,crv,668,821,485,574,153,89,0.80433,12,30,11,0.5816993464052288,
20,2,car,crv,667,820,484,572,153,88,0.7759209,12,30,11,0.5751633986928104,
21,2,car,crv,667,819,484,572,152,88,0.7274725,12,30,11,0.5789473684210527,
22,2,car,crv,810,1001,490,585,191,95,0.9551184,9,30,11,0.4973821989528796,
23,2,car,crv,807,1006,489,583,199,94,0.9514729,12,60,11,0.4723618090452261,
0,2,car,crv,668,821,484,575,153,91,0.7870298,12,30,11,0.5947712418300654,
1,2,car,crv,667,820,484,575,153,91,0.8413766,12,30,11,0.5947712418300654,
2,2,car,crv,668,820,484,574,152,90,0.8056128,12,30,11,0.5921052631578947,
3,2,car,crv,667,820,483,575,153,92,0.66239387,12,30,11,0.6013071895424836,
4,2,car,crv,667,820,484,575,153,91,0.772995,12,30,11,0.5947712418300654,
5,2,car,crv,667,820,485,574,153,89,0.8488218,12,30,11,0.5816993464052288,
6,2,car,crv,667,820,484,575,153,91,0.78723717,12,30,11,0.5947712418300654,
7,2,car,crv,663,810,486,569,147,83,0.7781846,12,30,11,0.564625850340136,
8,2,car,crv,667,819,485,574,152,89,0.8128246,12,30,11,0.5855263157894737,
9,2,car,crv,666,820,482,577,154,95,0.80031437,9,0,11,0.6168831168831169,
10,2,car,crv,667,820,485,573,153,88,0.8438455,12,30,11,0.5751633986928104,
11,2,car,crv,667,819,484,575,152,91,0.9125865,12,30,11,0.5986842105263158,
12,2,car,crv,668,821,485,574,153,89,0.8785678,12,30,11,0.5816993464052288,
13,2,car,crv,667,819,485,574,152,89,0.71991515,12,30,11,0.5855263157894737,
14,2,car,crv,667,820,484,577,153,93,0.7404891,12,30,11,0.6078431372549019,
15,2,car,crv,667,819,484,575,152,91,0.7707914,12,30,11,0.5986842105263158,
16,2,car,crv,662,810,486,571,148,85,0.7150951,12,30,11,0.5743243243243243,
17,2,car,crv,669,820,485,574,151,89,0.83562523,12,30,11,0.5894039735099338,
18,2,car,crv,666,820,484,574,154,90,0.78819734,12,30,11,0.5844155844155844,
19,2,car,crv,667,819,483,575,152,92,0.8056975,12,30,11,0.6052631578947368,
20,2,car,crv,668,821,485,574,153,89,0.80433,12,30,11,0.5816993464052288,
21,2,car,crv,667,820,484,572,153,88,0.7759209,12,30,11,0.5751633986928104,
22,2,car,crv,667,819,484,572,152,88,0.7274725,12,30,11,0.5789473684210527,
23,2,car,crv,810,1001,490,585,191,95,0.9551184,9,30,11,0.4973821989528796,
24,2,car,crv,807,1006,489,583,199,94,0.9514729,12,60,11,0.4723618090452261,
0,2,car,crv,668,818,483,573,150,90,0.7379781,12,30,11,0.6,
1,2,car,crv,668,821,484,575,153,91,0.7870298,12,30,11,0.5947712418300654,
2,2,car,crv,667,820,484,575,153,91,0.8413766,12,30,11,0.5947712418300654,
3,2,car,crv,668,820,484,574,152,90,0.8056128,12,30,11,0.5921052631578947,
4,2,car,crv,667,820,483,575,153,92,0.66239387,12,30,11,0.6013071895424836,
5,2,car,crv,667,820,484,575,153,91,0.772995,12,30,11,0.5947712418300654,
6,2,car,crv,667,820,485,574,153,89,0.8488218,12,30,11,0.5816993464052288,
7,2,car,crv,667,820,484,575,153,91,0.78723717,12,30,11,0.5947712418300654,
8,2,car,crv,663,810,486,569,147,83,0.7781846,12,30,11,0.564625850340136,
9,2,car,crv,667,819,485,574,152,89,0.8128246,12,30,11,0.5855263157894737,
10,2,car,crv,666,820,482,577,154,95,0.80031437,9,0,11,0.6168831168831169,
11,2,car,crv,667,820,485,573,153,88,0.8438455,12,30,11,0.5751633986928104,
12,2,car,crv,667,819,484,575,152,91,0.9125865,12,30,11,0.5986842105263158,
13,2,car,crv,668,821,485,574,153,89,0.8785678,12,30,11,0.5816993464052288,
14,2,car,crv,667,819,485,574,152,89,0.71991515,12,30,11,0.5855263157894737,
15,2,car,crv,667,820,484,577,153,93,0.7404891,12,30,11,0.6078431372549019,
16,2,car,crv,667,819,484,575,152,91,0.7707914,12,30,11,0.5986842105263158,
17,2,car,crv,662,810,486,571,148,85,0.7150951,12,30,11,0.5743243243243243,
18,2,car,crv,669,820,485,574,151,89,0.83562523,12,30,11,0.5894039735099338,
19,2,car,crv,666,820,484,574,154,90,0.78819734,12,30,11,0.5844155844155844,
20,2,car,crv,667,819,483,575,152,92,0.8056975,12,30,11,0.6052631578947368,
21,2,car,crv,668,821,485,574,153,89,0.80433,12,30,11,0.5816993464052288,
22,2,car,crv,667,820,484,572,153,88,0.7759209,12,30,11,0.5751633986928104,
23,2,car,crv,667,819,484,572,152,88,0.7274725,12,30,11,0.5789473684210527,
24,2,car,crv,810,1001,490,585,191,95,0.9551184,9,30,11,0.4973821989528796,
25,2,car,crv,807,1006,489,583,199,94,0.9514729,12,60,11,0.4723618090452261,
0,2,car,crv,668,819,484,574,151,90,0.7223766,12,30,11,0.5960264900662252,
1,2,car,crv,668,818,483,573,150,90,0.7379781,12,30,11,0.6,
2,2,car,crv,668,821,484,575,153,91,0.7870298,12,30,11,0.5947712418300654,
3,2,car,crv,667,820,484,575,153,91,0.8413766,12,30,11,0.5947712418300654,
4,2,car,crv,668,820,484,574,152,90,0.8056128,12,30,11,0.5921052631578947,
5,2,car,crv,667,820,483,575,153,92,0.66239387,12,30,11,0.6013071895424836,
6,2,car,crv,667,820,484,575,153,91,0.772995,12,30,11,0.5947712418300654,
7,2,car,crv,667,820,485,574,153,89,0.8488218,12,30,11,0.5816993464052288,
8,2,car,crv,667,820,484,575,153,91,0.78723717,12,30,11,0.5947712418300654,
9,2,car,crv,663,810,486,569,147,83,0.7781846,12,30,11,0.564625850340136,
10,2,car,crv,667,819,485,574,152,89,0.8128246,12,30,11,0.5855263157894737,
11,2,car,crv,666,820,482,577,154,95,0.80031437,9,0,11,0.6168831168831169,
12,2,car,crv,667,820,485,573,153,88,0.8438455,12,30,11,0.5751633986928104,
13,2,car,crv,667,819,484,575,152,91,0.9125865,12,30,11,0.5986842105263158,
14,2,car,crv,668,821,485,574,153,89,0.8785678,12,30,11,0.5816993464052288,
15,2,car,crv,667,819,485,574,152,89,0.71991515,12,30,11,0.5855263157894737,
16,2,car,crv,667,820,484,577,153,93,0.7404891,12,30,11,0.6078431372549019,
17,2,car,crv,667,819,484,575,152,91,0.7707914,12,30,11,0.5986842105263158,
18,2,car,crv,662,810,486,571,148,85,0.7150951,12,30,11,0.5743243243243243,
19,2,car,crv,669,820,485,574,151,89,0.83562523,12,30,11,0.5894039735099338,
20,2,car,crv,666,820,484,574,154,90,0.78819734,12,30,11,0.5844155844155844,
21,2,car,crv,667,819,483,575,152,92,0.8056975,12,30,11,0.6052631578947368,
22,2,car,crv,668,821,485,574,153,89,0.80433,12,30,11,0.5816993464052288,
23,2,car,crv,667,820,484,572,153,88,0.7759209,12,30,11,0.5751633986928104,
24,2,car,crv,667,819,484,572,152,88,0.7274725,12,30,11,0.5789473684210527,
25,2,car,crv,810,1001,490,585,191,95,0.9551184,9,30,11,0.4973821989528796,
26,2,car,crv,807,1006,489,583,199,94,0.9514729,12,60,11,0.4723618090452261,
0,2,car,crv,667,819,484,575,152,91,0.83604145,12,30,11,0.5986842105263158,
1,2,car,crv,668,819,484,574,151,90,0.7223766,12,30,11,0.5960264900662252,
2,2,car,crv,668,818,483,573,150,90,0.7379781,12,30,11,0.6,
3,2,car,crv,668,821,484,575,153,91,0.7870298,12,30,11,0.5947712418300654,
4,2,car,crv,667,820,484,575,153,91,0.8413766,12,30,11,0.5947712418300654,
5,2,car,crv,668,820,484,574,152,90,0.8056128,12,30,11,0.5921052631578947,
6,2,car,crv,667,820,483,575,153,92,0.66239387,12,30,11,0.6013071895424836,
7,2,car,crv,667,820,484,575,153,91,0.772995,12,30,11,0.5947712418300654,
8,2,car,crv,667,820,485,574,153,89,0.8488218,12,30,11,0.5816993464052288,
9,2,car,crv,667,820,484,575,153,91,0.78723717,12,30,11,0.5947712418300654,
10,2,car,crv,663,810,486,569,147,83,0.7781846,12,30,11,0.564625850340136,
11,2,car,crv,667,819,485,574,152,89,0.8128246,12,30,11,0.5855263157894737,
12,2,car,crv,666,820,482,577,154,95,0.80031437,9,0,11,0.6168831168831169,
13,2,car,crv,667,820,485,573,153,88,0.8438455,12,30,11,0.5751633986928104,
14,2,car,crv,667,819,484,575,152,91,0.9125865,12,30,11,0.5986842105263158,
15,2,car,crv,668,821,485,574,153,89,0.8785678,12,30,11,0.5816993464052288,
16,2,car,crv,667,819,485,574,152,89,0.71991515,12,30,11,0.5855263157894737,
17,2,car,crv,667,820,484,577,153,93,0.7404891,12,30,11,0.6078431372549019,
18,2,car,crv,667,819,484,575,152,91,0.7707914,12,30,11,0.5986842105263158,
19,2,car,crv,662,810,486,571,148,85,0.7150951,12,30,11,0.5743243243243243,
20,2,car,crv,669,820,485,574,151,89,0.83562523,12,30,11,0.5894039735099338,
21,2,car,crv,666,820,484,574,154,90,0.78819734,12,30,11,0.5844155844155844,
22,2,car,crv,667,819,483,575,152,92,0.8056975,12,30,11,0.6052631578947368,
23,2,car,crv,668,821,485,574,153,89,0.80433,12,30,11,0.5816993464052288,
24,2,car,crv,667,820,484,572,153,88,0.7759209,12,30,11,0.5751633986928104,
25,2,car,crv,667,819,484,572,152,88,0.7274725,12,30,11,0.5789473684210527,
26,2,car,crv,810,1001,490,585,191,95,0.9551184,9,30,11,0.4973821989528796,
27,2,car,crv,807,1006,489,583,199,94,0.9514729,12,60,11,0.4723618090452261,
0,2,car,crv,667,819,483,574,152,91,0.79131705,12,30,11,0.5986842105263158,
1,2,car,crv,667,819,484,575,152,91,0.83604145,12,30,11,0.5986842105263158,
2,2,car,crv,668,819,484,574,151,90,0.7223766,12,30,11,0.5960264900662252,
3,2,car,crv,668,818,483,573,150,90,0.7379781,12,30,11,0.6,
4,2,car,crv,668,821,484,575,153,91,0.7870298,12,30,11,0.5947712418300654,
5,2,car,crv,667,820,484,575,153,91,0.8413766,12,30,11,0.5947712418300654,
6,2,car,crv,668,820,484,574,152,90,0.8056128,12,30,11,0.5921052631578947,
7,2,car,crv,667,820,483,575,153,92,0.66239387,12,30,11,0.6013071895424836,
8,2,car,crv,667,820,484,575,153,91,0.772995,12,30,11,0.5947712418300654,
9,2,car,crv,667,820,485,574,153,89,0.8488218,12,30,11,0.5816993464052288,
10,2,car,crv,667,820,484,575,153,91,0.78723717,12,30,11,0.5947712418300654,
11,2,car,crv,663,810,486,569,147,83,0.7781846,12,30,11,0.564625850340136,
12,2,car,crv,667,819,485,574,152,89,0.8128246,12,30,11,0.5855263157894737,
13,2,car,crv,666,820,482,577,154,95,0.80031437,9,0,11,0.6168831168831169,
14,2,car,crv,667,820,485,573,153,88,0.8438455,12,30,11,0.5751633986928104,
15,2,car,crv,667,819,484,575,152,91,0.9125865,12,30,11,0.5986842105263158,
16,2,car,crv,668,821,485,574,153,89,0.8785678,12,30,11,0.5816993464052288,
17,2,car,crv,667,819,485,574,152,89,0.71991515,12,30,11,0.5855263157894737,
18,2,car,crv,667,820,484,577,153,93,0.7404891,12,30,11,0.6078431372549019,
19,2,car,crv,667,819,484,575,152,91,0.7707914,12,30,11,0.5986842105263158,
20,2,car,crv,662,810,486,571,148,85,0.7150951,12,30,11,0.5743243243243243,
21,2,car,crv,669,820,485,574,151,89,0.83562523,12,30,11,0.5894039735099338,
22,2,car,crv,666,820,484,574,154,90,0.78819734,12,30,11,0.5844155844155844,
23,2,car,crv,667,819,483,575,152,92,0.8056975,12,30,11,0.6052631578947368,
24,2,car,crv,668,821,485,574,153,89,0.80433,12,30,11,0.5816993464052288,
25,2,car,crv,667,820,484,572,153,88,0.7759209,12,30,11,0.5751633986928104,
26,2,car,crv,667,819,484,572,152,88,0.7274725,12,30,11,0.5789473684210527,
27,2,car,crv,810,1001,490,585,191,95,0.9551184,9,30,11,0.4973821989528796,
28,2,car,crv,807,1006,489,583,199,94,0.9514729,12,60,11,0.4723618090452261,
0,2,car,crv,667,817,484,574,150,90,0.66427475,12,30,11,0.6,
1,2,car,crv,667,819,483,574,152,91,0.79131705,12,30,11,0.5986842105263158,
2,2,car,crv,667,819,484,575,152,91,0.83604145,12,30,11,0.5986842105263158,
3,2,car,crv,668,819,484,574,151,90,0.7223766,12,30,11,0.5960264900662252,
4,2,car,crv,668,818,483,573,150,90,0.7379781,12,30,11,0.6,
5,2,car,crv,668,821,484,575,153,91,0.7870298,12,30,11,0.5947712418300654,
6,2,car,crv,667,820,484,575,153,91,0.8413766,12,30,11,0.5947712418300654,
7,2,car,crv,668,820,484,574,152,90,0.8056128,12,30,11,0.5921052631578947,
8,2,car,crv,667,820,483,575,153,92,0.66239387,12,30,11,0.6013071895424836,
9,2,car,crv,667,820,484,575,153,91,0.772995,12,30,11,0.5947712418300654,
10,2,car,crv,667,820,485,574,153,89,0.8488218,12,30,11,0.5816993464052288,
11,2,car,crv,667,820,484,575,153,91,0.78723717,12,30,11,0.5947712418300654,
12,2,car,crv,663,810,486,569,147,83,0.7781846,12,30,11,0.564625850340136,
13,2,car,crv,667,819,485,574,152,89,0.8128246,12,30,11,0.5855263157894737,
14,2,car,crv,666,820,482,577,154,95,0.80031437,9,0,11,0.6168831168831169,
15,2,car,crv,667,820,485,573,153,88,0.8438455,12,30,11,0.5751633986928104,
16,2,car,crv,667,819,484,575,152,91,0.9125865,12,30,11,0.5986842105263158,
17,2,car,crv,668,821,485,574,153,89,0.8785678,12,30,11,0.5816993464052288,
18,2,car,crv,667,819,485,574,152,89,0.71991515,12,30,11,0.5855263157894737,
19,2,car,crv,667,820,484,577,153,93,0.7404891,12,30,11,0.6078431372549019,
20,2,car,crv,667,819,484,575,152,91,0.7707914,12,30,11,0.5986842105263158,
21,2,car,crv,662,810,486,571,148,85,0.7150951,12,30,11,0.5743243243243243,
22,2,car,crv,669,820,485,574,151,89,0.83562523,12,30,11,0.5894039735099338,
23,2,car,crv,666,820,484,574,154,90,0.78819734,12,30,11,0.5844155844155844,
24,2,car,crv,667,819,483,575,152,92,0.8056975,12,30,11,0.6052631578947368,
25,2,car,crv,668,821,485,574,153,89,0.80433,12,30,11,0.5816993464052288,
26,2,car,crv,667,820,484,572,153,88,0.7759209,12,30,11,0.5751633986928104,
27,2,car,crv,667,819,484,572,152,88,0.7274725,12,30,11,0.5789473684210527,
28,2,car,crv,810,1001,490,585,191,95,0.9551184,9,30,11,0.4973821989528796,
29,2,car,crv,807,1006,489,583,199,94,0.9514729,12,60,11,0.4723618090452261,
0,2,car,crv,667,819,484,574,152,90,0.77298564,12,30,11,0.5921052631578947,
1,2,car,crv,667,817,484,574,150,90,0.66427475,12,30,11,0.6,
2,2,car,crv,667,819,483,574,152,91,0.79131705,12,30,11,0.5986842105263158,
3,2,car,crv,667,819,484,575,152,91,0.83604145,12,30,11,0.5986842105263158,
4,2,car,crv,668,819,484,574,151,90,0.7223766,12,30,11,0.5960264900662252,
5,2,car,crv,668,818,483,573,150,90,0.7379781,12,30,11,0.6,
6,2,car,crv,668,821,484,575,153,91,0.7870298,12,30,11,0.5947712418300654,
7,2,car,crv,667,820,484,575,153,91,0.8413766,12,30,11,0.5947712418300654,
8,2,car,crv,668,820,484,574,152,90,0.8056128,12,30,11,0.5921052631578947,
9,2,car,crv,667,820,483,575,153,92,0.66239387,12,30,11,0.6013071895424836,
10,2,car,crv,667,820,484,575,153,91,0.772995,12,30,11,0.5947712418300654,
11,2,car,crv,667,820,485,574,153,89,0.8488218,12,30,11,0.5816993464052288,
12,2,car,crv,667,820,484,575,153,91,0.78723717,12,30,11,0.5947712418300654,
13,2,car,crv,663,810,486,569,147,83,0.7781846,12,30,11,0.564625850340136,
14,2,car,crv,667,819,485,574,152,89,0.8128246,12,30,11,0.5855263157894737,
15,2,car,crv,666,820,482,577,154,95,0.80031437,9,0,11,0.6168831168831169,
16,2,car,crv,667,820,485,573,153,88,0.8438455,12,30,11,0.5751633986928104,
17,2,car,crv,667,819,484,575,152,91,0.9125865,12,30,11,0.5986842105263158,
18,2,car,crv,668,821,485,574,153,89,0.8785678,12,30,11,0.5816993464052288,
19,2,car,crv,667,819,485,574,152,89,0.71991515,12,30,11,0.5855263157894737,
20,2,car,crv,667,820,484,577,153,93,0.7404891,12,30,11,0.6078431372549019,
21,2,car,crv,667,819,484,575,152,91,0.7707914,12,30,11,0.5986842105263158,
22,2,car,crv,662,810,486,571,148,85,0.7150951,12,30,11,0.5743243243243243,
23,2,car,crv,669,820,485,574,151,89,0.83562523,12,30,11,0.5894039735099338,
24,2,car,crv,666,820,484,574,154,90,0.78819734,12,30,11,0.5844155844155844,
25,2,car,crv,667,819,483,575,152,92,0.8056975,12,30,11,0.6052631578947368,
26,2,car,crv,668,821,485,574,153,89,0.80433,12,30,11,0.5816993464052288,
27,2,car,crv,667,820,484,572,153,88,0.7759209,12,30,11,0.5751633986928104,
28,2,car,crv,667,819,484,572,152,88,0.7274725,12,30,11,0.5789473684210527,
29,2,car,crv,810,1001,490,585,191,95,0.9551184,9,30,11,0.4973821989528796,
30,2,car,crv,807,1006,489,583,199,94,0.9514729,12,60,11,0.4723618090452261,
0,2,car,crv,667,819,484,574,152,90,0.8371277,12,30,11,0.5921052631578947,
1,2,car,crv,667,819,484,574,152,90,0.77298564,12,30,11,0.5921052631578947,
2,2,car,crv,667,817,484,574,150,90,0.66427475,12,30,11,0.6,
3,2,car,crv,667,819,483,574,152,91,0.79131705,12,30,11,0.5986842105263158,
4,2,car,crv,667,819,484,575,152,91,0.83604145,12,30,11,0.5986842105263158,
5,2,car,crv,668,819,484,574,151,90,0.7223766,12,30,11,0.5960264900662252,
6,2,car,crv,668,818,483,573,150,90,0.7379781,12,30,11,0.6,
7,2,car,crv,668,821,484,575,153,91,0.7870298,12,30,11,0.5947712418300654,
8,2,car,crv,667,820,484,575,153,91,0.8413766,12,30,11,0.5947712418300654,
9,2,car,crv,668,820,484,574,152,90,0.8056128,12,30,11,0.5921052631578947,
10,2,car,crv,667,820,483,575,153,92,0.66239387,12,30,11,0.6013071895424836,
11,2,car,crv,667,820,484,575,153,91,0.772995,12,30,11,0.5947712418300654,
12,2,car,crv,667,820,485,574,153,89,0.8488218,12,30,11,0.5816993464052288,
13,2,car,crv,667,820,484,575,153,91,0.78723717,12,30,11,0.5947712418300654,
14,2,car,crv,663,810,486,569,147,83,0.7781846,12,30,11,0.564625850340136,
15,2,car,crv,667,819,485,574,152,89,0.8128246,12,30,11,0.5855263157894737,
16,2,car,crv,666,820,482,577,154,95,0.80031437,9,0,11,0.6168831168831169,
17,2,car,crv,667,820,485,573,153,88,0.8438455,12,30,11,0.5751633986928104,
18,2,car,crv,667,819,484,575,152,91,0.9125865,12,30,11,0.5986842105263158,
19,2,car,crv,668,821,485,574,153,89,0.8785678,12,30,11,0.5816993464052288,
20,2,car,crv,667,819,485,574,152,89,0.71991515,12,30,11,0.5855263157894737,
21,2,car,crv,667,820,484,577,153,93,0.7404891,12,30,11,0.6078431372549019,
22,2,car,crv,667,819,484,575,152,91,0.7707914,12,30,11,0.5986842105263158,
23,2,car,crv,662,810,486,571,148,85,0.7150951,12,30,11,0.5743243243243243,
24,2,car,crv,669,820,485,574,151,89,0.83562523,12,30,11,0.5894039735099338,
25,2,car,crv,666,820,484,574,154,90,0.78819734,12,30,11,0.5844155844155844,
26,2,car,crv,667,819,483,575,152,92,0.8056975,12,30,11,0.6052631578947368,
27,2,car,crv,668,821,485,574,153,89,0.80433,12,30,11,0.5816993464052288,
28,2,car,crv,667,820,484,572,153,88,0.7759209,12,30,11,0.5751633986928104,
29,2,car,crv,667,819,484,572,152,88,0.7274725,12,30,11,0.5789473684210527,
30,2,car,crv,810,1001,490,585,191,95,0.9551184,9,30,11,0.4973821989528796,
31,2,car,crv,807,1006,489,583,199,94,0.9514729,12,60,11,0.4723618090452261,
0,2,car,crv,667,820,482,574,153,92,0.6722521,12,30,11,0.6013071895424836,
1,2,car,crv,667,819,484,574,152,90,0.8371277,12,30,11,0.5921052631578947,
2,2,car,crv,667,819,484,574,152,90,0.77298564,12,30,11,0.5921052631578947,
3,2,car,crv,667,817,484,574,150,90,0.66427475,12,30,11,0.6,
4,2,car,crv,667,819,483,574,152,91,0.79131705,12,30,11,0.5986842105263158,
5,2,car,crv,667,819,484,575,152,91,0.83604145,12,30,11,0.5986842105263158,
6,2,car,crv,668,819,484,574,151,90,0.7223766,12,30,11,0.5960264900662252,
7,2,car,crv,668,818,483,573,150,90,0.7379781,12,30,11,0.6,
8,2,car,crv,668,821,484,575,153,91,0.7870298,12,30,11,0.5947712418300654,
9,2,car,crv,667,820,484,575,153,91,0.8413766,12,30,11,0.5947712418300654,
10,2,car,crv,668,820,484,574,152,90,0.8056128,12,30,11,0.5921052631578947,
11,2,car,crv,667,820,483,575,153,92,0.66239387,12,30,11,0.6013071895424836,
12,2,car,crv,667,820,484,575,153,91,0.772995,12,30,11,0.5947712418300654,
13,2,car,crv,667,820,485,574,153,89,0.8488218,12,30,11,0.5816993464052288,
14,2,car,crv,667,820,484,575,153,91,0.78723717,12,30,11,0.5947712418300654,
15,2,car,crv,663,810,486,569,147,83,0.7781846,12,30,11,0.564625850340136,
16,2,car,crv,667,819,485,574,152,89,0.8128246,12,30,11,0.5855263157894737,
17,2,car,crv,666,820,482,577,154,95,0.80031437,9,0,11,0.6168831168831169,
18,2,car,crv,667,820,485,573,153,88,0.8438455,12,30,11,0.5751633986928104,
19,2,car,crv,667,819,484,575,152,91,0.9125865,12,30,11,0.5986842105263158,
20,2,car,crv,668,821,485,574,153,89,0.8785678,12,30,11,0.5816993464052288,
21,2,car,crv,667,819,485,574,152,89,0.71991515,12,30,11,0.5855263157894737,
22,2,car,crv,667,820,484,577,153,93,0.7404891,12,30,11,0.6078431372549019,
23,2,car,crv,667,819,484,575,152,91,0.7707914,12,30,11,0.5986842105263158,
24,2,car,crv,662,810,486,571,148,85,0.7150951,12,30,11,0.5743243243243243,
25,2,car,crv,669,820,485,574,151,89,0.83562523,12,30,11,0.5894039735099338,
26,2,car,crv,666,820,484,574,154,90,0.78819734,12,30,11,0.5844155844155844,
27,2,car,crv,667,819,483,575,152,92,0.8056975,12,30,11,0.6052631578947368,
28,2,car,crv,668,821,485,574,153,89,0.80433,12,30,11,0.5816993464052288,
29,2,car,crv,667,820,484,572,153,88,0.7759209,12,30,11,0.5751633986928104,
30,2,car,crv,667,819,484,572,152,88,0.7274725,12,30,11,0.5789473684210527,
31,2,car,crv,810,1001,490,585,191,95,0.9551184,9,30,11,0.4973821989528796,
32,2,car,crv,807,1006,489,583,199,94,0.9514729,12,60,11,0.4723618090452261,
0,2,car,crv,667,819,483,575,152,92,0.8094451,12,30,11,1.5625,
1,2,car,crv,667,820,482,574,153,92,0.6722521,12,30,11,0.6013071895424836,
2,2,car,crv,667,819,484,574,152,90,0.8371277,12,30,11,0.5921052631578947,
3,2,car,crv,667,819,484,574,152,90,0.77298564,12,30,11,0.5921052631578947,
4,2,car,crv,667,817,484,574,150,90,0.66427475,12,30,11,0.6,
5,2,car,crv,667,819,483,574,152,91,0.79131705,12,30,11,0.5986842105263158,
6,2,car,crv,667,819,484,575,152,91,0.83604145,12,30,11,0.5986842105263158,
7,2,car,crv,668,819,484,574,151,90,0.7223766,12,30,11,0.5960264900662252,
8,2,car,crv,668,818,483,573,150,90,0.7379781,12,30,11,0.6,
9,2,car,crv,668,821,484,575,153,91,0.7870298,12,30,11,0.5947712418300654,
10,2,car,crv,667,820,484,575,153,91,0.8413766,12,30,11,0.5947712418300654,
11,2,car,crv,668,820,484,574,152,90,0.8056128,12,30,11,0.5921052631578947,
12,2,car,crv,667,820,483,575,153,92,0.66239387,12,30,11,0.6013071895424836,
13,2,car,crv,667,820,484,575,153,91,0.772995,12,30,11,0.5947712418300654,
14,2,car,crv,667,820,485,574,153,89,0.8488218,12,30,11,0.5816993464052288,
15,2,car,crv,667,820,484,575,153,91,0.78723717,12,30,11,0.5947712418300654,
16,2,car,crv,663,810,486,569,147,83,0.7781846,12,30,11,0.564625850340136,
17,2,car,crv,667,819,485,574,152,89,0.8128246,12,30,11,0.5855263157894737,
18,2,car,crv,666,820,482,577,154,95,0.80031437,9,0,11,0.6168831168831169,
19,2,car,crv,667,820,485,573,153,88,0.8438455,12,30,11,0.5751633986928104,
20,2,car,crv,667,819,484,575,152,91,0.9125865,12,30,11,0.5986842105263158,
21,2,car,crv,668,821,485,574,153,89,0.8785678,12,30,11,0.5816993464052288,
22,2,car,crv,667,819,485,574,152,89,0.71991515,12,30,11,0.5855263157894737,
23,2,car,crv,667,820,484,577,153,93,0.7404891,12,30,11,0.6078431372549019,
24,2,car,crv,667,819,484,575,152,91,0.7707914,12,30,11,0.5986842105263158,
25,2,car,crv,662,810,486,571,148,85,0.7150951,12,30,11,0.5743243243243243,
26,2,car,crv,669,820,485,574,151,89,0.83562523,12,30,11,0.5894039735099338,
27,2,car,crv,666,820,484,574,154,90,0.78819734,12,30,11,0.5844155844155844,
28,2,car,crv,667,819,483,575,152,92,0.8056975,12,30,11,0.6052631578947368,
29,2,car,crv,668,821,485,574,153,89,0.80433,12,30,11,0.5816993464052288,
30,2,car,crv,667,820,484,572,153,88,0.7759209,12,30,11,0.5751633986928104,
31,2,car,crv,667,819,484,572,152,88,0.7274725,12,30,11,0.5789473684210527,
32,2,car,crv,810,1001,490,585,191,95,0.9551184,9,30,11,0.4973821989528796,
33,2,car,crv,807,1006,489,583,199,94,0.9514729,12,60,11,0.4723618090452261,
0,2,car,crv,667,819,484,575,152,91,0.8454891,12,30,11,0.5986842105263158,
1,2,car,crv,667,819,483,575,152,92,0.8094451,12,30,11,1.5625,
2,2,car,crv,667,820,482,574,153,92,0.6722521,12,30,11,0.6013071895424836,
3,2,car,crv,667,819,484,574,152,90,0.8371277,12,30,11,0.5921052631578947,
4,2,car,crv,667,819,484,574,152,90,0.77298564,12,30,11,0.5921052631578947,
5,2,car,crv,667,817,484,574,150,90,0.66427475,12,30,11,0.6,
6,2,car,crv,667,819,483,574,152,91,0.79131705,12,30,11,0.5986842105263158,
7,2,car,crv,667,819,484,575,152,91,0.83604145,12,30,11,0.5986842105263158,
8,2,car,crv,668,819,484,574,151,90,0.7223766,12,30,11,0.5960264900662252,
9,2,car,crv,668,818,483,573,150,90,0.7379781,12,30,11,0.6,
10,2,car,crv,668,821,484,575,153,91,0.7870298,12,30,11,0.5947712418300654,
11,2,car,crv,667,820,484,575,153,91,0.8413766,12,30,11,0.5947712418300654,
12,2,car,crv,668,820,484,574,152,90,0.8056128,12,30,11,0.5921052631578947,
13,2,car,crv,667,820,483,575,153,92,0.66239387,12,30,11,0.6013071895424836,
14,2,car,crv,667,820,484,575,153,91,0.772995,12,30,11,0.5947712418300654,
15,2,car,crv,667,820,485,574,153,89,0.8488218,12,30,11,0.5816993464052288,
16,2,car,crv,667,820,484,575,153,91,0.78723717,12,30,11,0.5947712418300654,
17,2,car,crv,663,810,486,569,147,83,0.7781846,12,30,11,0.564625850340136,
18,2,car,crv,667,819,485,574,152,89,0.8128246,12,30,11,0.5855263157894737,
19,2,car,crv,666,820,482,577,154,95,0.80031437,9,0,11,0.6168831168831169,
20,2,car,crv,667,820,485,573,153,88,0.8438455,12,30,11,0.5751633986928104,
21,2,car,crv,667,819,484,575,152,91,0.9125865,12,30,11,0.5986842105263158,
22,2,car,crv,668,821,485,574,153,89,0.8785678,12,30,11,0.5816993464052288,
23,2,car,crv,667,819,485,574,152,89,0.71991515,12,30,11,0.5855263157894737,
24,2,car,crv,667,820,484,577,153,93,0.7404891,12,30,11,0.6078431372549019,
25,2,car,crv,667,819,484,575,152,91,0.7707914,12,30,11,0.5986842105263158,
26,2,car,crv,662,810,486,571,148,85,0.7150951,12,30,11,0.5743243243243243,
27,2,car,crv,669,820,485,574,151,89,0.83562523,12,30,11,0.5894039735099338,
28,2,car,crv,666,820,484,574,154,90,0.78819734,12,30,11,0.5844155844155844,
29,2,car,crv,667,819,483,575,152,92,0.8056975,12,30,11,0.6052631578947368,
30,2,car,crv,668,821,485,574,153,89,0.80433,12,30,11,0.5816993464052288,
31,2,car,crv,667,820,484,572,153,88,0.7759209,12,30,11,0.5751633986928104,
32,2,car,crv,667,819,484,572,152,88,0.7274725,12,30,11,0.5789473684210527,
33,2,car,crv,810,1001,490,585,191,95,0.9551184,9,30,11,0.4973821989528796,
34,2,car,crv,807,1006,489,583,199,94,0.9514729,12,60,11,0.4723618090452261,
0,2,car,crv,664,809,487,570,145,83,0.77994776,12,30,11,0.5724137931034483,
1,2,car,crv,667,819,484,575,152,91,0.8454891,12,30,11,0.5986842105263158,
2,2,car,crv,667,819,483,575,152,92,0.8094451,12,30,11,1.5625,
3,2,car,crv,667,820,482,574,153,92,0.6722521,12,30,11,0.6013071895424836,
4,2,car,crv,667,819,484,574,152,90,0.8371277,12,30,11,0.5921052631578947,
5,2,car,crv,667,819,484,574,152,90,0.77298564,12,30,11,0.5921052631578947,
6,2,car,crv,667,817,484,574,150,90,0.66427475,12,30,11,0.6,
7,2,car,crv,667,819,483,574,152,91,0.79131705,12,30,11,0.5986842105263158,
8,2,car,crv,667,819,484,575,152,91,0.83604145,12,30,11,0.5986842105263158,
9,2,car,crv,668,819,484,574,151,90,0.7223766,12,30,11,0.5960264900662252,
10,2,car,crv,668,818,483,573,150,90,0.7379781,12,30,11,0.6,
11,2,car,crv,668,821,484,575,153,91,0.7870298,12,30,11,0.5947712418300654,
12,2,car,crv,667,820,484,575,153,91,0.8413766,12,30,11,0.5947712418300654,
13,2,car,crv,668,820,484,574,152,90,0.8056128,12,30,11,0.5921052631578947,
14,2,car,crv,667,820,483,575,153,92,0.66239387,12,30,11,0.6013071895424836,
15,2,car,crv,667,820,484,575,153,91,0.772995,12,30,11,0.5947712418300654,
16,2,car,crv,667,820,485,574,153,89,0.8488218,12,30,11,0.5816993464052288,
17,2,car,crv,667,820,484,575,153,91,0.78723717,12,30,11,0.5947712418300654,
18,2,car,crv,663,810,486,569,147,83,0.7781846,12,30,11,0.564625850340136,
19,2,car,crv,667,819,485,574,152,89,0.8128246,12,30,11,0.5855263157894737,
20,2,car,crv,666,820,482,577,154,95,0.80031437,9,0,11,0.6168831168831169,
21,2,car,crv,667,820,485,573,153,88,0.8438455,12,30,11,0.5751633986928104,
22,2,car,crv,667,819,484,575,152,91,0.9125865,12,30,11,0.5986842105263158,
23,2,car,crv,668,821,485,574,153,89,0.8785678,12,30,11,0.5816993464052288,
24,2,car,crv,667,819,485,574,152,89,0.71991515,12,30,11,0.5855263157894737,
25,2,car,crv,667,820,484,577,153,93,0.7404891,12,30,11,0.6078431372549019,
26,2,car,crv,667,819,484,575,152,91,0.7707914,12,30,11,0.5986842105263158,
27,2,car,crv,662,810,486,571,148,85,0.7150951,12,30,11,0.5743243243243243,
28,2,car,crv,669,820,485,574,151,89,0.83562523,12,30,11,0.5894039735099338,
29,2,car,crv,666,820,484,574,154,90,0.78819734,12,30,11,0.5844155844155844,
30,2,car,crv,667,819,483,575,152,92,0.8056975,12,30,11,0.6052631578947368,
31,2,car,crv,668,821,485,574,153,89,0.80433,12,30,11,0.5816993464052288,
32,2,car,crv,667,820,484,572,153,88,0.7759209,12,30,11,0.5751633986928104,
33,2,car,crv,667,819,484,572,152,88,0.7274725,12,30,11,0.5789473684210527,
34,2,car,crv,810,1001,490,585,191,95,0.9551184,9,30,11,0.4973821989528796,
35,2,car,crv,807,1006,489,583,199,94,0.9514729,12,60,11,0.4723618090452261,
0,2,car,crv,667,819,484,575,152,91,0.8101879,12,30,11,0.5986842105263158,
1,2,car,crv,664,809,487,570,145,83,0.77994776,12,30,11,0.5724137931034483,
2,2,car,crv,667,819,484,575,152,91,0.8454891,12,30,11,0.5986842105263158,
3,2,car,crv,667,819,483,575,152,92,0.8094451,12,30,11,1.5625,
4,2,car,crv,667,820,482,574,153,92,0.6722521,12,30,11,0.6013071895424836,
5,2,car,crv,667,819,484,574,152,90,0.8371277,12,30,11,0.5921052631578947,
6,2,car,crv,667,819,484,574,152,90,0.77298564,12,30,11,0.5921052631578947,
7,2,car,crv,667,817,484,574,150,90,0.66427475,12,30,11,0.6,
8,2,car,crv,667,819,483,574,152,91,0.79131705,12,30,11,0.5986842105263158,
9,2,car,crv,667,819,484,575,152,91,0.83604145,12,30,11,0.5986842105263158,
10,2,car,crv,668,819,484,574,151,90,0.7223766,12,30,11,0.5960264900662252,
11,2,car,crv,668,818,483,573,150,90,0.7379781,12,30,11,0.6,
12,2,car,crv,668,821,484,575,153,91,0.7870298,12,30,11,0.5947712418300654,
13,2,car,crv,667,820,484,575,153,91,0.8413766,12,30,11,0.5947712418300654,
14,2,car,crv,668,820,484,574,152,90,0.8056128,12,30,11,0.5921052631578947,
15,2,car,crv,667,820,483,575,153,92,0.66239387,12,30,11,0.6013071895424836,
16,2,car,crv,667,820,484,575,153,91,0.772995,12,30,11,0.5947712418300654,
17,2,car,crv,667,820,485,574,153,89,0.8488218,12,30,11,0.5816993464052288,
18,2,car,crv,667,820,484,575,153,91,0.78723717,12,30,11,0.5947712418300654,
19,2,car,crv,663,810,486,569,147,83,0.7781846,12,30,11,0.564625850340136,
20,2,car,crv,667,819,485,574,152,89,0.8128246,12,30,11,0.5855263157894737,
21,2,car,crv,666,820,482,577,154,95,0.80031437,9,0,11,0.6168831168831169,
22,2,car,crv,667,820,485,573,153,88,0.8438455,12,30,11,0.5751633986928104,
23,2,car,crv,667,819,484,575,152,91,0.9125865,12,30,11,0.5986842105263158,
24,2,car,crv,668,821,485,574,153,89,0.8785678,12,30,11,0.5816993464052288,
25,2,car,crv,667,819,485,574,152,89,0.71991515,12,30,11,0.5855263157894737,
26,2,car,crv,667,820,484,577,153,93,0.7404891,12,30,11,0.6078431372549019,
27,2,car,crv,667,819,484,575,152,91,0.7707914,12,30,11,0.5986842105263158,
28,2,car,crv,662,810,486,571,148,85,0.7150951,12,30,11,0.5743243243243243,
29,2,car,crv,669,820,485,574,151,89,0.83562523,12,30,11,0.5894039735099338,
30,2,car,crv,666,820,484,574,154,90,0.78819734,12,30,11,0.5844155844155844,
31,2,car,crv,667,819,483,575,152,92,0.8056975,12,30,11,0.6052631578947368,
32,2,car,crv,668,821,485,574,153,89,0.80433,12,30,11,0.5816993464052288,
33,2,car,crv,667,820,484,572,153,88,0.7759209,12,30,11,0.5751633986928104,
34,2,car,crv,667,819,484,572,152,88,0.7274725,12,30,11,0.5789473684210527,
35,2,car,crv,810,1001,490,585,191,95,0.9551184,9,30,11,0.4973821989528796,
36,2,car,crv,807,1006,489,583,199,94,0.9514729,12,60,11,0.4723618090452261,
0,2,car,crv,662,810,486,570,148,84,0.7822179,12,30,11,0.5675675675675675,
1,2,car,crv,667,819,484,575,152,91,0.8101879,12,30,11,0.5986842105263158,
2,2,car,crv,664,809,487,570,145,83,0.77994776,12,30,11,0.5724137931034483,
3,2,car,crv,667,819,484,575,152,91,0.8454891,12,30,11,0.5986842105263158,
4,2,car,crv,667,819,483,575,152,92,0.8094451,12,30,11,1.5625,
5,2,car,crv,667,820,482,574,153,92,0.6722521,12,30,11,0.6013071895424836,
6,2,car,crv,667,819,484,574,152,90,0.8371277,12,30,11,0.5921052631578947,
7,2,car,crv,667,819,484,574,152,90,0.77298564,12,30,11,0.5921052631578947,
8,2,car,crv,667,817,484,574,150,90,0.66427475,12,30,11,0.6,
9,2,car,crv,667,819,483,574,152,91,0.79131705,12,30,11,0.5986842105263158,
10,2,car,crv,667,819,484,575,152,91,0.83604145,12,30,11,0.5986842105263158,
11,2,car,crv,668,819,484,574,151,90,0.7223766,12,30,11,0.5960264900662252,
12,2,car,crv,668,818,483,573,150,90,0.7379781,12,30,11,0.6,
13,2,car,crv,668,821,484,575,153,91,0.7870298,12,30,11,0.5947712418300654,
14,2,car,crv,667,820,484,575,153,91,0.8413766,12,30,11,0.5947712418300654,
15,2,car,crv,668,820,484,574,152,90,0.8056128,12,30,11,0.5921052631578947,
16,2,car,crv,667,820,483,575,153,92,0.66239387,12,30,11,0.6013071895424836,
17,2,car,crv,667,820,484,575,153,91,0.772995,12,30,11,0.5947712418300654,
18,2,car,crv,667,820,485,574,153,89,0.8488218,12,30,11,0.5816993464052288,
19,2,car,crv,667,820,484,575,153,91,0.78723717,12,30,11,0.5947712418300654,
20,2,car,crv,663,810,486,569,147,83,0.7781846,12,30,11,0.564625850340136,
21,2,car,crv,667,819,485,574,152,89,0.8128246,12,30,11,0.5855263157894737,
22,2,car,crv,666,820,482,577,154,95,0.80031437,9,0,11,0.6168831168831169,
23,2,car,crv,667,820,485,573,153,88,0.8438455,12,30,11,0.5751633986928104,
24,2,car,crv,667,819,484,575,152,91,0.9125865,12,30,11,0.5986842105263158,
25,2,car,crv,668,821,485,574,153,89,0.8785678,12,30,11,0.5816993464052288,
26,2,car,crv,667,819,485,574,152,89,0.71991515,12,30,11,0.5855263157894737,
27,2,car,crv,667,820,484,577,153,93,0.7404891,12,30,11,0.6078431372549019,
28,2,car,crv,667,819,484,575,152,91,0.7707914,12,30,11,0.5986842105263158,
29,2,car,crv,662,810,486,571,148,85,0.7150951,12,30,11,0.5743243243243243,
30,2,car,crv,669,820,485,574,151,89,0.83562523,12,30,11,0.5894039735099338,
31,2,car,crv,666,820,484,574,154,90,0.78819734,12,30,11,0.5844155844155844,
32,2,car,crv,667,819,483,575,152,92,0.8056975,12,30,11,0.6052631578947368,
33,2,car,crv,668,821,485,574,153,89,0.80433,12,30,11,0.5816993464052288,
34,2,car,crv,667,820,484,572,153,88,0.7759209,12,30,11,0.5751633986928104,
35,2,car,crv,667,819,484,572,152,88,0.7274725,12,30,11,0.5789473684210527,
36,2,car,crv,810,1001,490,585,191,95,0.9551184,9,30,11,0.4973821989528796,
37,2,car,crv,807,1006,489,583,199,94,0.9514729,12,60,11,0.4723618090452261,
0,2,car,crv,667,820,485,574,153,89,0.8510291,12,30,11,0.5816993464052288,
1,2,car,crv,662,810,486,570,148,84,0.7822179,12,30,11,0.5675675675675675,
2,2,car,crv,667,819,484,575,152,91,0.8101879,12,30,11,0.5986842105263158,
3,2,car,crv,664,809,487,570,145,83,0.77994776,12,30,11,0.5724137931034483,
4,2,car,crv,667,819,484,575,152,91,0.8454891,12,30,11,0.5986842105263158,
5,2,car,crv,667,819,483,575,152,92,0.8094451,12,30,11,1.5625,
6,2,car,crv,667,820,482,574,153,92,0.6722521,12,30,11,0.6013071895424836,
7,2,car,crv,667,819,484,574,152,90,0.8371277,12,30,11,0.5921052631578947,
8,2,car,crv,667,819,484,574,152,90,0.77298564,12,30,11,0.5921052631578947,
9,2,car,crv,667,817,484,574,150,90,0.66427475,12,30,11,0.6,
10,2,car,crv,667,819,483,574,152,91,0.79131705,12,30,11,0.5986842105263158,
11,2,car,crv,667,819,484,575,152,91,0.83604145,12,30,11,0.5986842105263158,
12,2,car,crv,668,819,484,574,151,90,0.7223766,12,30,11,0.5960264900662252,
13,2,car,crv,668,818,483,573,150,90,0.7379781,12,30,11,0.6,
14,2,car,crv,668,821,484,575,153,91,0.7870298,12,30,11,0.5947712418300654,
15,2,car,crv,667,820,484,575,153,91,0.8413766,12,30,11,0.5947712418300654,
16,2,car,crv,668,820,484,574,152,90,0.8056128,12,30,11,0.5921052631578947,
17,2,car,crv,667,820,483,575,153,92,0.66239387,12,30,11,0.6013071895424836,
18,2,car,crv,667,820,484,575,153,91,0.772995,12,30,11,0.5947712418300654,
19,2,car,crv,667,820,485,574,153,89,0.8488218,12,30,11,0.5816993464052288,
20,2,car,crv,667,820,484,575,153,91,0.78723717,12,30,11,0.5947712418300654,
21,2,car,crv,663,810,486,569,147,83,0.7781846,12,30,11,0.564625850340136,
22,2,car,crv,667,819,485,574,152,89,0.8128246,12,30,11,0.5855263157894737,
23,2,car,crv,666,820,482,577,154,95,0.80031437,9,0,11,0.6168831168831169,
24,2,car,crv,667,820,485,573,153,88,0.8438455,12,30,11,0.5751633986928104,
25,2,car,crv,667,819,484,575,152,91,0.9125865,12,30,11,0.5986842105263158,
26,2,car,crv,668,821,485,574,153,89,0.8785678,12,30,11,0.5816993464052288,
27,2,car,crv,667,819,485,574,152,89,0.71991515,12,30,11,0.5855263157894737,
28,2,car,crv,667,820,484,577,153,93,0.7404891,12,30,11,0.6078431372549019,
29,2,car,crv,667,819,484,575,152,91,0.7707914,12,30,11,0.5986842105263158,
30,2,car,crv,662,810,486,571,148,85,0.7150951,12,30,11,0.5743243243243243,
31,2,car,crv,669,820,485,574,151,89,0.83562523,12,30,11,0.5894039735099338,
32,2,car,crv,666,820,484,574,154,90,0.78819734,12,30,11,0.5844155844155844,
33,2,car,crv,667,819,483,575,152,92,0.8056975,12,30,11,0.6052631578947368,
34,2,car,crv,668,821,485,574,153,89,0.80433,12,30,11,0.5816993464052288,
35,2,car,crv,667,820,484,572,153,88,0.7759209,12,30,11,0.5751633986928104,
36,2,car,crv,667,819,484,572,152,88,0.7274725,12,30,11,0.5789473684210527,
37,2,car,crv,810,1001,490,585,191,95,0.9551184,9,30,11,0.4973821989528796,
38,2,car,crv,807,1006,489,583,199,94,0.9514729,12,60,11,0.4723618090452261,
0,2,car,crv,667,820,483,575,153,92,0.84983456,12,30,11,0.6013071895424836,
1,2,car,crv,667,820,485,574,153,89,0.8510291,12,30,11,0.5816993464052288,
2,2,car,crv,662,810,486,570,148,84,0.7822179,12,30,11,0.5675675675675675,
3,2,car,crv,667,819,484,575,152,91,0.8101879,12,30,11,0.5986842105263158,
4,2,car,crv,664,809,487,570,145,83,0.77994776,12,30,11,0.5724137931034483,
5,2,car,crv,667,819,484,575,152,91,0.8454891,12,30,11,0.5986842105263158,
6,2,car,crv,667,819,483,575,152,92,0.8094451,12,30,11,1.5625,
7,2,car,crv,667,820,482,574,153,92,0.6722521,12,30,11,0.6013071895424836,
8,2,car,crv,667,819,484,574,152,90,0.8371277,12,30,11,0.5921052631578947,
9,2,car,crv,667,819,484,574,152,90,0.77298564,12,30,11,0.5921052631578947,
10,2,car,crv,667,817,484,574,150,90,0.66427475,12,30,11,0.6,
11,2,car,crv,667,819,483,574,152,91,0.79131705,12,30,11,0.5986842105263158,
12,2,car,crv,667,819,484,575,152,91,0.83604145,12,30,11,0.5986842105263158,
13,2,car,crv,668,819,484,574,151,90,0.7223766,12,30,11,0.5960264900662252,
14,2,car,crv,668,818,483,573,150,90,0.7379781,12,30,11,0.6,
15,2,car,crv,668,821,484,575,153,91,0.7870298,12,30,11,0.5947712418300654,
16,2,car,crv,667,820,484,575,153,91,0.8413766,12,30,11,0.5947712418300654,
17,2,car,crv,668,820,484,574,152,90,0.8056128,12,30,11,0.5921052631578947,
18,2,car,crv,667,820,483,575,153,92,0.66239387,12,30,11,0.6013071895424836,
19,2,car,crv,667,820,484,575,153,91,0.772995,12,30,11,0.5947712418300654,
20,2,car,crv,667,820,485,574,153,89,0.8488218,12,30,11,0.5816993464052288,
21,2,car,crv,667,820,484,575,153,91,0.78723717,12,30,11,0.5947712418300654,
22,2,car,crv,663,810,486,569,147,83,0.7781846,12,30,11,0.564625850340136,
23,2,car,crv,667,819,485,574,152,89,0.8128246,12,30,11,0.5855263157894737,
24,2,car,crv,666,820,482,577,154,95,0.80031437,9,0,11,0.6168831168831169,
25,2,car,crv,667,820,485,573,153,88,0.8438455,12,30,11,0.5751633986928104,
26,2,car,crv,667,819,484,575,152,91,0.9125865,12,30,11,0.5986842105263158,
27,2,car,crv,668,821,485,574,153,89,0.8785678,12,30,11,0.5816993464052288,
28,2,car,crv,667,819,485,574,152,89,0.71991515,12,30,11,0.5855263157894737,
29,2,car,crv,667,820,484,577,153,93,0.7404891,12,30,11,0.6078431372549019,
30,2,car,crv,667,819,484,575,152,91,0.7707914,12,30,11,0.5986842105263158,
31,2,car,crv,662,810,486,571,148,85,0.7150951,12,30,11,0.5743243243243243,
32,2,car,crv,669,820,485,574,151,89,0.83562523,12,30,11,0.5894039735099338,
33,2,car,crv,666,820,484,574,154,90,0.78819734,12,30,11,0.5844155844155844,
34,2,car,crv,667,819,483,575,152,92,0.8056975,12,30,11,0.6052631578947368,
35,2,car,crv,668,821,485,574,153,89,0.80433,12,30,11,0.5816993464052288,
36,2,car,crv,667,820,484,572,153,88,0.7759209,12,30,11,0.5751633986928104,
37,2,car,crv,667,819,484,572,152,88,0.7274725,12,30,11,0.5789473684210527,
38,2,car,crv,810,1001,490,585,191,95,0.9551184,9,30,11,0.4973821989528796,
39,2,car,crv,807,1006,489,583,199,94,0.9514729,12,60,11,0.4723618090452261,
0,2,car,crv,667,820,484,577,153,93,0.8308673,12,30,11,0.6078431372549019,
1,2,car,crv,667,820,483,575,153,92,0.84983456,12,30,11,0.6013071895424836,
2,2,car,crv,667,820,485,574,153,89,0.8510291,12,30,11,0.5816993464052288,
3,2,car,crv,662,810,486,570,148,84,0.7822179,12,30,11,0.5675675675675675,
4,2,car,crv,667,819,484,575,152,91,0.8101879,12,30,11,0.5986842105263158,
5,2,car,crv,664,809,487,570,145,83,0.77994776,12,30,11,0.5724137931034483,
6,2,car,crv,667,819,484,575,152,91,0.8454891,12,30,11,0.5986842105263158,
7,2,car,crv,667,819,483,575,152,92,0.8094451,12,30,11,1.5625,
8,2,car,crv,667,820,482,574,153,92,0.6722521,12,30,11,0.6013071895424836,
9,2,car,crv,667,819,484,574,152,90,0.8371277,12,30,11,0.5921052631578947,
10,2,car,crv,667,819,484,574,152,90,0.77298564,12,30,11,0.5921052631578947,
11,2,car,crv,667,817,484,574,150,90,0.66427475,12,30,11,0.6,
12,2,car,crv,667,819,483,574,152,91,0.79131705,12,30,11,0.5986842105263158,
13,2,car,crv,667,819,484,575,152,91,0.83604145,12,30,11,0.5986842105263158,
14,2,car,crv,668,819,484,574,151,90,0.7223766,12,30,11,0.5960264900662252,
15,2,car,crv,668,818,483,573,150,90,0.7379781,12,30,11,0.6,
16,2,car,crv,668,821,484,575,153,91,0.7870298,12,30,11,0.5947712418300654,
17,2,car,crv,667,820,484,575,153,91,0.8413766,12,30,11,0.5947712418300654,
18,2,car,crv,668,820,484,574,152,90,0.8056128,12,30,11,0.5921052631578947,
19,2,car,crv,667,820,483,575,153,92,0.66239387,12,30,11,0.6013071895424836,
20,2,car,crv,667,820,484,575,153,91,0.772995,12,30,11,0.5947712418300654,
21,2,car,crv,667,820,485,574,153,89,0.8488218,12,30,11,0.5816993464052288,
22,2,car,crv,667,820,484,575,153,91,0.78723717,12,30,11,0.5947712418300654,
23,2,car,crv,663,810,486,569,147,83,0.7781846,12,30,11,0.564625850340136,
24,2,car,crv,667,819,485,574,152,89,0.8128246,12,30,11,0.5855263157894737,
25,2,car,crv,666,820,482,577,154,95,0.80031437,9,0,11,0.6168831168831169,
26,2,car,crv,667,820,485,573,153,88,0.8438455,12,30,11,0.5751633986928104,
27,2,car,crv,667,819,484,575,152,91,0.9125865,12,30,11,0.5986842105263158,
28,2,car,crv,668,821,485,574,153,89,0.8785678,12,30,11,0.5816993464052288,
29,2,car,crv,667,819,485,574,152,89,0.71991515,12,30,11,0.5855263157894737,
30,2,car,crv,667,820,484,577,153,93,0.7404891,12,30,11,0.6078431372549019,
31,2,car,crv,667,819,484,575,152,91,0.7707914,12,30,11,0.5986842105263158,
32,2,car,crv,662,810,486,571,148,85,0.7150951,12,30,11,0.5743243243243243,
33,2,car,crv,669,820,485,574,151,89,0.83562523,12,30,11,0.5894039735099338,
34,2,car,crv,666,820,484,574,154,90,0.78819734,12,30,11,0.5844155844155844,
35,2,car,crv,667,819,483,575,152,92,0.8056975,12,30,11,0.6052631578947368,
36,2,car,crv,668,821,485,574,153,89,0.80433,12,30,11,0.5816993464052288,
37,2,car,crv,667,820,484,572,153,88,0.7759209,12,30,11,0.5751633986928104,
38,2,car,crv,667,819,484,572,152,88,0.7274725,12,30,11,0.5789473684210527,
39,2,car,crv,810,1001,490,585,191,95,0.9551184,9,30,11,0.4973821989528796,
40,2,car,crv,807,1006,489,583,199,94,0.9514729,12,60,11,0.4723618090452261,
0,2,car,crv,662,810,486,569,148,83,0.8144621,12,30,11,0.5608108108108109,
1,2,car,crv,667,820,484,577,153,93,0.8308673,12,30,11,0.6078431372549019,
2,2,car,crv,667,820,483,575,153,92,0.84983456,12,30,11,0.6013071895424836,
3,2,car,crv,667,820,485,574,153,89,0.8510291,12,30,11,0.5816993464052288,
4,2,car,crv,662,810,486,570,148,84,0.7822179,12,30,11,0.5675675675675675,
5,2,car,crv,667,819,484,575,152,91,0.8101879,12,30,11,0.5986842105263158,
6,2,car,crv,664,809,487,570,145,83,0.77994776,12,30,11,0.5724137931034483,
7,2,car,crv,667,819,484,575,152,91,0.8454891,12,30,11,0.5986842105263158,
8,2,car,crv,667,819,483,575,152,92,0.8094451,12,30,11,1.5625,
9,2,car,crv,667,820,482,574,153,92,0.6722521,12,30,11,0.6013071895424836,
10,2,car,crv,667,819,484,574,152,90,0.8371277,12,30,11,0.5921052631578947,
11,2,car,crv,667,819,484,574,152,90,0.77298564,12,30,11,0.5921052631578947,
12,2,car,crv,667,817,484,574,150,90,0.66427475,12,30,11,0.6,
13,2,car,crv,667,819,483,574,152,91,0.79131705,12,30,11,0.5986842105263158,
14,2,car,crv,667,819,484,575,152,91,0.83604145,12,30,11,0.5986842105263158,
15,2,car,crv,668,819,484,574,151,90,0.7223766,12,30,11,0.5960264900662252,
16,2,car,crv,668,818,483,573,150,90,0.7379781,12,30,11,0.6,
17,2,car,crv,668,821,484,575,153,91,0.7870298,12,30,11,0.5947712418300654,
18,2,car,crv,667,820,484,575,153,91,0.8413766,12,30,11,0.5947712418300654,
19,2,car,crv,668,820,484,574,152,90,0.8056128,12,30,11,0.5921052631578947,
20,2,car,crv,667,820,483,575,153,92,0.66239387,12,30,11,0.6013071895424836,
21,2,car,crv,667,820,484,575,153,91,0.772995,12,30,11,0.5947712418300654,
22,2,car,crv,667,820,485,574,153,89,0.8488218,12,30,11,0.5816993464052288,
23,2,car,crv,667,820,484,575,153,91,0.78723717,12,30,11,0.5947712418300654,
24,2,car,crv,663,810,486,569,147,83,0.7781846,12,30,11,0.564625850340136,
25,2,car,crv,667,819,485,574,152,89,0.8128246,12,30,11,0.5855263157894737,
26,2,car,crv,666,820,482,577,154,95,0.80031437,9,0,11,0.6168831168831169,
27,2,car,crv,667,820,485,573,153,88,0.8438455,12,30,11,0.5751633986928104,
28,2,car,crv,667,819,484,575,152,91,0.9125865,12,30,11,0.5986842105263158,
29,2,car,crv,668,821,485,574,153,89,0.8785678,12,30,11,0.5816993464052288,
30,2,car,crv,667,819,485,574,152,89,0.71991515,12,30,11,0.5855263157894737,
31,2,car,crv,667,820,484,577,153,93,0.7404891,12,30,11,0.6078431372549019,
32,2,car,crv,667,819,484,575,152,91,0.7707914,12,30,11,0.5986842105263158,
33,2,car,crv,662,810,486,571,148,85,0.7150951,12,30,11,0.5743243243243243,
34,2,car,crv,669,820,485,574,151,89,0.83562523,12,30,11,0.5894039735099338,
35,2,car,crv,666,820,484,574,154,90,0.78819734,12,30,11,0.5844155844155844,
36,2,car,crv,667,819,483,575,152,92,0.8056975,12,30,11,0.6052631578947368,
37,2,car,crv,668,821,485,574,153,89,0.80433,12,30,11,0.5816993464052288,
38,2,car,crv,667,820,484,572,153,88,0.7759209,12,30,11,0.5751633986928104,
39,2,car,crv,667,819,484,572,152,88,0.7274725,12,30,11,0.5789473684210527,
40,2,car,crv,810,1001,490,585,191,95,0.9551184,9,30,11,0.4973821989528796,
41,2,car,crv,807,1006,489,583,199,94,0.9514729,12,60,11,0.4723618090452261,
0,2,car,crv,664,809,487,570,145,83,0.8104471,12,30,11,0.5724137931034483,
1,2,car,crv,662,810,486,569,148,83,0.8144621,12,30,11,0.5608108108108109,
2,2,car,crv,667,820,484,577,153,93,0.8308673,12,30,11,0.6078431372549019,
3,2,car,crv,667,820,483,575,153,92,0.84983456,12,30,11,0.6013071895424836,
4,2,car,crv,667,820,485,574,153,89,0.8510291,12,30,11,0.5816993464052288,
5,2,car,crv,662,810,486,570,148,84,0.7822179,12,30,11,0.5675675675675675,
6,2,car,crv,667,819,484,575,152,91,0.8101879,12,30,11,0.5986842105263158,
7,2,car,crv,664,809,487,570,145,83,0.77994776,12,30,11,0.5724137931034483,
8,2,car,crv,667,819,484,575,152,91,0.8454891,12,30,11,0.5986842105263158,
9,2,car,crv,667,819,483,575,152,92,0.8094451,12,30,11,1.5625,
10,2,car,crv,667,820,482,574,153,92,0.6722521,12,30,11,0.6013071895424836,
11,2,car,crv,667,819,484,574,152,90,0.8371277,12,30,11,0.5921052631578947,
12,2,car,crv,667,819,484,574,152,90,0.77298564,12,30,11,0.5921052631578947,
13,2,car,crv,667,817,484,574,150,90,0.66427475,12,30,11,0.6,
14,2,car,crv,667,819,483,574,152,91,0.79131705,12,30,11,0.5986842105263158,
15,2,car,crv,667,819,484,575,152,91,0.83604145,12,30,11,0.5986842105263158,
16,2,car,crv,668,819,484,574,151,90,0.7223766,12,30,11,0.5960264900662252,
17,2,car,crv,668,818,483,573,150,90,0.7379781,12,30,11,0.6,
18,2,car,crv,668,821,484,575,153,91,0.7870298,12,30,11,0.5947712418300654,
19,2,car,crv,667,820,484,575,153,91,0.8413766,12,30,11,0.5947712418300654,
20,2,car,crv,668,820,484,574,152,90,0.8056128,12,30,11,0.5921052631578947,
21,2,car,crv,667,820,483,575,153,92,0.66239387,12,30,11,0.6013071895424836,
22,2,car,crv,667,820,484,575,153,91,0.772995,12,30,11,0.5947712418300654,
23,2,car,crv,667,820,485,574,153,89,0.8488218,12,30,11,0.5816993464052288,
24,2,car,crv,667,820,484,575,153,91,0.78723717,12,30,11,0.5947712418300654,
25,2,car,crv,663,810,486,569,147,83,0.7781846,12,30,11,0.564625850340136,
26,2,car,crv,667,819,485,574,152,89,0.8128246,12,30,11,0.5855263157894737,
27,2,car,crv,666,820,482,577,154,95,0.80031437,9,0,11,0.6168831168831169,
28,2,car,crv,667,820,485,573,153,88,0.8438455,12,30,11,0.5751633986928104,
29,2,car,crv,667,819,484,575,152,91,0.9125865,12,30,11,0.5986842105263158,
30,2,car,crv,668,821,485,574,153,89,0.8785678,12,30,11,0.5816993464052288,
31,2,car,crv,667,819,485,574,152,89,0.71991515,12,30,11,0.5855263157894737,
32,2,car,crv,667,820,484,577,153,93,0.7404891,12,30,11,0.6078431372549019,
33,2,car,crv,667,819,484,575,152,91,0.7707914,12,30,11,0.5986842105263158,
34,2,car,crv,662,810,486,571,148,85,0.7150951,12,30,11,0.5743243243243243,
35,2,car,crv,669,820,485,574,151,89,0.83562523,12,30,11,0.5894039735099338,
36,2,car,crv,666,820,484,574,154,90,0.78819734,12,30,11,0.5844155844155844,
37,2,car,crv,667,819,483,575,152,92,0.8056975,12,30,11,0.6052631578947368,
38,2,car,crv,668,821,485,574,153,89,0.80433,12,30,11,0.5816993464052288,
39,2,car,crv,667,820,484,572,153,88,0.7759209,12,30,11,0.5751633986928104,
40,2,car,crv,667,819,484,572,152,88,0.7274725,12,30,11,0.5789473684210527,
41,2,car,crv,810,1001,490,585,191,95,0.9551184,9,30,11,0.4973821989528796,
42,2,car,crv,807,1006,489,583,199,94,0.9514729,12,60,11,0.4723618090452261,
0,2,car,crv,667,821,485,574,154,89,0.80527765,12,30,11,0.577922077922078,
1,2,car,crv,664,809,487,570,145,83,0.8104471,12,30,11,0.5724137931034483,
2,2,car,crv,662,810,486,569,148,83,0.8144621,12,30,11,0.5608108108108109,
3,2,car,crv,667,820,484,577,153,93,0.8308673,12,30,11,0.6078431372549019,
4,2,car,crv,667,820,483,575,153,92,0.84983456,12,30,11,0.6013071895424836,
5,2,car,crv,667,820,485,574,153,89,0.8510291,12,30,11,0.5816993464052288,
6,2,car,crv,662,810,486,570,148,84,0.7822179,12,30,11,0.5675675675675675,
7,2,car,crv,667,819,484,575,152,91,0.8101879,12,30,11,0.5986842105263158,
8,2,car,crv,664,809,487,570,145,83,0.77994776,12,30,11,0.5724137931034483,
9,2,car,crv,667,819,484,575,152,91,0.8454891,12,30,11,0.5986842105263158,
10,2,car,crv,667,819,483,575,152,92,0.8094451,12,30,11,1.5625,
11,2,car,crv,667,820,482,574,153,92,0.6722521,12,30,11,0.6013071895424836,
12,2,car,crv,667,819,484,574,152,90,0.8371277,12,30,11,0.5921052631578947,
13,2,car,crv,667,819,484,574,152,90,0.77298564,12,30,11,0.5921052631578947,
14,2,car,crv,667,817,484,574,150,90,0.66427475,12,30,11,0.6,
15,2,car,crv,667,819,483,574,152,91,0.79131705,12,30,11,0.5986842105263158,
16,2,car,crv,667,819,484,575,152,91,0.83604145,12,30,11,0.5986842105263158,
17,2,car,crv,668,819,484,574,151,90,0.7223766,12,30,11,0.5960264900662252,
18,2,car,crv,668,818,483,573,150,90,0.7379781,12,30,11,0.6,
19,2,car,crv,668,821,484,575,153,91,0.7870298,12,30,11,0.5947712418300654,
20,2,car,crv,667,820,484,575,153,91,0.8413766,12,30,11,0.5947712418300654,
21,2,car,crv,668,820,484,574,152,90,0.8056128,12,30,11,0.5921052631578947,
22,2,car,crv,667,820,483,575,153,92,0.66239387,12,30,11,0.6013071895424836,
23,2,car,crv,667,820,484,575,153,91,0.772995,12,30,11,0.5947712418300654,
24,2,car,crv,667,820,485,574,153,89,0.8488218,12,30,11,0.5816993464052288,
25,2,car,crv,667,820,484,575,153,91,0.78723717,12,30,11,0.5947712418300654,
26,2,car,crv,663,810,486,569,147,83,0.7781846,12,30,11,0.564625850340136,
27,2,car,crv,667,819,485,574,152,89,0.8128246,12,30,11,0.5855263157894737,
28,2,car,crv,666,820,482,577,154,95,0.80031437,9,0,11,0.6168831168831169,
29,2,car,crv,667,820,485,573,153,88,0.8438455,12,30,11,0.5751633986928104,
30,2,car,crv,667,819,484,575,152,91,0.9125865,12,30,11,0.5986842105263158,
31,2,car,crv,668,821,485,574,153,89,0.8785678,12,30,11,0.5816993464052288,
32,2,car,crv,667,819,485,574,152,89,0.71991515,12,30,11,0.5855263157894737,
33,2,car,crv,667,820,484,577,153,93,0.7404891,12,30,11,0.6078431372549019,
34,2,car,crv,667,819,484,575,152,91,0.7707914,12,30,11,0.5986842105263158,
35,2,car,crv,662,810,486,571,148,85,0.7150951,12,30,11,0.5743243243243243,
36,2,car,crv,669,820,485,574,151,89,0.83562523,12,30,11,0.5894039735099338,
37,2,car,crv,666,820,484,574,154,90,0.78819734,12,30,11,0.5844155844155844,
38,2,car,crv,667,819,483,575,152,92,0.8056975,12,30,11,0.6052631578947368,
39,2,car,crv,668,821,485,574,153,89,0.80433,12,30,11,0.5816993464052288,
40,2,car,crv,667,820,484,572,153,88,0.7759209,12,30,11,0.5751633986928104,
41,2,car,crv,667,819,484,572,152,88,0.7274725,12,30,11,0.5789473684210527,
42,2,car,crv,810,1001,490,585,191,95,0.9551184,9,30,11,0.4973821989528796,
43,2,car,crv,807,1006,489,583,199,94,0.9514729,12,60,11,0.4723618090452261,
0,2,car,crv,668,819,484,573,151,89,0.8000626,12,30,11,0.5894039735099338,
1,2,car,crv,667,821,485,574,154,89,0.80527765,12,30,11,0.577922077922078,
2,2,car,crv,664,809,487,570,145,83,0.8104471,12,30,11,0.5724137931034483,
3,2,car,crv,662,810,486,569,148,83,0.8144621,12,30,11,0.5608108108108109,
4,2,car,crv,667,820,484,577,153,93,0.8308673,12,30,11,0.6078431372549019,
5,2,car,crv,667,820,483,575,153,92,0.84983456,12,30,11,0.6013071895424836,
6,2,car,crv,667,820,485,574,153,89,0.8510291,12,30,11,0.5816993464052288,
7,2,car,crv,662,810,486,570,148,84,0.7822179,12,30,11,0.5675675675675675,
8,2,car,crv,667,819,484,575,152,91,0.8101879,12,30,11,0.5986842105263158,
9,2,car,crv,664,809,487,570,145,83,0.77994776,12,30,11,0.5724137931034483,
10,2,car,crv,667,819,484,575,152,91,0.8454891,12,30,11,0.5986842105263158,
11,2,car,crv,667,819,483,575,152,92,0.8094451,12,30,11,1.5625,
12,2,car,crv,667,820,482,574,153,92,0.6722521,12,30,11,0.6013071895424836,
13,2,car,crv,667,819,484,574,152,90,0.8371277,12,30,11,0.5921052631578947,
14,2,car,crv,667,819,484,574,152,90,0.77298564,12,30,11,0.5921052631578947,
15,2,car,crv,667,817,484,574,150,90,0.66427475,12,30,11,0.6,
16,2,car,crv,667,819,483,574,152,91,0.79131705,12,30,11,0.5986842105263158,
17,2,car,crv,667,819,484,575,152,91,0.83604145,12,30,11,0.5986842105263158,
18,2,car,crv,668,819,484,574,151,90,0.7223766,12,30,11,0.5960264900662252,
19,2,car,crv,668,818,483,573,150,90,0.7379781,12,30,11,0.6,
20,2,car,crv,668,821,484,575,153,91,0.7870298,12,30,11,0.5947712418300654,
21,2,car,crv,667,820,484,575,153,91,0.8413766,12,30,11,0.5947712418300654,
22,2,car,crv,668,820,484,574,152,90,0.8056128,12,30,11,0.5921052631578947,
23,2,car,crv,667,820,483,575,153,92,0.66239387,12,30,11,0.6013071895424836,
24,2,car,crv,667,820,484,575,153,91,0.772995,12,30,11,0.5947712418300654,
25,2,car,crv,667,820,485,574,153,89,0.8488218,12,30,11,0.5816993464052288,
26,2,car,crv,667,820,484,575,153,91,0.78723717,12,30,11,0.5947712418300654,
27,2,car,crv,663,810,486,569,147,83,0.7781846,12,30,11,0.564625850340136,
28,2,car,crv,667,819,485,574,152,89,0.8128246,12,30,11,0.5855263157894737,
29,2,car,crv,666,820,482,577,154,95,0.80031437,9,0,11,0.6168831168831169,
30,2,car,crv,667,820,485,573,153,88,0.8438455,12,30,11,0.5751633986928104,
31,2,car,crv,667,819,484,575,152,91,0.9125865,12,30,11,0.5986842105263158,
32,2,car,crv,668,821,485,574,153,89,0.8785678,12,30,11,0.5816993464052288,
33,2,car,crv,667,819,485,574,152,89,0.71991515,12,30,11,0.5855263157894737,
34,2,car,crv,667,820,484,577,153,93,0.7404891,12,30,11,0.6078431372549019,
35,2,car,crv,667,819,484,575,152,91,0.7707914,12,30,11,0.5986842105263158,
36,2,car,crv,662,810,486,571,148,85,0.7150951,12,30,11,0.5743243243243243,
37,2,car,crv,669,820,485,574,151,89,0.83562523,12,30,11,0.5894039735099338,
38,2,car,crv,666,820,484,574,154,90,0.78819734,12,30,11,0.5844155844155844,
39,2,car,crv,667,819,483,575,152,92,0.8056975,12,30,11,0.6052631578947368,
40,2,car,crv,668,821,485,574,153,89,0.80433,12,30,11,0.5816993464052288,
41,2,car,crv,667,820,484,572,153,88,0.7759209,12,30,11,0.5751633986928104,
42,2,car,crv,667,819,484,572,152,88,0.7274725,12,30,11,0.5789473684210527,
43,2,car,crv,810,1001,490,585,191,95,0.9551184,9,30,11,0.4973821989528796,
44,2,car,crv,807,1006,489,583,199,94,0.9514729,12,60,11,0.4723618090452261,
0,2,car,crv,669,820,485,574,151,89,0.8260642,12,30,11,0.5894039735099338,
1,2,car,crv,668,819,484,573,151,89,0.8000626,12,30,11,0.5894039735099338,
2,2,car,crv,667,821,485,574,154,89,0.80527765,12,30,11,0.577922077922078,
3,2,car,crv,664,809,487,570,145,83,0.8104471,12,30,11,0.5724137931034483,
4,2,car,crv,662,810,486,569,148,83,0.8144621,12,30,11,0.5608108108108109,
5,2,car,crv,667,820,484,577,153,93,0.8308673,12,30,11,0.6078431372549019,
6,2,car,crv,667,820,483,575,153,92,0.84983456,12,30,11,0.6013071895424836,
7,2,car,crv,667,820,485,574,153,89,0.8510291,12,30,11,0.5816993464052288,
8,2,car,crv,662,810,486,570,148,84,0.7822179,12,30,11,0.5675675675675675,
9,2,car,crv,667,819,484,575,152,91,0.8101879,12,30,11,0.5986842105263158,
10,2,car,crv,664,809,487,570,145,83,0.77994776,12,30,11,0.5724137931034483,
11,2,car,crv,667,819,484,575,152,91,0.8454891,12,30,11,0.5986842105263158,
12,2,car,crv,667,819,483,575,152,92,0.8094451,12,30,11,1.5625,
13,2,car,crv,667,820,482,574,153,92,0.6722521,12,30,11,0.6013071895424836,
14,2,car,crv,667,819,484,574,152,90,0.8371277,12,30,11,0.5921052631578947,
15,2,car,crv,667,819,484,574,152,90,0.77298564,12,30,11,0.5921052631578947,
16,2,car,crv,667,817,484,574,150,90,0.66427475,12,30,11,0.6,
17,2,car,crv,667,819,483,574,152,91,0.79131705,12,30,11,0.5986842105263158,
18,2,car,crv,667,819,484,575,152,91,0.83604145,12,30,11,0.5986842105263158,
19,2,car,crv,668,819,484,574,151,90,0.7223766,12,30,11,0.5960264900662252,
20,2,car,crv,668,818,483,573,150,90,0.7379781,12,30,11,0.6,
21,2,car,crv,668,821,484,575,153,91,0.7870298,12,30,11,0.5947712418300654,
22,2,car,crv,667,820,484,575,153,91,0.8413766,12,30,11,0.5947712418300654,
23,2,car,crv,668,820,484,574,152,90,0.8056128,12,30,11,0.5921052631578947,
24,2,car,crv,667,820,483,575,153,92,0.66239387,12,30,11,0.6013071895424836,
25,2,car,crv,667,820,484,575,153,91,0.772995,12,30,11,0.5947712418300654,
26,2,car,crv,667,820,485,574,153,89,0.8488218,12,30,11,0.5816993464052288,
27,2,car,crv,667,820,484,575,153,91,0.78723717,12,30,11,0.5947712418300654,
28,2,car,crv,663,810,486,569,147,83,0.7781846,12,30,11,0.564625850340136,
29,2,car,crv,667,819,485,574,152,89,0.8128246,12,30,11,0.5855263157894737,
30,2,car,crv,666,820,482,577,154,95,0.80031437,9,0,11,0.6168831168831169,
31,2,car,crv,667,820,485,573,153,88,0.8438455,12,30,11,0.5751633986928104,
32,2,car,crv,667,819,484,575,152,91,0.9125865,12,30,11,0.5986842105263158,
33,2,car,crv,668,821,485,574,153,89,0.8785678,12,30,11,0.5816993464052288,
34,2,car,crv,667,819,485,574,152,89,0.71991515,12,30,11,0.5855263157894737,
35,2,car,crv,667,820,484,577,153,93,0.7404891,12,30,11,0.6078431372549019,
36,2,car,crv,667,819,484,575,152,91,0.7707914,12,30,11,0.5986842105263158,
37,2,car,crv,662,810,486,571,148,85,0.7150951,12,30,11,0.5743243243243243,
38,2,car,crv,669,820,485,574,151,89,0.83562523,12,30,11,0.5894039735099338,
39,2,car,crv,666,820,484,574,154,90,0.78819734,12,30,11,0.5844155844155844,
40,2,car,crv,667,819,483,575,152,92,0.8056975,12,30,11,0.6052631578947368,
41,2,car,crv,668,821,485,574,153,89,0.80433,12,30,11,0.5816993464052288,
42,2,car,crv,667,820,484,572,153,88,0.7759209,12,30,11,0.5751633986928104,
43,2,car,crv,667,819,484,572,152,88,0.7274725,12,30,11,0.5789473684210527,
44,2,car,crv,810,1001,490,585,191,95,0.9551184,9,30,11,0.4973821989528796,
45,2,car,crv,807,1006,489,583,199,94,0.9514729,12,60,11,0.4723618090452261,
0,2,car,crv,669,820,484,574,151,90,0.7934381,12,30,11,0.5960264900662252,
1,2,car,crv,669,820,485,574,151,89,0.8260642,12,30,11,0.5894039735099338,
2,2,car,crv,668,819,484,573,151,89,0.8000626,12,30,11,0.5894039735099338,
3,2,car,crv,667,821,485,574,154,89,0.80527765,12,30,11,0.577922077922078,
4,2,car,crv,664,809,487,570,145,83,0.8104471,12,30,11,0.5724137931034483,
5,2,car,crv,662,810,486,569,148,83,0.8144621,12,30,11,0.5608108108108109,
6,2,car,crv,667,820,484,577,153,93,0.8308673,12,30,11,0.6078431372549019,
7,2,car,crv,667,820,483,575,153,92,0.84983456,12,30,11,0.6013071895424836,
8,2,car,crv,667,820,485,574,153,89,0.8510291,12,30,11,0.5816993464052288,
9,2,car,crv,662,810,486,570,148,84,0.7822179,12,30,11,0.5675675675675675,
10,2,car,crv,667,819,484,575,152,91,0.8101879,12,30,11,0.5986842105263158,
11,2,car,crv,664,809,487,570,145,83,0.77994776,12,30,11,0.5724137931034483,
12,2,car,crv,667,819,484,575,152,91,0.8454891,12,30,11,0.5986842105263158,
13,2,car,crv,667,819,483,575,152,92,0.8094451,12,30,11,1.5625,
14,2,car,crv,667,820,482,574,153,92,0.6722521,12,30,11,0.6013071895424836,
15,2,car,crv,667,819,484,574,152,90,0.8371277,12,30,11,0.5921052631578947,
16,2,car,crv,667,819,484,574,152,90,0.77298564,12,30,11,0.5921052631578947,
17,2,car,crv,667,817,484,574,150,90,0.66427475,12,30,11,0.6,
18,2,car,crv,667,819,483,574,152,91,0.79131705,12,30,11,0.5986842105263158,
19,2,car,crv,667,819,484,575,152,91,0.83604145,12,30,11,0.5986842105263158,
20,2,car,crv,668,819,484,574,151,90,0.7223766,12,30,11,0.5960264900662252,
21,2,car,crv,668,818,483,573,150,90,0.7379781,12,30,11,0.6,
22,2,car,crv,668,821,484,575,153,91,0.7870298,12,30,11,0.5947712418300654,
23,2,car,crv,667,820,484,575,153,91,0.8413766,12,30,11,0.5947712418300654,
24,2,car,crv,668,820,484,574,152,90,0.8056128,12,30,11,0.5921052631578947,
25,2,car,crv,667,820,483,575,153,92,0.66239387,12,30,11,0.6013071895424836,
26,2,car,crv,667,820,484,575,153,91,0.772995,12,30,11,0.5947712418300654,
27,2,car,crv,667,820,485,574,153,89,0.8488218,12,30,11,0.5816993464052288,
28,2,car,crv,667,820,484,575,153,91,0.78723717,12,30,11,0.5947712418300654,
29,2,car,crv,663,810,486,569,147,83,0.7781846,12,30,11,0.564625850340136,
30,2,car,crv,667,819,485,574,152,89,0.8128246,12,30,11,0.5855263157894737,
31,2,car,crv,666,820,482,577,154,95,0.80031437,9,0,11,0.6168831168831169,
32,2,car,crv,667,820,485,573,153,88,0.8438455,12,30,11,0.5751633986928104,
33,2,car,crv,667,819,484,575,152,91,0.9125865,12,30,11,0.5986842105263158,
34,2,car,crv,668,821,485,574,153,89,0.8785678,12,30,11,0.5816993464052288,
35,2,car,crv,667,819,485,574,152,89,0.71991515,12,30,11,0.5855263157894737,
36,2,car,crv,667,820,484,577,153,93,0.7404891,12,30,11,0.6078431372549019,
37,2,car,crv,667,819,484,575,152,91,0.7707914,12,30,11,0.5986842105263158,
38,2,car,crv,662,810,486,571,148,85,0.7150951,12,30,11,0.5743243243243243,
39,2,car,crv,669,820,485,574,151,89,0.83562523,12,30,11,0.5894039735099338,
40,2,car,crv,666,820,484,574,154,90,0.78819734,12,30,11,0.5844155844155844,
41,2,car,crv,667,819,483,575,152,92,0.8056975,12,30,11,0.6052631578947368,
42,2,car,crv,668,821,485,574,153,89,0.80433,12,30,11,0.5816993464052288,
43,2,car,crv,667,820,484,572,153,88,0.7759209,12,30,11,0.5751633986928104,
44,2,car,crv,667,819,484,572,152,88,0.7274725,12,30,11,0.5789473684210527,
45,2,car,crv,810,1001,490,585,191,95,0.9551184,9,30,11,0.4973821989528796,
46,2,car,crv,807,1006,489,583,199,94,0.9514729,12,60,11,0.4723618090452261,
0,2,car,crv,668,819,484,575,151,91,0.8577185,12,30,11,-12413197.066473989,
1,2,car,crv,669,820,484,574,151,90,0.7934381,12,30,11,0.5960264900662252,
2,2,car,crv,669,820,485,574,151,89,0.8260642,12,30,11,0.5894039735099338,
3,2,car,crv,668,819,484,573,151,89,0.8000626,12,30,11,0.5894039735099338,
4,2,car,crv,667,821,485,574,154,89,0.80527765,12,30,11,0.577922077922078,
5,2,car,crv,664,809,487,570,145,83,0.8104471,12,30,11,0.5724137931034483,
6,2,car,crv,662,810,486,569,148,83,0.8144621,12,30,11,0.5608108108108109,
7,2,car,crv,667,820,484,577,153,93,0.8308673,12,30,11,0.6078431372549019,
8,2,car,crv,667,820,483,575,153,92,0.84983456,12,30,11,0.6013071895424836,
9,2,car,crv,667,820,485,574,153,89,0.8510291,12,30,11,0.5816993464052288,
10,2,car,crv,662,810,486,570,148,84,0.7822179,12,30,11,0.5675675675675675,
11,2,car,crv,667,819,484,575,152,91,0.8101879,12,30,11,0.5986842105263158,
12,2,car,crv,664,809,487,570,145,83,0.77994776,12,30,11,0.5724137931034483,
13,2,car,crv,667,819,484,575,152,91,0.8454891,12,30,11,0.5986842105263158,
14,2,car,crv,667,819,483,575,152,92,0.8094451,12,30,11,1.5625,
15,2,car,crv,667,820,482,574,153,92,0.6722521,12,30,11,0.6013071895424836,
16,2,car,crv,667,819,484,574,152,90,0.8371277,12,30,11,0.5921052631578947,
17,2,car,crv,667,819,484,574,152,90,0.77298564,12,30,11,0.5921052631578947,
18,2,car,crv,667,817,484,574,150,90,0.66427475,12,30,11,0.6,
19,2,car,crv,667,819,483,574,152,91,0.79131705,12,30,11,0.5986842105263158,
20,2,car,crv,667,819,484,575,152,91,0.83604145,12,30,11,0.5986842105263158,
21,2,car,crv,668,819,484,574,151,90,0.7223766,12,30,11,0.5960264900662252,
22,2,car,crv,668,818,483,573,150,90,0.7379781,12,30,11,0.6,
23,2,car,crv,668,821,484,575,153,91,0.7870298,12,30,11,0.5947712418300654,
24,2,car,crv,667,820,484,575,153,91,0.8413766,12,30,11,0.5947712418300654,
25,2,car,crv,668,820,484,574,152,90,0.8056128,12,30,11,0.5921052631578947,
26,2,car,crv,667,820,483,575,153,92,0.66239387,12,30,11,0.6013071895424836,
27,2,car,crv,667,820,484,575,153,91,0.772995,12,30,11,0.5947712418300654,
28,2,car,crv,667,820,485,574,153,89,0.8488218,12,30,11,0.5816993464052288,
29,2,car,crv,667,820,484,575,153,91,0.78723717,12,30,11,0.5947712418300654,
30,2,car,crv,663,810,486,569,147,83,0.7781846,12,30,11,0.564625850340136,
31,2,car,crv,667,819,485,574,152,89,0.8128246,12,30,11,0.5855263157894737,
32,2,car,crv,666,820,482,577,154,95,0.80031437,9,0,11,0.6168831168831169,
33,2,car,crv,667,820,485,573,153,88,0.8438455,12,30,11,0.5751633986928104,
34,2,car,crv,667,819,484,575,152,91,0.9125865,12,30,11,0.5986842105263158,
35,2,car,crv,668,821,485,574,153,89,0.8785678,12,30,11,0.5816993464052288,
36,2,car,crv,667,819,485,574,152,89,0.71991515,12,30,11,0.5855263157894737,
37,2,car,crv,667,820,484,577,153,93,0.7404891,12,30,11,0.6078431372549019,
38,2,car,crv,667,819,484,575,152,91,0.7707914,12,30,11,0.5986842105263158,
39,2,car,crv,662,810,486,571,148,85,0.7150951,12,30,11,0.5743243243243243,
40,2,car,crv,669,820,485,574,151,89,0.83562523,12,30,11,0.5894039735099338,
41,2,car,crv,666,820,484,574,154,90,0.78819734,12,30,11,0.5844155844155844,
42,2,car,crv,667,819,483,575,152,92,0.8056975,12,30,11,0.6052631578947368,
43,2,car,crv,668,821,485,574,153,89,0.80433,12,30,11,0.5816993464052288,
44,2,car,crv,667,820,484,572,153,88,0.7759209,12,30,11,0.5751633986928104,
45,2,car,crv,667,819,484,572,152,88,0.7274725,12,30,11,0.5789473684210527,
46,2,car,crv,810,1001,490,585,191,95,0.9551184,9,30,11,0.4973821989528796,
47,2,car,crv,807,1006,489,583,199,94,0.9514729,12,60,11,0.4723618090452261,
0,2,car,crv,663,809,486,569,146,83,0.7675451,12,30,11,-12897796.35135135,
1,2,car,crv,668,819,484,575,151,91,0.8577185,12,30,11,-12413197.066473989,
2,2,car,crv,669,820,484,574,151,90,0.7934381,12,30,11,0.5960264900662252,
3,2,car,crv,669,820,485,574,151,89,0.8260642,12,30,11,0.5894039735099338,
4,2,car,crv,668,819,484,573,151,89,0.8000626,12,30,11,0.5894039735099338,
5,2,car,crv,667,821,485,574,154,89,0.80527765,12,30,11,0.577922077922078,
6,2,car,crv,664,809,487,570,145,83,0.8104471,12,30,11,0.5724137931034483,
7,2,car,crv,662,810,486,569,148,83,0.8144621,12,30,11,0.5608108108108109,
8,2,car,crv,667,820,484,577,153,93,0.8308673,12,30,11,0.6078431372549019,
9,2,car,crv,667,820,483,575,153,92,0.84983456,12,30,11,0.6013071895424836,
10,2,car,crv,667,820,485,574,153,89,0.8510291,12,30,11,0.5816993464052288,
11,2,car,crv,662,810,486,570,148,84,0.7822179,12,30,11,0.5675675675675675,
12,2,car,crv,667,819,484,575,152,91,0.8101879,12,30,11,0.5986842105263158,
13,2,car,crv,664,809,487,570,145,83,0.77994776,12,30,11,0.5724137931034483,
14,2,car,crv,667,819,484,575,152,91,0.8454891,12,30,11,0.5986842105263158,
15,2,car,crv,667,819,483,575,152,92,0.8094451,12,30,11,1.5625,
16,2,car,crv,667,820,482,574,153,92,0.6722521,12,30,11,0.6013071895424836,
17,2,car,crv,667,819,484,574,152,90,0.8371277,12,30,11,0.5921052631578947,
18,2,car,crv,667,819,484,574,152,90,0.77298564,12,30,11,0.5921052631578947,
19,2,car,crv,667,817,484,574,150,90,0.66427475,12,30,11,0.6,
20,2,car,crv,667,819,483,574,152,91,0.79131705,12,30,11,0.5986842105263158,
21,2,car,crv,667,819,484,575,152,91,0.83604145,12,30,11,0.5986842105263158,
22,2,car,crv,668,819,484,574,151,90,0.7223766,12,30,11,0.5960264900662252,
23,2,car,crv,668,818,483,573,150,90,0.7379781,12,30,11,0.6,
24,2,car,crv,668,821,484,575,153,91,0.7870298,12,30,11,0.5947712418300654,
25,2,car,crv,667,820,484,575,153,91,0.8413766,12,30,11,0.5947712418300654,
26,2,car,crv,668,820,484,574,152,90,0.8056128,12,30,11,0.5921052631578947,
27,2,car,crv,667,820,483,575,153,92,0.66239387,12,30,11,0.6013071895424836,
28,2,car,crv,667,820,484,575,153,91,0.772995,12,30,11,0.5947712418300654,
29,2,car,crv,667,820,485,574,153,89,0.8488218,12,30,11,0.5816993464052288,
30,2,car,crv,667,820,484,575,153,91,0.78723717,12,30,11,0.5947712418300654,
31,2,car,crv,663,810,486,569,147,83,0.7781846,12,30,11,0.564625850340136,
32,2,car,crv,667,819,485,574,152,89,0.8128246,12,30,11,0.5855263157894737,
33,2,car,crv,666,820,482,577,154,95,0.80031437,9,0,11,0.6168831168831169,
34,2,car,crv,667,820,485,573,153,88,0.8438455,12,30,11,0.5751633986928104,
35,2,car,crv,667,819,484,575,152,91,0.9125865,12,30,11,0.5986842105263158,
36,2,car,crv,668,821,485,574,153,89,0.8785678,12,30,11,0.5816993464052288,
37,2,car,crv,667,819,485,574,152,89,0.71991515,12,30,11,0.5855263157894737,
38,2,car,crv,667,820,484,577,153,93,0.7404891,12,30,11,0.6078431372549019,
39,2,car,crv,667,819,484,575,152,91,0.7707914,12,30,11,0.5986842105263158,
40,2,car,crv,662,810,486,571,148,85,0.7150951,12,30,11,0.5743243243243243,
41,2,car,crv,669,820,485,574,151,89,0.83562523,12,30,11,0.5894039735099338,
42,2,car,crv,666,820,484,574,154,90,0.78819734,12,30,11,0.5844155844155844,
43,2,car,crv,667,819,483,575,152,92,0.8056975,12,30,11,0.6052631578947368,
44,2,car,crv,668,821,485,574,153,89,0.80433,12,30,11,0.5816993464052288,
45,2,car,crv,667,820,484,572,153,88,0.7759209,12,30,11,0.5751633986928104,
46,2,car,crv,667,819,484,572,152,88,0.7274725,12,30,11,0.5789473684210527,
47,2,car,crv,810,1001,490,585,191,95,0.9551184,9,30,11,0.4973821989528796,
48,2,car,crv,807,1006,489,583,199,94,0.9514729,12,60,11,0.4723618090452261,
0,2,car,crv,667,819,483,573,152,90,0.8037294,12,30,11,-13174742.81595092,
1,2,car,crv,663,809,486,569,146,83,0.7675451,12,30,11,-12897796.35135135,
2,2,car,crv,668,819,484,575,151,91,0.8577185,12,30,11,-12413197.066473989,
3,2,car,crv,669,820,484,574,151,90,0.7934381,12,30,11,0.5960264900662252,
4,2,car,crv,669,820,485,574,151,89,0.8260642,12,30,11,0.5894039735099338,
5,2,car,crv,668,819,484,573,151,89,0.8000626,12,30,11,0.5894039735099338,
6,2,car,crv,667,821,485,574,154,89,0.80527765,12,30,11,0.577922077922078,
7,2,car,crv,664,809,487,570,145,83,0.8104471,12,30,11,0.5724137931034483,
8,2,car,crv,662,810,486,569,148,83,0.8144621,12,30,11,0.5608108108108109,
9,2,car,crv,667,820,484,577,153,93,0.8308673,12,30,11,0.6078431372549019,
10,2,car,crv,667,820,483,575,153,92,0.84983456,12,30,11,0.6013071895424836,
11,2,car,crv,667,820,485,574,153,89,0.8510291,12,30,11,0.5816993464052288,
12,2,car,crv,662,810,486,570,148,84,0.7822179,12,30,11,0.5675675675675675,
13,2,car,crv,667,819,484,575,152,91,0.8101879,12,30,11,0.5986842105263158,
14,2,car,crv,664,809,487,570,145,83,0.77994776,12,30,11,0.5724137931034483,
15,2,car,crv,667,819,484,575,152,91,0.8454891,12,30,11,0.5986842105263158,
16,2,car,crv,667,819,483,575,152,92,0.8094451,12,30,11,1.5625,
17,2,car,crv,667,820,482,574,153,92,0.6722521,12,30,11,0.6013071895424836,
18,2,car,crv,667,819,484,574,152,90,0.8371277,12,30,11,0.5921052631578947,
19,2,car,crv,667,819,484,574,152,90,0.77298564,12,30,11,0.5921052631578947,
20,2,car,crv,667,817,484,574,150,90,0.66427475,12,30,11,0.6,
21,2,car,crv,667,819,483,574,152,91,0.79131705,12,30,11,0.5986842105263158,
22,2,car,crv,667,819,484,575,152,91,0.83604145,12,30,11,0.5986842105263158,
23,2,car,crv,668,819,484,574,151,90,0.7223766,12,30,11,0.5960264900662252,
24,2,car,crv,668,818,483,573,150,90,0.7379781,12,30,11,0.6,
25,2,car,crv,668,821,484,575,153,91,0.7870298,12,30,11,0.5947712418300654,
26,2,car,crv,667,820,484,575,153,91,0.8413766,12,30,11,0.5947712418300654,
27,2,car,crv,668,820,484,574,152,90,0.8056128,12,30,11,0.5921052631578947,
28,2,car,crv,667,820,483,575,153,92,0.66239387,12,30,11,0.6013071895424836,
29,2,car,crv,667,820,484,575,153,91,0.772995,12,30,11,0.5947712418300654,
30,2,car,crv,667,820,485,574,153,89,0.8488218,12,30,11,0.5816993464052288,
31,2,car,crv,667,820,484,575,153,91,0.78723717,12,30,11,0.5947712418300654,
32,2,car,crv,663,810,486,569,147,83,0.7781846,12,30,11,0.564625850340136,
33,2,car,crv,667,819,485,574,152,89,0.8128246,12,30,11,0.5855263157894737,
34,2,car,crv,666,820,482,577,154,95,0.80031437,9,0,11,0.6168831168831169,
35,2,car,crv,667,820,485,573,153,88,0.8438455,12,30,11,0.5751633986928104,
36,2,car,crv,667,819,484,575,152,91,0.9125865,12,30,11,0.5986842105263158,
37,2,car,crv,668,821,485,574,153,89,0.8785678,12,30,11,0.5816993464052288,
38,2,car,crv,667,819,485,574,152,89,0.71991515,12,30,11,0.5855263157894737,
39,2,car,crv,667,820,484,577,153,93,0.7404891,12,30,11,0.6078431372549019,
40,2,car,crv,667,819,484,575,152,91,0.7707914,12,30,11,0.5986842105263158,
41,2,car,crv,662,810,486,571,148,85,0.7150951,12,30,11,0.5743243243243243,
42,2,car,crv,669,820,485,574,151,89,0.83562523,12,30,11,0.5894039735099338,
43,2,car,crv,666,820,484,574,154,90,0.78819734,12,30,11,0.5844155844155844,
44,2,car,crv,667,819,483,575,152,92,0.8056975,12,30,11,0.6052631578947368,
45,2,car,crv,668,821,485,574,153,89,0.80433,12,30,11,0.5816993464052288,
46,2,car,crv,667,820,484,572,153,88,0.7759209,12,30,11,0.5751633986928104,
47,2,car,crv,667,819,484,572,152,88,0.7274725,12,30,11,0.5789473684210527,
48,2,car,crv,810,1001,490,585,191,95,0.9551184,9,30,11,0.4973821989528796,
49,2,car,crv,807,1006,489,583,199,94,0.9514729,12,60,11,0.4723618090452261,
0,2,car,crv,667,820,484,574,153,90,0.68943864,12,30,11,0.5882352941176471,
1,2,car,crv,667,819,483,573,152,90,0.8037294,12,30,11,-13174742.81595092,
2,2,car,crv,663,809,486,569,146,83,0.7675451,12,30,11,-12897796.35135135,
3,2,car,crv,668,819,484,575,151,91,0.8577185,12,30,11,-12413197.066473989,
4,2,car,crv,669,820,484,574,151,90,0.7934381,12,30,11,0.5960264900662252,
5,2,car,crv,669,820,485,574,151,89,0.8260642,12,30,11,0.5894039735099338,
6,2,car,crv,668,819,484,573,151,89,0.8000626,12,30,11,0.5894039735099338,
7,2,car,crv,667,821,485,574,154,89,0.80527765,12,30,11,0.577922077922078,
8,2,car,crv,664,809,487,570,145,83,0.8104471,12,30,11,0.5724137931034483,
9,2,car,crv,662,810,486,569,148,83,0.8144621,12,30,11,0.5608108108108109,
10,2,car,crv,667,820,484,577,153,93,0.8308673,12,30,11,0.6078431372549019,
11,2,car,crv,667,820,483,575,153,92,0.84983456,12,30,11,0.6013071895424836,
12,2,car,crv,667,820,485,574,153,89,0.8510291,12,30,11,0.5816993464052288,
13,2,car,crv,662,810,486,570,148,84,0.7822179,12,30,11,0.5675675675675675,
14,2,car,crv,667,819,484,575,152,91,0.8101879,12,30,11,0.5986842105263158,
15,2,car,crv,664,809,487,570,145,83,0.77994776,12,30,11,0.5724137931034483,
16,2,car,crv,667,819,484,575,152,91,0.8454891,12,30,11,0.5986842105263158,
17,2,car,crv,667,819,483,575,152,92,0.8094451,12,30,11,1.5625,
18,2,car,crv,667,820,482,574,153,92,0.6722521,12,30,11,0.6013071895424836,
19,2,car,crv,667,819,484,574,152,90,0.8371277,12,30,11,0.5921052631578947,
20,2,car,crv,667,819,484,574,152,90,0.77298564,12,30,11,0.5921052631578947,
21,2,car,crv,667,817,484,574,150,90,0.66427475,12,30,11,0.6,
22,2,car,crv,667,819,483,574,152,91,0.79131705,12,30,11,0.5986842105263158,
23,2,car,crv,667,819,484,575,152,91,0.83604145,12,30,11,0.5986842105263158,
24,2,car,crv,668,819,484,574,151,90,0.7223766,12,30,11,0.5960264900662252,
25,2,car,crv,668,818,483,573,150,90,0.7379781,12,30,11,0.6,
26,2,car,crv,668,821,484,575,153,91,0.7870298,12,30,11,0.5947712418300654,
27,2,car,crv,667,820,484,575,153,91,0.8413766,12,30,11,0.5947712418300654,
28,2,car,crv,668,820,484,574,152,90,0.8056128,12,30,11,0.5921052631578947,
29,2,car,crv,667,820,483,575,153,92,0.66239387,12,30,11,0.6013071895424836,
30,2,car,crv,667,820,484,575,153,91,0.772995,12,30,11,0.5947712418300654,
31,2,car,crv,667,820,485,574,153,89,0.8488218,12,30,11,0.5816993464052288,
32,2,car,crv,667,820,484,575,153,91,0.78723717,12,30,11,0.5947712418300654,
33,2,car,crv,663,810,486,569,147,83,0.7781846,12,30,11,0.564625850340136,
34,2,car,crv,667,819,485,574,152,89,0.8128246,12,30,11,0.5855263157894737,
35,2,car,crv,666,820,482,577,154,95,0.80031437,9,0,11,0.6168831168831169,
36,2,car,crv,667,820,485,573,153,88,0.8438455,12,30,11,0.5751633986928104,
37,2,car,crv,667,819,484,575,152,91,0.9125865,12,30,11,0.5986842105263158,
38,2,car,crv,668,821,485,574,153,89,0.8785678,12,30,11,0.5816993464052288,
39,2,car,crv,667,819,485,574,152,89,0.71991515,12,30,11,0.5855263157894737,
40,2,car,crv,667,820,484,577,153,93,0.7404891,12,30,11,0.6078431372549019,
41,2,car,crv,667,819,484,575,152,91,0.7707914,12,30,11,0.5986842105263158,
42,2,car,crv,662,810,486,571,148,85,0.7150951,12,30,11,0.5743243243243243,
43,2,car,crv,669,820,485,574,151,89,0.83562523,12,30,11,0.5894039735099338,
44,2,car,crv,666,820,484,574,154,90,0.78819734,12,30,11,0.5844155844155844,
45,2,car,crv,667,819,483,575,152,92,0.8056975,12,30,11,0.6052631578947368,
46,2,car,crv,668,821,485,574,153,89,0.80433,12,30,11,0.5816993464052288,
47,2,car,crv,667,820,484,572,153,88,0.7759209,12,30,11,0.5751633986928104,
48,2,car,crv,667,819,484,572,152,88,0.7274725,12,30,11,0.5789473684210527,
49,2,car,crv,810,1001,490,585,191,95,0.9551184,9,30,11,0.4973821989528796,
50,2,car,crv,807,1006,489,583,199,94,0.9514729,12,60,11,0.4723618090452261,
0,2,car,crv,667,819,483,575,152,92,0.8015768,12,30,11,-13421769.275,
1,2,car,crv,667,820,484,574,153,90,0.68943864,12,30,11,0.5882352941176471,
2,2,car,crv,667,819,483,573,152,90,0.8037294,12,30,11,-13174742.81595092,
3,2,car,crv,663,809,486,569,146,83,0.7675451,12,30,11,-12897796.35135135,
4,2,car,crv,668,819,484,575,151,91,0.8577185,12,30,11,-12413197.066473989,
5,2,car,crv,669,820,484,574,151,90,0.7934381,12,30,11,0.5960264900662252,
6,2,car,crv,669,820,485,574,151,89,0.8260642,12,30,11,0.5894039735099338,
7,2,car,crv,668,819,484,573,151,89,0.8000626,12,30,11,0.5894039735099338,
8,2,car,crv,667,821,485,574,154,89,0.80527765,12,30,11,0.577922077922078,
9,2,car,crv,664,809,487,570,145,83,0.8104471,12,30,11,0.5724137931034483,
10,2,car,crv,662,810,486,569,148,83,0.8144621,12,30,11,0.5608108108108109,
11,2,car,crv,667,820,484,577,153,93,0.8308673,12,30,11,0.6078431372549019,
12,2,car,crv,667,820,483,575,153,92,0.84983456,12,30,11,0.6013071895424836,
13,2,car,crv,667,820,485,574,153,89,0.8510291,12,30,11,0.5816993464052288,
14,2,car,crv,662,810,486,570,148,84,0.7822179,12,30,11,0.5675675675675675,
15,2,car,crv,667,819,484,575,152,91,0.8101879,12,30,11,0.5986842105263158,
16,2,car,crv,664,809,487,570,145,83,0.77994776,12,30,11,0.5724137931034483,
17,2,car,crv,667,819,484,575,152,91,0.8454891,12,30,11,0.5986842105263158,
18,2,car,crv,667,819,483,575,152,92,0.8094451,12,30,11,1.5625,
19,2,car,crv,667,820,482,574,153,92,0.6722521,12,30,11,0.6013071895424836,
20,2,car,crv,667,819,484,574,152,90,0.8371277,12,30,11,0.5921052631578947,
21,2,car,crv,667,819,484,574,152,90,0.77298564,12,30,11,0.5921052631578947,
22,2,car,crv,667,817,484,574,150,90,0.66427475,12,30,11,0.6,
23,2,car,crv,667,819,483,574,152,91,0.79131705,12,30,11,0.5986842105263158,
24,2,car,crv,667,819,484,575,152,91,0.83604145,12,30,11,0.5986842105263158,
25,2,car,crv,668,819,484,574,151,90,0.7223766,12,30,11,0.5960264900662252,
26,2,car,crv,668,818,483,573,150,90,0.7379781,12,30,11,0.6,
27,2,car,crv,668,821,484,575,153,91,0.7870298,12,30,11,0.5947712418300654,
28,2,car,crv,667,820,484,575,153,91,0.8413766,12,30,11,0.5947712418300654,
29,2,car,crv,668,820,484,574,152,90,0.8056128,12,30,11,0.5921052631578947,
30,2,car,crv,667,820,483,575,153,92,0.66239387,12,30,11,0.6013071895424836,
31,2,car,crv,667,820,484,575,153,91,0.772995,12,30,11,0.5947712418300654,
32,2,car,crv,667,820,485,574,153,89,0.8488218,12,30,11,0.5816993464052288,
33,2,car,crv,667,820,484,575,153,91,0.78723717,12,30,11,0.5947712418300654,
34,2,car,crv,663,810,486,569,147,83,0.7781846,12,30,11,0.564625850340136,
35,2,car,crv,667,819,485,574,152,89,0.8128246,12,30,11,0.5855263157894737,
36,2,car,crv,666,820,482,577,154,95,0.80031437,9,0,11,0.6168831168831169,
37,2,car,crv,667,820,485,573,153,88,0.8438455,12,30,11,0.5751633986928104,
38,2,car,crv,667,819,484,575,152,91,0.9125865,12,30,11,0.5986842105263158,
39,2,car,crv,668,821,485,574,153,89,0.8785678,12,30,11,0.5816993464052288,
40,2,car,crv,667,819,485,574,152,89,0.71991515,12,30,11,0.5855263157894737,
41,2,car,crv,667,820,484,577,153,93,0.7404891,12,30,11,0.6078431372549019,
42,2,car,crv,667,819,484,575,152,91,0.7707914,12,30,11,0.5986842105263158,
43,2,car,crv,662,810,486,571,148,85,0.7150951,12,30,11,0.5743243243243243,
44,2,car,crv,669,820,485,574,151,89,0.83562523,12,30,11,0.5894039735099338,
45,2,car,crv,666,820,484,574,154,90,0.78819734,12,30,11,0.5844155844155844,
46,2,car,crv,667,819,483,575,152,92,0.8056975,12,30,11,0.6052631578947368,
47,2,car,crv,668,821,485,574,153,89,0.80433,12,30,11,0.5816993464052288,
48,2,car,crv,667,820,484,572,153,88,0.7759209,12,30,11,0.5751633986928104,
49,2,car,crv,667,819,484,572,152,88,0.7274725,12,30,11,0.5789473684210527,
50,2,car,crv,810,1001,490,585,191,95,0.9551184,9,30,11,0.4973821989528796,
51,2,car,crv,807,1006,489,583,199,94,0.9514729,12,60,11,0.4723618090452261,
0,2,car,crv,667,820,483,576,153,93,0.73838603,12,30,11,-17248860.90763052,
1,2,car,crv,667,819,483,575,152,92,0.8015768,12,30,11,-13421769.275,
2,2,car,crv,667,820,484,574,153,90,0.68943864,12,30,11,0.5882352941176471,
3,2,car,crv,667,819,483,573,152,90,0.8037294,12,30,11,-13174742.81595092,
4,2,car,crv,663,809,486,569,146,83,0.7675451,12,30,11,-12897796.35135135,
5,2,car,crv,668,819,484,575,151,91,0.8577185,12,30,11,-12413197.066473989,
6,2,car,crv,669,820,484,574,151,90,0.7934381,12,30,11,0.5960264900662252,
7,2,car,crv,669,820,485,574,151,89,0.8260642,12,30,11,0.5894039735099338,
8,2,car,crv,668,819,484,573,151,89,0.8000626,12,30,11,0.5894039735099338,
9,2,car,crv,667,821,485,574,154,89,0.80527765,12,30,11,0.577922077922078,
10,2,car,crv,664,809,487,570,145,83,0.8104471,12,30,11,0.5724137931034483,
11,2,car,crv,662,810,486,569,148,83,0.8144621,12,30,11,0.5608108108108109,
12,2,car,crv,667,820,484,577,153,93,0.8308673,12,30,11,0.6078431372549019,
13,2,car,crv,667,820,483,575,153,92,0.84983456,12,30,11,0.6013071895424836,
14,2,car,crv,667,820,485,574,153,89,0.8510291,12,30,11,0.5816993464052288,
15,2,car,crv,662,810,486,570,148,84,0.7822179,12,30,11,0.5675675675675675,
16,2,car,crv,667,819,484,575,152,91,0.8101879,12,30,11,0.5986842105263158,
17,2,car,crv,664,809,487,570,145,83,0.77994776,12,30,11,0.5724137931034483,
18,2,car,crv,667,819,484,575,152,91,0.8454891,12,30,11,0.5986842105263158,
19,2,car,crv,667,819,483,575,152,92,0.8094451,12,30,11,1.5625,
20,2,car,crv,667,820,482,574,153,92,0.6722521,12,30,11,0.6013071895424836,
21,2,car,crv,667,819,484,574,152,90,0.8371277,12,30,11,0.5921052631578947,
22,2,car,crv,667,819,484,574,152,90,0.77298564,12,30,11,0.5921052631578947,
23,2,car,crv,667,817,484,574,150,90,0.66427475,12,30,11,0.6,
24,2,car,crv,667,819,483,574,152,91,0.79131705,12,30,11,0.5986842105263158,
25,2,car,crv,667,819,484,575,152,91,0.83604145,12,30,11,0.5986842105263158,
26,2,car,crv,668,819,484,574,151,90,0.7223766,12,30,11,0.5960264900662252,
27,2,car,crv,668,818,483,573,150,90,0.7379781,12,30,11,0.6,
28,2,car,crv,668,821,484,575,153,91,0.7870298,12,30,11,0.5947712418300654,
29,2,car,crv,667,820,484,575,153,91,0.8413766,12,30,11,0.5947712418300654,
30,2,car,crv,668,820,484,574,152,90,0.8056128,12,30,11,0.5921052631578947,
31,2,car,crv,667,820,483,575,153,92,0.66239387,12,30,11,0.6013071895424836,
32,2,car,crv,667,820,484,575,153,91,0.772995,12,30,11,0.5947712418300654,
33,2,car,crv,667,820,485,574,153,89,0.8488218,12,30,11,0.5816993464052288,
34,2,car,crv,667,820,484,575,153,91,0.78723717,12,30,11,0.5947712418300654,
35,2,car,crv,663,810,486,569,147,83,0.7781846,12,30,11,0.564625850340136,
36,2,car,crv,667,819,485,574,152,89,0.8128246,12,30,11,0.5855263157894737,
37,2,car,crv,666,820,482,577,154,95,0.80031437,9,0,11,0.6168831168831169,
38,2,car,crv,667,820,485,573,153,88,0.8438455,12,30,11,0.5751633986928104,
39,2,car,crv,667,819,484,575,152,91,0.9125865,12,30,11,0.5986842105263158,
40,2,car,crv,668,821,485,574,153,89,0.8785678,12,30,11,0.5816993464052288,
41,2,car,crv,667,819,485,574,152,89,0.71991515,12,30,11,0.5855263157894737,
42,2,car,crv,667,820,484,577,153,93,0.7404891,12,30,11,0.6078431372549019,
43,2,car,crv,667,819,484,575,152,91,0.7707914,12,30,11,0.5986842105263158,
44,2,car,crv,662,810,486,571,148,85,0.7150951,12,30,11,0.5743243243243243,
45,2,car,crv,669,820,485,574,151,89,0.83562523,12,30,11,0.5894039735099338,
46,2,car,crv,666,820,484,574,154,90,0.78819734,12,30,11,0.5844155844155844,
47,2,car,crv,667,819,483,575,152,92,0.8056975,12,30,11,0.6052631578947368,
48,2,car,crv,668,821,485,574,153,89,0.80433,12,30,11,0.5816993464052288,
49,2,car,crv,667,820,484,572,153,88,0.7759209,12,30,11,0.5751633986928104,
50,2,car,crv,667,819,484,572,152,88,0.7274725,12,30,11,0.5789473684210527,
51,2,car,crv,810,1001,490,585,191,95,0.9551184,9,30,11,0.4973821989528796,
52,2,car,crv,807,1006,489,583,199,94,0.9514729,12,60,11,0.4723618090452261,
0,2,car,crv,669,819,484,574,150,90,0.81360966,12,30,11,-18592927.83982684,
1,2,car,crv,667,820,483,576,153,93,0.73838603,12,30,11,-17248860.90763052,
2,2,car,crv,667,819,483,575,152,92,0.8015768,12,30,11,-13421769.275,
3,2,car,crv,667,820,484,574,153,90,0.68943864,12,30,11,0.5882352941176471,
4,2,car,crv,667,819,483,573,152,90,0.8037294,12,30,11,-13174742.81595092,
5,2,car,crv,663,809,486,569,146,83,0.7675451,12,30,11,-12897796.35135135,
6,2,car,crv,668,819,484,575,151,91,0.8577185,12,30,11,-12413197.066473989,
7,2,car,crv,669,820,484,574,151,90,0.7934381,12,30,11,0.5960264900662252,
8,2,car,crv,669,820,485,574,151,89,0.8260642,12,30,11,0.5894039735099338,
9,2,car,crv,668,819,484,573,151,89,0.8000626,12,30,11,0.5894039735099338,
10,2,car,crv,667,821,485,574,154,89,0.80527765,12,30,11,0.577922077922078,
11,2,car,crv,664,809,487,570,145,83,0.8104471,12,30,11,0.5724137931034483,
12,2,car,crv,662,810,486,569,148,83,0.8144621,12,30,11,0.5608108108108109,
13,2,car,crv,667,820,484,577,153,93,0.8308673,12,30,11,0.6078431372549019,
14,2,car,crv,667,820,483,575,153,92,0.84983456,12,30,11,0.6013071895424836,
15,2,car,crv,667,820,485,574,153,89,0.8510291,12,30,11,0.5816993464052288,
16,2,car,crv,662,810,486,570,148,84,0.7822179,12,30,11,0.5675675675675675,
17,2,car,crv,667,819,484,575,152,91,0.8101879,12,30,11,0.5986842105263158,
18,2,car,crv,664,809,487,570,145,83,0.77994776,12,30,11,0.5724137931034483,
19,2,car,crv,667,819,484,575,152,91,0.8454891,12,30,11,0.5986842105263158,
20,2,car,crv,667,819,483,575,152,92,0.8094451,12,30,11,1.5625,
21,2,car,crv,667,820,482,574,153,92,0.6722521,12,30,11,0.6013071895424836,
22,2,car,crv,667,819,484,574,152,90,0.8371277,12,30,11,0.5921052631578947,
23,2,car,crv,667,819,484,574,152,90,0.77298564,12,30,11,0.5921052631578947,
24,2,car,crv,667,817,484,574,150,90,0.66427475,12,30,11,0.6,
25,2,car,crv,667,819,483,574,152,91,0.79131705,12,30,11,0.5986842105263158,
26,2,car,crv,667,819,484,575,152,91,0.83604145,12,30,11,0.5986842105263158,
27,2,car,crv,668,819,484,574,151,90,0.7223766,12,30,11,0.5960264900662252,
28,2,car,crv,668,818,483,573,150,90,0.7379781,12,30,11,0.6,
29,2,car,crv,668,821,484,575,153,91,0.7870298,12,30,11,0.5947712418300654,
30,2,car,crv,667,820,484,575,153,91,0.8413766,12,30,11,0.5947712418300654,
31,2,car,crv,668,820,484,574,152,90,0.8056128,12,30,11,0.5921052631578947,
32,2,car,crv,667,820,483,575,153,92,0.66239387,12,30,11,0.6013071895424836,
33,2,car,crv,667,820,484,575,153,91,0.772995,12,30,11,0.5947712418300654,
34,2,car,crv,667,820,485,574,153,89,0.8488218,12,30,11,0.5816993464052288,
35,2,car,crv,667,820,484,575,153,91,0.78723717,12,30,11,0.5947712418300654,
36,2,car,crv,663,810,486,569,147,83,0.7781846,12,30,11,0.564625850340136,
37,2,car,crv,667,819,485,574,152,89,0.8128246,12,30,11,0.5855263157894737,
38,2,car,crv,666,820,482,577,154,95,0.80031437,9,0,11,0.6168831168831169,
39,2,car,crv,667,820,485,573,153,88,0.8438455,12,30,11,0.5751633986928104,
40,2,car,crv,667,819,484,575,152,91,0.9125865,12,30,11,0.5986842105263158,
41,2,car,crv,668,821,485,574,153,89,0.8785678,12,30,11,0.5816993464052288,
42,2,car,crv,667,819,485,574,152,89,0.71991515,12,30,11,0.5855263157894737,
43,2,car,crv,667,820,484,577,153,93,0.7404891,12,30,11,0.6078431372549019,
44,2,car,crv,667,819,484,575,152,91,0.7707914,12,30,11,0.5986842105263158,
45,2,car,crv,662,810,486,571,148,85,0.7150951,12,30,11,0.5743243243243243,
46,2,car,crv,669,820,485,574,151,89,0.83562523,12,30,11,0.5894039735099338,
47,2,car,crv,666,820,484,574,154,90,0.78819734,12,30,11,0.5844155844155844,
48,2,car,crv,667,819,483,575,152,92,0.8056975,12,30,11,0.6052631578947368,
49,2,car,crv,668,821,485,574,153,89,0.80433,12,30,11,0.5816993464052288,
50,2,car,crv,667,820,484,572,153,88,0.7759209,12,30,11,0.5751633986928104,
51,2,car,crv,667,819,484,572,152,88,0.7274725,12,30,11,0.5789473684210527,
52,2,car,crv,810,1001,490,585,191,95,0.9551184,9,30,11,0.4973821989528796,
53,2,car,crv,807,1006,489,583,199,94,0.9514729,12,60,11,0.4723618090452261,
0,2,car,crv,667,820,484,575,153,91,0.8247261,12,30,11,-17043516.26190476,
1,2,car,crv,669,819,484,574,150,90,0.81360966,12,30,11,-18592927.83982684,
2,2,car,crv,667,820,483,576,153,93,0.73838603,12,30,11,-17248860.90763052,
3,2,car,crv,667,819,483,575,152,92,0.8015768,12,30,11,-13421769.275,
4,2,car,crv,667,820,484,574,153,90,0.68943864,12,30,11,0.5882352941176471,
5,2,car,crv,667,819,483,573,152,90,0.8037294,12,30,11,-13174742.81595092,
6,2,car,crv,663,809,486,569,146,83,0.7675451,12,30,11,-12897796.35135135,
7,2,car,crv,668,819,484,575,151,91,0.8577185,12,30,11,-12413197.066473989,
8,2,car,crv,669,820,484,574,151,90,0.7934381,12,30,11,0.5960264900662252,
9,2,car,crv,669,820,485,574,151,89,0.8260642,12,30,11,0.5894039735099338,
10,2,car,crv,668,819,484,573,151,89,0.8000626,12,30,11,0.5894039735099338,
11,2,car,crv,667,821,485,574,154,89,0.80527765,12,30,11,0.577922077922078,
12,2,car,crv,664,809,487,570,145,83,0.8104471,12,30,11,0.5724137931034483,
13,2,car,crv,662,810,486,569,148,83,0.8144621,12,30,11,0.5608108108108109,
14,2,car,crv,667,820,484,577,153,93,0.8308673,12,30,11,0.6078431372549019,
15,2,car,crv,667,820,483,575,153,92,0.84983456,12,30,11,0.6013071895424836,
16,2,car,crv,667,820,485,574,153,89,0.8510291,12,30,11,0.5816993464052288,
17,2,car,crv,662,810,486,570,148,84,0.7822179,12,30,11,0.5675675675675675,
18,2,car,crv,667,819,484,575,152,91,0.8101879,12,30,11,0.5986842105263158,
19,2,car,crv,664,809,487,570,145,83,0.77994776,12,30,11,0.5724137931034483,
20,2,car,crv,667,819,484,575,152,91,0.8454891,12,30,11,0.5986842105263158,
21,2,car,crv,667,819,483,575,152,92,0.8094451,12,30,11,1.5625,
22,2,car,crv,667,820,482,574,153,92,0.6722521,12,30,11,0.6013071895424836,
23,2,car,crv,667,819,484,574,152,90,0.8371277,12,30,11,0.5921052631578947,
24,2,car,crv,667,819,484,574,152,90,0.77298564,12,30,11,0.5921052631578947,
25,2,car,crv,667,817,484,574,150,90,0.66427475,12,30,11,0.6,
26,2,car,crv,667,819,483,574,152,91,0.79131705,12,30,11,0.5986842105263158,
27,2,car,crv,667,819,484,575,152,91,0.83604145,12,30,11,0.5986842105263158,
28,2,car,crv,668,819,484,574,151,90,0.7223766,12,30,11,0.5960264900662252,
29,2,car,crv,668,818,483,573,150,90,0.7379781,12,30,11,0.6,
30,2,car,crv,668,821,484,575,153,91,0.7870298,12,30,11,0.5947712418300654,
31,2,car,crv,667,820,484,575,153,91,0.8413766,12,30,11,0.5947712418300654,
32,2,car,crv,668,820,484,574,152,90,0.8056128,12,30,11,0.5921052631578947,
33,2,car,crv,667,820,483,575,153,92,0.66239387,12,30,11,0.6013071895424836,
34,2,car,crv,667,820,484,575,153,91,0.772995,12,30,11,0.5947712418300654,
35,2,car,crv,667,820,485,574,153,89,0.8488218,12,30,11,0.5816993464052288,
36,2,car,crv,667,820,484,575,153,91,0.78723717,12,30,11,0.5947712418300654,
37,2,car,crv,663,810,486,569,147,83,0.7781846,12,30,11,0.564625850340136,
38,2,car,crv,667,819,485,574,152,89,0.8128246,12,30,11,0.5855263157894737,
39,2,car,crv,666,820,482,577,154,95,0.80031437,9,0,11,0.6168831168831169,
40,2,car,crv,667,820,485,573,153,88,0.8438455,12,30,11,0.5751633986928104,
41,2,car,crv,667,819,484,575,152,91,0.9125865,12,30,11,0.5986842105263158,
42,2,car,crv,668,821,485,574,153,89,0.8785678,12,30,11,0.5816993464052288,
43,2,car,crv,667,819,485,574,152,89,0.71991515,12,30,11,0.5855263157894737,
44,2,car,crv,667,820,484,577,153,93,0.7404891,12,30,11,0.6078431372549019,
45,2,car,crv,667,819,484,575,152,91,0.7707914,12,30,11,0.5986842105263158,
46,2,car,crv,662,810,486,571,148,85,0.7150951,12,30,11,0.5743243243243243,
47,2,car,crv,669,820,485,574,151,89,0.83562523,12,30,11,0.5894039735099338,
48,2,car,crv,666,820,484,574,154,90,0.78819734,12,30,11,0.5844155844155844,
49,2,car,crv,667,819,483,575,152,92,0.8056975,12,30,11,0.6052631578947368,
50,2,car,crv,668,821,485,574,153,89,0.80433,12,30,11,0.5816993464052288,
51,2,car,crv,667,820,484,572,153,88,0.7759209,12,30,11,0.5751633986928104,
52,2,car,crv,667,819,484,572,152,88,0.7274725,12,30,11,0.5789473684210527,
53,2,car,crv,810,1001,490,585,191,95,0.9551184,9,30,11,0.4973821989528796,
54,2,car,crv,807,1006,489,583,199,94,0.9514729,12,60,11,0.4723618090452261,
0,2,car,crv,667,820,484,575,153,91,0.7467092,12,30,11,-16207419.275471698,
1,2,car,crv,667,820,484,575,153,91,0.8247261,12,30,11,-17043516.26190476,
2,2,car,crv,669,819,484,574,150,90,0.81360966,12,30,11,-18592927.83982684,
3,2,car,crv,667,820,483,576,153,93,0.73838603,12,30,11,-17248860.90763052,
4,2,car,crv,667,819,483,575,152,92,0.8015768,12,30,11,-13421769.275,
5,2,car,crv,667,820,484,574,153,90,0.68943864,12,30,11,0.5882352941176471,
6,2,car,crv,667,819,483,573,152,90,0.8037294,12,30,11,-13174742.81595092,
7,2,car,crv,663,809,486,569,146,83,0.7675451,12,30,11,-12897796.35135135,
8,2,car,crv,668,819,484,575,151,91,0.8577185,12,30,11,-12413197.066473989,
9,2,car,crv,669,820,484,574,151,90,0.7934381,12,30,11,0.5960264900662252,
10,2,car,crv,669,820,485,574,151,89,0.8260642,12,30,11,0.5894039735099338,
11,2,car,crv,668,819,484,573,151,89,0.8000626,12,30,11,0.5894039735099338,
12,2,car,crv,667,821,485,574,154,89,0.80527765,12,30,11,0.577922077922078,
13,2,car,crv,664,809,487,570,145,83,0.8104471,12,30,11,0.5724137931034483,
14,2,car,crv,662,810,486,569,148,83,0.8144621,12,30,11,0.5608108108108109,
15,2,car,crv,667,820,484,577,153,93,0.8308673,12,30,11,0.6078431372549019,
16,2,car,crv,667,820,483,575,153,92,0.84983456,12,30,11,0.6013071895424836,
17,2,car,crv,667,820,485,574,153,89,0.8510291,12,30,11,0.5816993464052288,
18,2,car,crv,662,810,486,570,148,84,0.7822179,12,30,11,0.5675675675675675,
19,2,car,crv,667,819,484,575,152,91,0.8101879,12,30,11,0.5986842105263158,
20,2,car,crv,664,809,487,570,145,83,0.77994776,12,30,11,0.5724137931034483,
21,2,car,crv,667,819,484,575,152,91,0.8454891,12,30,11,0.5986842105263158,
22,2,car,crv,667,819,483,575,152,92,0.8094451,12,30,11,1.5625,
23,2,car,crv,667,820,482,574,153,92,0.6722521,12,30,11,0.6013071895424836,
24,2,car,crv,667,819,484,574,152,90,0.8371277,12,30,11,0.5921052631578947,
25,2,car,crv,667,819,484,574,152,90,0.77298564,12,30,11,0.5921052631578947,
26,2,car,crv,667,817,484,574,150,90,0.66427475,12,30,11,0.6,
27,2,car,crv,667,819,483,574,152,91,0.79131705,12,30,11,0.5986842105263158,
28,2,car,crv,667,819,484,575,152,91,0.83604145,12,30,11,0.5986842105263158,
29,2,car,crv,668,819,484,574,151,90,0.7223766,12,30,11,0.5960264900662252,
30,2,car,crv,668,818,483,573,150,90,0.7379781,12,30,11,0.6,
31,2,car,crv,668,821,484,575,153,91,0.7870298,12,30,11,0.5947712418300654,
32,2,car,crv,667,820,484,575,153,91,0.8413766,12,30,11,0.5947712418300654,
33,2,car,crv,668,820,484,574,152,90,0.8056128,12,30,11,0.5921052631578947,
34,2,car,crv,667,820,483,575,153,92,0.66239387,12,30,11,0.6013071895424836,
35,2,car,crv,667,820,484,575,153,91,0.772995,12,30,11,0.5947712418300654,
36,2,car,crv,667,820,485,574,153,89,0.8488218,12,30,11,0.5816993464052288,
37,2,car,crv,667,820,484,575,153,91,0.78723717,12,30,11,0.5947712418300654,
38,2,car,crv,663,810,486,569,147,83,0.7781846,12,30,11,0.564625850340136,
39,2,car,crv,667,819,485,574,152,89,0.8128246,12,30,11,0.5855263157894737,
40,2,car,crv,666,820,482,577,154,95,0.80031437,9,0,11,0.6168831168831169,
41,2,car,crv,667,820,485,573,153,88,0.8438455,12,30,11,0.5751633986928104,
42,2,car,crv,667,819,484,575,152,91,0.9125865,12,30,11,0.5986842105263158,
43,2,car,crv,668,821,485,574,153,89,0.8785678,12,30,11,0.5816993464052288,
44,2,car,crv,667,819,485,574,152,89,0.71991515,12,30,11,0.5855263157894737,
45,2,car,crv,667,820,484,577,153,93,0.7404891,12,30,11,0.6078431372549019,
46,2,car,crv,667,819,484,575,152,91,0.7707914,12,30,11,0.5986842105263158,
47,2,car,crv,662,810,486,571,148,85,0.7150951,12,30,11,0.5743243243243243,
48,2,car,crv,669,820,485,574,151,89,0.83562523,12,30,11,0.5894039735099338,
49,2,car,crv,666,820,484,574,154,90,0.78819734,12,30,11,0.5844155844155844,
50,2,car,crv,667,819,483,575,152,92,0.8056975,12,30,11,0.6052631578947368,
51,2,car,crv,668,821,485,574,153,89,0.80433,12,30,11,0.5816993464052288,
52,2,car,crv,667,820,484,572,153,88,0.7759209,12,30,11,0.5751633986928104,
53,2,car,crv,667,819,484,572,152,88,0.7274725,12,30,11,0.5789473684210527,
54,2,car,crv,810,1001,490,585,191,95,0.9551184,9,30,11,0.4973821989528796,
55,2,car,crv,807,1006,489,583,199,94,0.9514729,12,60,11,0.4723618090452261,
0,2,car,crv,667,820,483,575,153,92,0.8773953,12,30,11,-13591665.107594937,
1,2,car,crv,667,820,484,575,153,91,0.7467092,12,30,11,-16207419.275471698,
2,2,car,crv,667,820,484,575,153,91,0.8247261,12,30,11,-17043516.26190476,
3,2,car,crv,669,819,484,574,150,90,0.81360966,12,30,11,-18592927.83982684,
4,2,car,crv,667,820,483,576,153,93,0.73838603,12,30,11,-17248860.90763052,
5,2,car,crv,667,819,483,575,152,92,0.8015768,12,30,11,-13421769.275,
6,2,car,crv,667,820,484,574,153,90,0.68943864,12,30,11,0.5882352941176471,
7,2,car,crv,667,819,483,573,152,90,0.8037294,12,30,11,-13174742.81595092,
8,2,car,crv,663,809,486,569,146,83,0.7675451,12,30,11,-12897796.35135135,
9,2,car,crv,668,819,484,575,151,91,0.8577185,12,30,11,-12413197.066473989,
10,2,car,crv,669,820,484,574,151,90,0.7934381,12,30,11,0.5960264900662252,
11,2,car,crv,669,820,485,574,151,89,0.8260642,12,30,11,0.5894039735099338,
12,2,car,crv,668,819,484,573,151,89,0.8000626,12,30,11,0.5894039735099338,
13,2,car,crv,667,821,485,574,154,89,0.80527765,12,30,11,0.577922077922078,
14,2,car,crv,664,809,487,570,145,83,0.8104471,12,30,11,0.5724137931034483,
15,2,car,crv,662,810,486,569,148,83,0.8144621,12,30,11,0.5608108108108109,
16,2,car,crv,667,820,484,577,153,93,0.8308673,12,30,11,0.6078431372549019,
17,2,car,crv,667,820,483,575,153,92,0.84983456,12,30,11,0.6013071895424836,
18,2,car,crv,667,820,485,574,153,89,0.8510291,12,30,11,0.5816993464052288,
19,2,car,crv,662,810,486,570,148,84,0.7822179,12,30,11,0.5675675675675675,
20,2,car,crv,667,819,484,575,152,91,0.8101879,12,30,11,0.5986842105263158,
21,2,car,crv,664,809,487,570,145,83,0.77994776,12,30,11,0.5724137931034483,
22,2,car,crv,667,819,484,575,152,91,0.8454891,12,30,11,0.5986842105263158,
23,2,car,crv,667,819,483,575,152,92,0.8094451,12,30,11,1.5625,
24,2,car,crv,667,820,482,574,153,92,0.6722521,12,30,11,0.6013071895424836,
25,2,car,crv,667,819,484,574,152,90,0.8371277,12,30,11,0.5921052631578947,
26,2,car,crv,667,819,484,574,152,90,0.77298564,12,30,11,0.5921052631578947,
27,2,car,crv,667,817,484,574,150,90,0.66427475,12,30,11,0.6,
28,2,car,crv,667,819,483,574,152,91,0.79131705,12,30,11,0.5986842105263158,
29,2,car,crv,667,819,484,575,152,91,0.83604145,12,30,11,0.5986842105263158,
30,2,car,crv,668,819,484,574,151,90,0.7223766,12,30,11,0.5960264900662252,
31,2,car,crv,668,818,483,573,150,90,0.7379781,12,30,11,0.6,
32,2,car,crv,668,821,484,575,153,91,0.7870298,12,30,11,0.5947712418300654,
33,2,car,crv,667,820,484,575,153,91,0.8413766,12,30,11,0.5947712418300654,
34,2,car,crv,668,820,484,574,152,90,0.8056128,12,30,11,0.5921052631578947,
35,2,car,crv,667,820,483,575,153,92,0.66239387,12,30,11,0.6013071895424836,
36,2,car,crv,667,820,484,575,153,91,0.772995,12,30,11,0.5947712418300654,
37,2,car,crv,667,820,485,574,153,89,0.8488218,12,30,11,0.5816993464052288,
38,2,car,crv,667,820,484,575,153,91,0.78723717,12,30,11,0.5947712418300654,
39,2,car,crv,663,810,486,569,147,83,0.7781846,12,30,11,0.564625850340136,
40,2,car,crv,667,819,485,574,152,89,0.8128246,12,30,11,0.5855263157894737,
41,2,car,crv,666,820,482,577,154,95,0.80031437,9,0,11,0.6168831168831169,
42,2,car,crv,667,820,485,573,153,88,0.8438455,12,30,11,0.5751633986928104,
43,2,car,crv,667,819,484,575,152,91,0.9125865,12,30,11,0.5986842105263158,
44,2,car,crv,668,821,485,574,153,89,0.8785678,12,30,11,0.5816993464052288,
45,2,car,crv,667,819,485,574,152,89,0.71991515,12,30,11,0.5855263157894737,
46,2,car,crv,667,820,484,577,153,93,0.7404891,12,30,11,0.6078431372549019,
47,2,car,crv,667,819,484,575,152,91,0.7707914,12,30,11,0.5986842105263158,
48,2,car,crv,662,810,486,571,148,85,0.7150951,12,30,11,0.5743243243243243,
49,2,car,crv,669,820,485,574,151,89,0.83562523,12,30,11,0.5894039735099338,
50,2,car,crv,666,820,484,574,154,90,0.78819734,12,30,11,0.5844155844155844,
51,2,car,crv,667,819,483,575,152,92,0.8056975,12,30,11,0.6052631578947368,
52,2,car,crv,668,821,485,574,153,89,0.80433,12,30,11,0.5816993464052288,
53,2,car,crv,667,820,484,572,153,88,0.7759209,12,30,11,0.5751633986928104,
54,2,car,crv,667,819,484,572,152,88,0.7274725,12,30,11,0.5789473684210527,
55,2,car,crv,810,1001,490,585,191,95,0.9551184,9,30,11,0.4973821989528796,
56,2,car,crv,807,1006,489,583,199,94,0.9514729,12,60,11,0.4723618090452261,
0,2,car,crv,666,820,483,574,154,91,0.80471843,12,30,11,-13634813.587301588,
1,2,car,crv,667,820,483,575,153,92,0.8773953,12,30,11,-13591665.107594937,
2,2,car,crv,667,820,484,575,153,91,0.7467092,12,30,11,-16207419.275471698,
3,2,car,crv,667,820,484,575,153,91,0.8247261,12,30,11,-17043516.26190476,
4,2,car,crv,669,819,484,574,150,90,0.81360966,12,30,11,-18592927.83982684,
5,2,car,crv,667,820,483,576,153,93,0.73838603,12,30,11,-17248860.90763052,
6,2,car,crv,667,819,483,575,152,92,0.8015768,12,30,11,-13421769.275,
7,2,car,crv,667,820,484,574,153,90,0.68943864,12,30,11,0.5882352941176471,
8,2,car,crv,667,819,483,573,152,90,0.8037294,12,30,11,-13174742.81595092,
9,2,car,crv,663,809,486,569,146,83,0.7675451,12,30,11,-12897796.35135135,
10,2,car,crv,668,819,484,575,151,91,0.8577185,12,30,11,-12413197.066473989,
11,2,car,crv,669,820,484,574,151,90,0.7934381,12,30,11,0.5960264900662252,
12,2,car,crv,669,820,485,574,151,89,0.8260642,12,30,11,0.5894039735099338,
13,2,car,crv,668,819,484,573,151,89,0.8000626,12,30,11,0.5894039735099338,
14,2,car,crv,667,821,485,574,154,89,0.80527765,12,30,11,0.577922077922078,
15,2,car,crv,664,809,487,570,145,83,0.8104471,12,30,11,0.5724137931034483,
16,2,car,crv,662,810,486,569,148,83,0.8144621,12,30,11,0.5608108108108109,
17,2,car,crv,667,820,484,577,153,93,0.8308673,12,30,11,0.6078431372549019,
18,2,car,crv,667,820,483,575,153,92,0.84983456,12,30,11,0.6013071895424836,
19,2,car,crv,667,820,485,574,153,89,0.8510291,12,30,11,0.5816993464052288,
20,2,car,crv,662,810,486,570,148,84,0.7822179,12,30,11,0.5675675675675675,
21,2,car,crv,667,819,484,575,152,91,0.8101879,12,30,11,0.5986842105263158,
22,2,car,crv,664,809,487,570,145,83,0.77994776,12,30,11,0.5724137931034483,
23,2,car,crv,667,819,484,575,152,91,0.8454891,12,30,11,0.5986842105263158,
24,2,car,crv,667,819,483,575,152,92,0.8094451,12,30,11,1.5625,
25,2,car,crv,667,820,482,574,153,92,0.6722521,12,30,11,0.6013071895424836,
26,2,car,crv,667,819,484,574,152,90,0.8371277,12,30,11,0.5921052631578947,
27,2,car,crv,667,819,484,574,152,90,0.77298564,12,30,11,0.5921052631578947,
28,2,car,crv,667,817,484,574,150,90,0.66427475,12,30,11,0.6,
29,2,car,crv,667,819,483,574,152,91,0.79131705,12,30,11,0.5986842105263158,
30,2,car,crv,667,819,484,575,152,91,0.83604145,12,30,11,0.5986842105263158,
31,2,car,crv,668,819,484,574,151,90,0.7223766,12,30,11,0.5960264900662252,
32,2,car,crv,668,818,483,573,150,90,0.7379781,12,30,11,0.6,
33,2,car,crv,668,821,484,575,153,91,0.7870298,12,30,11,0.5947712418300654,
34,2,car,crv,667,820,484,575,153,91,0.8413766,12,30,11,0.5947712418300654,
35,2,car,crv,668,820,484,574,152,90,0.8056128,12,30,11,0.5921052631578947,
36,2,car,crv,667,820,483,575,153,92,0.66239387,12,30,11,0.6013071895424836,
37,2,car,crv,667,820,484,575,153,91,0.772995,12,30,11,0.5947712418300654,
38,2,car,crv,667,820,485,574,153,89,0.8488218,12,30,11,0.5816993464052288,
39,2,car,crv,667,820,484,575,153,91,0.78723717,12,30,11,0.5947712418300654,
40,2,car,crv,663,810,486,569,147,83,0.7781846,12,30,11,0.564625850340136,
41,2,car,crv,667,819,485,574,152,89,0.8128246,12,30,11,0.5855263157894737,
42,2,car,crv,666,820,482,577,154,95,0.80031437,9,0,11,0.6168831168831169,
43,2,car,crv,667,820,485,573,153,88,0.8438455,12,30,11,0.5751633986928104,
44,2,car,crv,667,819,484,575,152,91,0.9125865,12,30,11,0.5986842105263158,
45,2,car,crv,668,821,485,574,153,89,0.8785678,12,30,11,0.5816993464052288,
46,2,car,crv,667,819,485,574,152,89,0.71991515,12,30,11,0.5855263157894737,
47,2,car,crv,667,820,484,577,153,93,0.7404891,12,30,11,0.6078431372549019,
48,2,car,crv,667,819,484,575,152,91,0.7707914,12,30,11,0.5986842105263158,
49,2,car,crv,662,810,486,571,148,85,0.7150951,12,30,11,0.5743243243243243,
50,2,car,crv,669,820,485,574,151,89,0.83562523,12,30,11,0.5894039735099338,
51,2,car,crv,666,820,484,574,154,90,0.78819734,12,30,11,0.5844155844155844,
52,2,car,crv,667,819,483,575,152,92,0.8056975,12,30,11,0.6052631578947368,
53,2,car,crv,668,821,485,574,153,89,0.80433,12,30,11,0.5816993464052288,
54,2,car,crv,667,820,484,572,153,88,0.7759209,12,30,11,0.5751633986928104,
55,2,car,crv,667,819,484,572,152,88,0.7274725,12,30,11,0.5789473684210527,
56,2,car,crv,810,1001,490,585,191,95,0.9551184,9,30,11,0.4973821989528796,
57,2,car,crv,807,1006,489,583,199,94,0.9514729,12,60,11,0.4723618090452261,
0,2,car,crv,668,819,483,574,151,91,0.8174212,12,30,11,-13765918.567307692,
1,2,car,crv,666,820,483,574,154,91,0.80471843,12,30,11,-13634813.587301588,
2,2,car,crv,667,820,483,575,153,92,0.8773953,12,30,11,-13591665.107594937,
3,2,car,crv,667,820,484,575,153,91,0.7467092,12,30,11,-16207419.275471698,
4,2,car,crv,667,820,484,575,153,91,0.8247261,12,30,11,-17043516.26190476,
5,2,car,crv,669,819,484,574,150,90,0.81360966,12,30,11,-18592927.83982684,
6,2,car,crv,667,820,483,576,153,93,0.73838603,12,30,11,-17248860.90763052,
7,2,car,crv,667,819,483,575,152,92,0.8015768,12,30,11,-13421769.275,
8,2,car,crv,667,820,484,574,153,90,0.68943864,12,30,11,0.5882352941176471,
9,2,car,crv,667,819,483,573,152,90,0.8037294,12,30,11,-13174742.81595092,
10,2,car,crv,663,809,486,569,146,83,0.7675451,12,30,11,-12897796.35135135,
11,2,car,crv,668,819,484,575,151,91,0.8577185,12,30,11,-12413197.066473989,
12,2,car,crv,669,820,484,574,151,90,0.7934381,12,30,11,0.5960264900662252,
13,2,car,crv,669,820,485,574,151,89,0.8260642,12,30,11,0.5894039735099338,
14,2,car,crv,668,819,484,573,151,89,0.8000626,12,30,11,0.5894039735099338,
15,2,car,crv,667,821,485,574,154,89,0.80527765,12,30,11,0.577922077922078,
16,2,car,crv,664,809,487,570,145,83,0.8104471,12,30,11,0.5724137931034483,
17,2,car,crv,662,810,486,569,148,83,0.8144621,12,30,11,0.5608108108108109,
18,2,car,crv,667,820,484,577,153,93,0.8308673,12,30,11,0.6078431372549019,
19,2,car,crv,667,820,483,575,153,92,0.84983456,12,30,11,0.6013071895424836,
20,2,car,crv,667,820,485,574,153,89,0.8510291,12,30,11,0.5816993464052288,
21,2,car,crv,662,810,486,570,148,84,0.7822179,12,30,11,0.5675675675675675,
22,2,car,crv,667,819,484,575,152,91,0.8101879,12,30,11,0.5986842105263158,
23,2,car,crv,664,809,487,570,145,83,0.77994776,12,30,11,0.5724137931034483,
24,2,car,crv,667,819,484,575,152,91,0.8454891,12,30,11,0.5986842105263158,
25,2,car,crv,667,819,483,575,152,92,0.8094451,12,30,11,1.5625,
26,2,car,crv,667,820,482,574,153,92,0.6722521,12,30,11,0.6013071895424836,
27,2,car,crv,667,819,484,574,152,90,0.8371277,12,30,11,0.5921052631578947,
28,2,car,crv,667,819,484,574,152,90,0.77298564,12,30,11,0.5921052631578947,
29,2,car,crv,667,817,484,574,150,90,0.66427475,12,30,11,0.6,
30,2,car,crv,667,819,483,574,152,91,0.79131705,12,30,11,0.5986842105263158,
31,2,car,crv,667,819,484,575,152,91,0.83604145,12,30,11,0.5986842105263158,
32,2,car,crv,668,819,484,574,151,90,0.7223766,12,30,11,0.5960264900662252,
33,2,car,crv,668,818,483,573,150,90,0.7379781,12,30,11,0.6,
34,2,car,crv,668,821,484,575,153,91,0.7870298,12,30,11,0.5947712418300654,
35,2,car,crv,667,820,484,575,153,91,0.8413766,12,30,11,0.5947712418300654,
36,2,car,crv,668,820,484,574,152,90,0.8056128,12,30,11,0.5921052631578947,
37,2,car,crv,667,820,483,575,153,92,0.66239387,12,30,11,0.6013071895424836,
38,2,car,crv,667,820,484,575,153,91,0.772995,12,30,11,0.5947712418300654,
39,2,car,crv,667,820,485,574,153,89,0.8488218,12,30,11,0.5816993464052288,
40,2,car,crv,667,820,484,575,153,91,0.78723717,12,30,11,0.5947712418300654,
41,2,car,crv,663,810,486,569,147,83,0.7781846,12,30,11,0.564625850340136,
42,2,car,crv,667,819,485,574,152,89,0.8128246,12,30,11,0.5855263157894737,
43,2,car,crv,666,820,482,577,154,95,0.80031437,9,0,11,0.6168831168831169,
44,2,car,crv,667,820,485,573,153,88,0.8438455,12,30,11,0.5751633986928104,
45,2,car,crv,667,819,484,575,152,91,0.9125865,12,30,11,0.5986842105263158,
46,2,car,crv,668,821,485,574,153,89,0.8785678,12,30,11,0.5816993464052288,
47,2,car,crv,667,819,485,574,152,89,0.71991515,12,30,11,0.5855263157894737,
48,2,car,crv,667,820,484,577,153,93,0.7404891,12,30,11,0.6078431372549019,
49,2,car,crv,667,819,484,575,152,91,0.7707914,12,30,11,0.5986842105263158,
50,2,car,crv,662,810,486,571,148,85,0.7150951,12,30,11,0.5743243243243243,
51,2,car,crv,669,820,485,574,151,89,0.83562523,12,30,11,0.5894039735099338,
52,2,car,crv,666,820,484,574,154,90,0.78819734,12,30,11,0.5844155844155844,
53,2,car,crv,667,819,483,575,152,92,0.8056975,12,30,11,0.6052631578947368,
54,2,car,crv,668,821,485,574,153,89,0.80433,12,30,11,0.5816993464052288,
55,2,car,crv,667,820,484,572,153,88,0.7759209,12,30,11,0.5751633986928104,
56,2,car,crv,667,819,484,572,152,88,0.7274725,12,30,11,0.5789473684210527,
57,2,car,crv,810,1001,490,585,191,95,0.9551184,9,30,11,0.4973821989528796,
58,2,car,crv,807,1006,489,583,199,94,0.9514729,12,60,11,0.4723618090452261,
0,2,car,crv,667,820,484,575,153,91,0.8218401,12,30,11,-13134453.40061162,
1,2,car,crv,668,819,483,574,151,91,0.8174212,12,30,11,-13765918.567307692,
2,2,car,crv,666,820,483,574,154,91,0.80471843,12,30,11,-13634813.587301588,
3,2,car,crv,667,820,483,575,153,92,0.8773953,12,30,11,-13591665.107594937,
4,2,car,crv,667,820,484,575,153,91,0.7467092,12,30,11,-16207419.275471698,
5,2,car,crv,667,820,484,575,153,91,0.8247261,12,30,11,-17043516.26190476,
6,2,car,crv,669,819,484,574,150,90,0.81360966,12,30,11,-18592927.83982684,
7,2,car,crv,667,820,483,576,153,93,0.73838603,12,30,11,-17248860.90763052,
8,2,car,crv,667,819,483,575,152,92,0.8015768,12,30,11,-13421769.275,
9,2,car,crv,667,820,484,574,153,90,0.68943864,12,30,11,0.5882352941176471,
10,2,car,crv,667,819,483,573,152,90,0.8037294,12,30,11,-13174742.81595092,
11,2,car,crv,663,809,486,569,146,83,0.7675451,12,30,11,-12897796.35135135,
12,2,car,crv,668,819,484,575,151,91,0.8577185,12,30,11,-12413197.066473989,
13,2,car,crv,669,820,484,574,151,90,0.7934381,12,30,11,0.5960264900662252,
14,2,car,crv,669,820,485,574,151,89,0.8260642,12,30,11,0.5894039735099338,
15,2,car,crv,668,819,484,573,151,89,0.8000626,12,30,11,0.5894039735099338,
16,2,car,crv,667,821,485,574,154,89,0.80527765,12,30,11,0.577922077922078,
17,2,car,crv,664,809,487,570,145,83,0.8104471,12,30,11,0.5724137931034483,
18,2,car,crv,662,810,486,569,148,83,0.8144621,12,30,11,0.5608108108108109,
19,2,car,crv,667,820,484,577,153,93,0.8308673,12,30,11,0.6078431372549019,
20,2,car,crv,667,820,483,575,153,92,0.84983456,12,30,11,0.6013071895424836,
21,2,car,crv,667,820,485,574,153,89,0.8510291,12,30,11,0.5816993464052288,
22,2,car,crv,662,810,486,570,148,84,0.7822179,12,30,11,0.5675675675675675,
23,2,car,crv,667,819,484,575,152,91,0.8101879,12,30,11,0.5986842105263158,
24,2,car,crv,664,809,487,570,145,83,0.77994776,12,30,11,0.5724137931034483,
25,2,car,crv,667,819,484,575,152,91,0.8454891,12,30,11,0.5986842105263158,
26,2,car,crv,667,819,483,575,152,92,0.8094451,12,30,11,1.5625,
27,2,car,crv,667,820,482,574,153,92,0.6722521,12,30,11,0.6013071895424836,
28,2,car,crv,667,819,484,574,152,90,0.8371277,12,30,11,0.5921052631578947,
29,2,car,crv,667,819,484,574,152,90,0.77298564,12,30,11,0.5921052631578947,
30,2,car,crv,667,817,484,574,150,90,0.66427475,12,30,11,0.6,
31,2,car,crv,667,819,483,574,152,91,0.79131705,12,30,11,0.5986842105263158,
32,2,car,crv,667,819,484,575,152,91,0.83604145,12,30,11,0.5986842105263158,
33,2,car,crv,668,819,484,574,151,90,0.7223766,12,30,11,0.5960264900662252,
34,2,car,crv,668,818,483,573,150,90,0.7379781,12,30,11,0.6,
35,2,car,crv,668,821,484,575,153,91,0.7870298,12,30,11,0.5947712418300654,
36,2,car,crv,667,820,484,575,153,91,0.8413766,12,30,11,0.5947712418300654,
37,2,car,crv,668,820,484,574,152,90,0.8056128,12,30,11,0.5921052631578947,
38,2,car,crv,667,820,483,575,153,92,0.66239387,12,30,11,0.6013071895424836,
39,2,car,crv,667,820,484,575,153,91,0.772995,12,30,11,0.5947712418300654,
40,2,car,crv,667,820,485,574,153,89,0.8488218,12,30,11,0.5816993464052288,
41,2,car,crv,667,820,484,575,153,91,0.78723717,12,30,11,0.5947712418300654,
42,2,car,crv,663,810,486,569,147,83,0.7781846,12,30,11,0.564625850340136,
43,2,car,crv,667,819,485,574,152,89,0.8128246,12,30,11,0.5855263157894737,
44,2,car,crv,666,820,482,577,154,95,0.80031437,9,0,11,0.6168831168831169,
45,2,car,crv,667,820,485,573,153,88,0.8438455,12,30,11,0.5751633986928104,
46,2,car,crv,667,819,484,575,152,91,0.9125865,12,30,11,0.5986842105263158,
47,2,car,crv,668,821,485,574,153,89,0.8785678,12,30,11,0.5816993464052288,
48,2,car,crv,667,819,485,574,152,89,0.71991515,12,30,11,0.5855263157894737,
49,2,car,crv,667,820,484,577,153,93,0.7404891,12,30,11,0.6078431372549019,
50,2,car,crv,667,819,484,575,152,91,0.7707914,12,30,11,0.5986842105263158,
51,2,car,crv,662,810,486,571,148,85,0.7150951,12,30,11,0.5743243243243243,
52,2,car,crv,669,820,485,574,151,89,0.83562523,12,30,11,0.5894039735099338,
53,2,car,crv,666,820,484,574,154,90,0.78819734,12,30,11,0.5844155844155844,
54,2,car,crv,667,819,483,575,152,92,0.8056975,12,30,11,0.6052631578947368,
55,2,car,crv,668,821,485,574,153,89,0.80433,12,30,11,0.5816993464052288,
56,2,car,crv,667,820,484,572,153,88,0.7759209,12,30,11,0.5751633986928104,
57,2,car,crv,667,819,484,572,152,88,0.7274725,12,30,11,0.5789473684210527,
58,2,car,crv,810,1001,490,585,191,95,0.9551184,9,30,11,0.4973821989528796,
59,2,car,crv,807,1006,489,583,199,94,0.9514729,12,60,11,0.4723618090452261,
0,2,car,crv,663,810,485,569,147,84,0.7043501,12,30,11,-12744706.9347181,
1,2,car,crv,667,820,484,575,153,91,0.8218401,12,30,11,-13134453.40061162,
2,2,car,crv,668,819,483,574,151,91,0.8174212,12,30,11,-13765918.567307692,
3,2,car,crv,666,820,483,574,154,91,0.80471843,12,30,11,-13634813.587301588,
4,2,car,crv,667,820,483,575,153,92,0.8773953,12,30,11,-13591665.107594937,
5,2,car,crv,667,820,484,575,153,91,0.7467092,12,30,11,-16207419.275471698,
6,2,car,crv,667,820,484,575,153,91,0.8247261,12,30,11,-17043516.26190476,
7,2,car,crv,669,819,484,574,150,90,0.81360966,12,30,11,-18592927.83982684,
8,2,car,crv,667,820,483,576,153,93,0.73838603,12,30,11,-17248860.90763052,
9,2,car,crv,667,819,483,575,152,92,0.8015768,12,30,11,-13421769.275,
10,2,car,crv,667,820,484,574,153,90,0.68943864,12,30,11,0.5882352941176471,
11,2,car,crv,667,819,483,573,152,90,0.8037294,12,30,11,-13174742.81595092,
12,2,car,crv,663,809,486,569,146,83,0.7675451,12,30,11,-12897796.35135135,
13,2,car,crv,668,819,484,575,151,91,0.8577185,12,30,11,-12413197.066473989,
14,2,car,crv,669,820,484,574,151,90,0.7934381,12,30,11,0.5960264900662252,
15,2,car,crv,669,820,485,574,151,89,0.8260642,12,30,11,0.5894039735099338,
16,2,car,crv,668,819,484,573,151,89,0.8000626,12,30,11,0.5894039735099338,
17,2,car,crv,667,821,485,574,154,89,0.80527765,12,30,11,0.577922077922078,
18,2,car,crv,664,809,487,570,145,83,0.8104471,12,30,11,0.5724137931034483,
19,2,car,crv,662,810,486,569,148,83,0.8144621,12,30,11,0.5608108108108109,
20,2,car,crv,667,820,484,577,153,93,0.8308673,12,30,11,0.6078431372549019,
21,2,car,crv,667,820,483,575,153,92,0.84983456,12,30,11,0.6013071895424836,
22,2,car,crv,667,820,485,574,153,89,0.8510291,12,30,11,0.5816993464052288,
23,2,car,crv,662,810,486,570,148,84,0.7822179,12,30,11,0.5675675675675675,
24,2,car,crv,667,819,484,575,152,91,0.8101879,12,30,11,0.5986842105263158,
25,2,car,crv,664,809,487,570,145,83,0.77994776,12,30,11,0.5724137931034483,
26,2,car,crv,667,819,484,575,152,91,0.8454891,12,30,11,0.5986842105263158,
27,2,car,crv,667,819,483,575,152,92,0.8094451,12,30,11,1.5625,
28,2,car,crv,667,820,482,574,153,92,0.6722521,12,30,11,0.6013071895424836,
29,2,car,crv,667,819,484,574,152,90,0.8371277,12,30,11,0.5921052631578947,
30,2,car,crv,667,819,484,574,152,90,0.77298564,12,30,11,0.5921052631578947,
31,2,car,crv,667,817,484,574,150,90,0.66427475,12,30,11,0.6,
32,2,car,crv,667,819,483,574,152,91,0.79131705,12,30,11,0.5986842105263158,
33,2,car,crv,667,819,484,575,152,91,0.83604145,12,30,11,0.5986842105263158,
34,2,car,crv,668,819,484,574,151,90,0.7223766,12,30,11,0.5960264900662252,
35,2,car,crv,668,818,483,573,150,90,0.7379781,12,30,11,0.6,
36,2,car,crv,668,821,484,575,153,91,0.7870298,12,30,11,0.5947712418300654,
37,2,car,crv,667,820,484,575,153,91,0.8413766,12,30,11,0.5947712418300654,
38,2,car,crv,668,820,484,574,152,90,0.8056128,12,30,11,0.5921052631578947,
39,2,car,crv,667,820,483,575,153,92,0.66239387,12,30,11,0.6013071895424836,
40,2,car,crv,667,820,484,575,153,91,0.772995,12,30,11,0.5947712418300654,
41,2,car,crv,667,820,485,574,153,89,0.8488218,12,30,11,0.5816993464052288,
42,2,car,crv,667,820,484,575,153,91,0.78723717,12,30,11,0.5947712418300654,
43,2,car,crv,663,810,486,569,147,83,0.7781846,12,30,11,0.564625850340136,
44,2,car,crv,667,819,485,574,152,89,0.8128246,12,30,11,0.5855263157894737,
45,2,car,crv,666,820,482,577,154,95,0.80031437,9,0,11,0.6168831168831169,
46,2,car,crv,667,820,485,573,153,88,0.8438455,12,30,11,0.5751633986928104,
47,2,car,crv,667,819,484,575,152,91,0.9125865,12,30,11,0.5986842105263158,
48,2,car,crv,668,821,485,574,153,89,0.8785678,12,30,11,0.5816993464052288,
49,2,car,crv,667,819,485,574,152,89,0.71991515,12,30,11,0.5855263157894737,
50,2,car,crv,667,820,484,577,153,93,0.7404891,12,30,11,0.6078431372549019,
51,2,car,crv,667,819,484,575,152,91,0.7707914,12,30,11,0.5986842105263158,
52,2,car,crv,662,810,486,571,148,85,0.7150951,12,30,11,0.5743243243243243,
53,2,car,crv,669,820,485,574,151,89,0.83562523,12,30,11,0.5894039735099338,
54,2,car,crv,666,820,484,574,154,90,0.78819734,12,30,11,0.5844155844155844,
55,2,car,crv,667,819,483,575,152,92,0.8056975,12,30,11,0.6052631578947368,
56,2,car,crv,668,821,485,574,153,89,0.80433,12,30,11,0.5816993464052288,
57,2,car,crv,667,820,484,572,153,88,0.7759209,12,30,11,0.5751633986928104,
58,2,car,crv,667,819,484,572,152,88,0.7274725,12,30,11,0.5789473684210527,
59,2,car,crv,810,1001,490,585,191,95,0.9551184,9,30,11,0.4973821989528796,
60,2,car,crv,807,1006,489,583,199,94,0.9514729,12,60,11,0.4723618090452261,
0,2,car,crv,667,819,484,575,152,91,0.7623789,12,30,11,-12669516.867256638,
1,2,car,crv,663,810,485,569,147,84,0.7043501,12,30,11,-12744706.9347181,
2,2,car,crv,667,820,484,575,153,91,0.8218401,12,30,11,-13134453.40061162,
3,2,car,crv,668,819,483,574,151,91,0.8174212,12,30,11,-13765918.567307692,
4,2,car,crv,666,820,483,574,154,91,0.80471843,12,30,11,-13634813.587301588,
5,2,car,crv,667,820,483,575,153,92,0.8773953,12,30,11,-13591665.107594937,
6,2,car,crv,667,820,484,575,153,91,0.7467092,12,30,11,-16207419.275471698,
7,2,car,crv,667,820,484,575,153,91,0.8247261,12,30,11,-17043516.26190476,
8,2,car,crv,669,819,484,574,150,90,0.81360966,12,30,11,-18592927.83982684,
9,2,car,crv,667,820,483,576,153,93,0.73838603,12,30,11,-17248860.90763052,
10,2,car,crv,667,819,483,575,152,92,0.8015768,12,30,11,-13421769.275,
11,2,car,crv,667,820,484,574,153,90,0.68943864,12,30,11,0.5882352941176471,
12,2,car,crv,667,819,483,573,152,90,0.8037294,12,30,11,-13174742.81595092,
13,2,car,crv,663,809,486,569,146,83,0.7675451,12,30,11,-12897796.35135135,
14,2,car,crv,668,819,484,575,151,91,0.8577185,12,30,11,-12413197.066473989,
15,2,car,crv,669,820,484,574,151,90,0.7934381,12,30,11,0.5960264900662252,
16,2,car,crv,669,820,485,574,151,89,0.8260642,12,30,11,0.5894039735099338,
17,2,car,crv,668,819,484,573,151,89,0.8000626,12,30,11,0.5894039735099338,
18,2,car,crv,667,821,485,574,154,89,0.80527765,12,30,11,0.577922077922078,
19,2,car,crv,664,809,487,570,145,83,0.8104471,12,30,11,0.5724137931034483,
20,2,car,crv,662,810,486,569,148,83,0.8144621,12,30,11,0.5608108108108109,
21,2,car,crv,667,820,484,577,153,93,0.8308673,12,30,11,0.6078431372549019,
22,2,car,crv,667,820,483,575,153,92,0.84983456,12,30,11,0.6013071895424836,
23,2,car,crv,667,820,485,574,153,89,0.8510291,12,30,11,0.5816993464052288,
24,2,car,crv,662,810,486,570,148,84,0.7822179,12,30,11,0.5675675675675675,
25,2,car,crv,667,819,484,575,152,91,0.8101879,12,30,11,0.5986842105263158,
26,2,car,crv,664,809,487,570,145,83,0.77994776,12,30,11,0.5724137931034483,
27,2,car,crv,667,819,484,575,152,91,0.8454891,12,30,11,0.5986842105263158,
28,2,car,crv,667,819,483,575,152,92,0.8094451,12,30,11,1.5625,
29,2,car,crv,667,820,482,574,153,92,0.6722521,12,30,11,0.6013071895424836,
30,2,car,crv,667,819,484,574,152,90,0.8371277,12,30,11,0.5921052631578947,
31,2,car,crv,667,819,484,574,152,90,0.77298564,12,30,11,0.5921052631578947,
32,2,car,crv,667,817,484,574,150,90,0.66427475,12,30,11,0.6,
33,2,car,crv,667,819,483,574,152,91,0.79131705,12,30,11,0.5986842105263158,
34,2,car,crv,667,819,484,575,152,91,0.83604145,12,30,11,0.5986842105263158,
35,2,car,crv,668,819,484,574,151,90,0.7223766,12,30,11,0.5960264900662252,
36,2,car,crv,668,818,483,573,150,90,0.7379781,12,30,11,0.6,
37,2,car,crv,668,821,484,575,153,91,0.7870298,12,30,11,0.5947712418300654,
38,2,car,crv,667,820,484,575,153,91,0.8413766,12,30,11,0.5947712418300654,
39,2,car,crv,668,820,484,574,152,90,0.8056128,12,30,11,0.5921052631578947,
40,2,car,crv,667,820,483,575,153,92,0.66239387,12,30,11,0.6013071895424836,
41,2,car,crv,667,820,484,575,153,91,0.772995,12,30,11,0.5947712418300654,
42,2,car,crv,667,820,485,574,153,89,0.8488218,12,30,11,0.5816993464052288,
43,2,car,crv,667,820,484,575,153,91,0.78723717,12,30,11,0.5947712418300654,
44,2,car,crv,663,810,486,569,147,83,0.7781846,12,30,11,0.564625850340136,
45,2,car,crv,667,819,485,574,152,89,0.8128246,12,30,11,0.5855263157894737,
46,2,car,crv,666,820,482,577,154,95,0.80031437,9,0,11,0.6168831168831169,
47,2,car,crv,667,820,485,573,153,88,0.8438455,12,30,11,0.5751633986928104,
48,2,car,crv,667,819,484,575,152,91,0.9125865,12,30,11,0.5986842105263158,
49,2,car,crv,668,821,485,574,153,89,0.8785678,12,30,11,0.5816993464052288,
50,2,car,crv,667,819,485,574,152,89,0.71991515,12,30,11,0.5855263157894737,
51,2,car,crv,667,820,484,577,153,93,0.7404891,12,30,11,0.6078431372549019,
52,2,car,crv,667,819,484,575,152,91,0.7707914,12,30,11,0.5986842105263158,
53,2,car,crv,662,810,486,571,148,85,0.7150951,12,30,11,0.5743243243243243,
54,2,car,crv,669,820,485,574,151,89,0.83562523,12,30,11,0.5894039735099338,
55,2,car,crv,666,820,484,574,154,90,0.78819734,12,30,11,0.5844155844155844,
56,2,car,crv,667,819,483,575,152,92,0.8056975,12,30,11,0.6052631578947368,
57,2,car,crv,668,821,485,574,153,89,0.80433,12,30,11,0.5816993464052288,
58,2,car,crv,667,820,484,572,153,88,0.7759209,12,30,11,0.5751633986928104,
59,2,car,crv,667,819,484,572,152,88,0.7274725,12,30,11,0.5789473684210527,
60,2,car,crv,810,1001,490,585,191,95,0.9551184,9,30,11,0.4973821989528796,
61,2,car,crv,807,1006,489,583,199,94,0.9514729,12,60,11,0.4723618090452261,
0,2,car,crv,666,819,483,575,153,92,0.87749106,12,30,11,-12236371.056980057,
1,2,car,crv,667,819,484,575,152,91,0.7623789,12,30,11,-12669516.867256638,
2,2,car,crv,663,810,485,569,147,84,0.7043501,12,30,11,-12744706.9347181,
3,2,car,crv,667,820,484,575,153,91,0.8218401,12,30,11,-13134453.40061162,
4,2,car,crv,668,819,483,574,151,91,0.8174212,12,30,11,-13765918.567307692,
5,2,car,crv,666,820,483,574,154,91,0.80471843,12,30,11,-13634813.587301588,
6,2,car,crv,667,820,483,575,153,92,0.8773953,12,30,11,-13591665.107594937,
7,2,car,crv,667,820,484,575,153,91,0.7467092,12,30,11,-16207419.275471698,
8,2,car,crv,667,820,484,575,153,91,0.8247261,12,30,11,-17043516.26190476,
9,2,car,crv,669,819,484,574,150,90,0.81360966,12,30,11,-18592927.83982684,
10,2,car,crv,667,820,483,576,153,93,0.73838603,12,30,11,-17248860.90763052,
11,2,car,crv,667,819,483,575,152,92,0.8015768,12,30,11,-13421769.275,
12,2,car,crv,667,820,484,574,153,90,0.68943864,12,30,11,0.5882352941176471,
13,2,car,crv,667,819,483,573,152,90,0.8037294,12,30,11,-13174742.81595092,
14,2,car,crv,663,809,486,569,146,83,0.7675451,12,30,11,-12897796.35135135,
15,2,car,crv,668,819,484,575,151,91,0.8577185,12,30,11,-12413197.066473989,
16,2,car,crv,669,820,484,574,151,90,0.7934381,12,30,11,0.5960264900662252,
17,2,car,crv,669,820,485,574,151,89,0.8260642,12,30,11,0.5894039735099338,
18,2,car,crv,668,819,484,573,151,89,0.8000626,12,30,11,0.5894039735099338,
19,2,car,crv,667,821,485,574,154,89,0.80527765,12,30,11,0.577922077922078,
20,2,car,crv,664,809,487,570,145,83,0.8104471,12,30,11,0.5724137931034483,
21,2,car,crv,662,810,486,569,148,83,0.8144621,12,30,11,0.5608108108108109,
22,2,car,crv,667,820,484,577,153,93,0.8308673,12,30,11,0.6078431372549019,
23,2,car,crv,667,820,483,575,153,92,0.84983456,12,30,11,0.6013071895424836,
24,2,car,crv,667,820,485,574,153,89,0.8510291,12,30,11,0.5816993464052288,
25,2,car,crv,662,810,486,570,148,84,0.7822179,12,30,11,0.5675675675675675,
26,2,car,crv,667,819,484,575,152,91,0.8101879,12,30,11,0.5986842105263158,
27,2,car,crv,664,809,487,570,145,83,0.77994776,12,30,11,0.5724137931034483,
28,2,car,crv,667,819,484,575,152,91,0.8454891,12,30,11,0.5986842105263158,
29,2,car,crv,667,819,483,575,152,92,0.8094451,12,30,11,1.5625,
30,2,car,crv,667,820,482,574,153,92,0.6722521,12,30,11,0.6013071895424836,
31,2,car,crv,667,819,484,574,152,90,0.8371277,12,30,11,0.5921052631578947,
32,2,car,crv,667,819,484,574,152,90,0.77298564,12,30,11,0.5921052631578947,
33,2,car,crv,667,817,484,574,150,90,0.66427475,12,30,11,0.6,
34,2,car,crv,667,819,483,574,152,91,0.79131705,12,30,11,0.5986842105263158,
35,2,car,crv,667,819,484,575,152,91,0.83604145,12,30,11,0.5986842105263158,
36,2,car,crv,668,819,484,574,151,90,0.7223766,12,30,11,0.5960264900662252,
37,2,car,crv,668,818,483,573,150,90,0.7379781,12,30,11,0.6,
38,2,car,crv,668,821,484,575,153,91,0.7870298,12,30,11,0.5947712418300654,
39,2,car,crv,667,820,484,575,153,91,0.8413766,12,30,11,0.5947712418300654,
40,2,car,crv,668,820,484,574,152,90,0.8056128,12,30,11,0.5921052631578947,
41,2,car,crv,667,820,483,575,153,92,0.66239387,12,30,11,0.6013071895424836,
42,2,car,crv,667,820,484,575,153,91,0.772995,12,30,11,0.5947712418300654,
43,2,car,crv,667,820,485,574,153,89,0.8488218,12,30,11,0.5816993464052288,
44,2,car,crv,667,820,484,575,153,91,0.78723717,12,30,11,0.5947712418300654,
45,2,car,crv,663,810,486,569,147,83,0.7781846,12,30,11,0.564625850340136,
46,2,car,crv,667,819,485,574,152,89,0.8128246,12,30,11,0.5855263157894737,
47,2,car,crv,666,820,482,577,154,95,0.80031437,9,0,11,0.6168831168831169,
48,2,car,crv,667,820,485,573,153,88,0.8438455,12,30,11,0.5751633986928104,
49,2,car,crv,667,819,484,575,152,91,0.9125865,12,30,11,0.5986842105263158,
50,2,car,crv,668,821,485,574,153,89,0.8785678,12,30,11,0.5816993464052288,
51,2,car,crv,667,819,485,574,152,89,0.71991515,12,30,11,0.5855263157894737,
52,2,car,crv,667,820,484,577,153,93,0.7404891,12,30,11,0.6078431372549019,
53,2,car,crv,667,819,484,575,152,91,0.7707914,12,30,11,0.5986842105263158,
54,2,car,crv,662,810,486,571,148,85,0.7150951,12,30,11,0.5743243243243243,
55,2,car,crv,669,820,485,574,151,89,0.83562523,12,30,11,0.5894039735099338,
56,2,car,crv,666,820,484,574,154,90,0.78819734,12,30,11,0.5844155844155844,
57,2,car,crv,667,819,483,575,152,92,0.8056975,12,30,11,0.6052631578947368,
58,2,car,crv,668,821,485,574,153,89,0.80433,12,30,11,0.5816993464052288,
59,2,car,crv,667,820,484,572,153,88,0.7759209,12,30,11,0.5751633986928104,
60,2,car,crv,667,819,484,572,152,88,0.7274725,12,30,11,0.5789473684210527,
61,2,car,crv,810,1001,490,585,191,95,0.9551184,9,30,11,0.4973821989528796,
62,2,car,crv,807,1006,489,583,199,94,0.9514729,12,60,11,0.4723618090452261,
0,2,car,crv,667,820,484,575,153,91,0.91537607,12,30,11,0.5947712418300654,
1,2,car,crv,666,819,483,575,153,92,0.87749106,12,30,11,-12236371.056980057,
2,2,car,crv,667,819,484,575,152,91,0.7623789,12,30,11,-12669516.867256638,
3,2,car,crv,663,810,485,569,147,84,0.7043501,12,30,11,-12744706.9347181,
4,2,car,crv,667,820,484,575,153,91,0.8218401,12,30,11,-13134453.40061162,
5,2,car,crv,668,819,483,574,151,91,0.8174212,12,30,11,-13765918.567307692,
6,2,car,crv,666,820,483,574,154,91,0.80471843,12,30,11,-13634813.587301588,
7,2,car,crv,667,820,483,575,153,92,0.8773953,12,30,11,-13591665.107594937,
8,2,car,crv,667,820,484,575,153,91,0.7467092,12,30,11,-16207419.275471698,
9,2,car,crv,667,820,484,575,153,91,0.8247261,12,30,11,-17043516.26190476,
10,2,car,crv,669,819,484,574,150,90,0.81360966,12,30,11,-18592927.83982684,
11,2,car,crv,667,820,483,576,153,93,0.73838603,12,30,11,-17248860.90763052,
12,2,car,crv,667,819,483,575,152,92,0.8015768,12,30,11,-13421769.275,
13,2,car,crv,667,820,484,574,153,90,0.68943864,12,30,11,0.5882352941176471,
14,2,car,crv,667,819,483,573,152,90,0.8037294,12,30,11,-13174742.81595092,
15,2,car,crv,663,809,486,569,146,83,0.7675451,12,30,11,-12897796.35135135,
16,2,car,crv,668,819,484,575,151,91,0.8577185,12,30,11,-12413197.066473989,
17,2,car,crv,669,820,484,574,151,90,0.7934381,12,30,11,0.5960264900662252,
18,2,car,crv,669,820,485,574,151,89,0.8260642,12,30,11,0.5894039735099338,
19,2,car,crv,668,819,484,573,151,89,0.8000626,12,30,11,0.5894039735099338,
20,2,car,crv,667,821,485,574,154,89,0.80527765,12,30,11,0.577922077922078,
21,2,car,crv,664,809,487,570,145,83,0.8104471,12,30,11,0.5724137931034483,
22,2,car,crv,662,810,486,569,148,83,0.8144621,12,30,11,0.5608108108108109,
23,2,car,crv,667,820,484,577,153,93,0.8308673,12,30,11,0.6078431372549019,
24,2,car,crv,667,820,483,575,153,92,0.84983456,12,30,11,0.6013071895424836,
25,2,car,crv,667,820,485,574,153,89,0.8510291,12,30,11,0.5816993464052288,
26,2,car,crv,662,810,486,570,148,84,0.7822179,12,30,11,0.5675675675675675,
27,2,car,crv,667,819,484,575,152,91,0.8101879,12,30,11,0.5986842105263158,
28,2,car,crv,664,809,487,570,145,83,0.77994776,12,30,11,0.5724137931034483,
29,2,car,crv,667,819,484,575,152,91,0.8454891,12,30,11,0.5986842105263158,
30,2,car,crv,667,819,483,575,152,92,0.8094451,12,30,11,1.5625,
31,2,car,crv,667,820,482,574,153,92,0.6722521,12,30,11,0.6013071895424836,
32,2,car,crv,667,819,484,574,152,90,0.8371277,12,30,11,0.5921052631578947,
33,2,car,crv,667,819,484,574,152,90,0.77298564,12,30,11,0.5921052631578947,
34,2,car,crv,667,817,484,574,150,90,0.66427475,12,30,11,0.6,
35,2,car,crv,667,819,483,574,152,91,0.79131705,12,30,11,0.5986842105263158,
36,2,car,crv,667,819,484,575,152,91,0.83604145,12,30,11,0.5986842105263158,
37,2,car,crv,668,819,484,574,151,90,0.7223766,12,30,11,0.5960264900662252,
38,2,car,crv,668,818,483,573,150,90,0.7379781,12,30,11,0.6,
39,2,car,crv,668,821,484,575,153,91,0.7870298,12,30,11,0.5947712418300654,
40,2,car,crv,667,820,484,575,153,91,0.8413766,12,30,11,0.5947712418300654,
41,2,car,crv,668,820,484,574,152,90,0.8056128,12,30,11,0.5921052631578947,
42,2,car,crv,667,820,483,575,153,92,0.66239387,12,30,11,0.6013071895424836,
43,2,car,crv,667,820,484,575,153,91,0.772995,12,30,11,0.5947712418300654,
44,2,car,crv,667,820,485,574,153,89,0.8488218,12,30,11,0.5816993464052288,
45,2,car,crv,667,820,484,575,153,91,0.78723717,12,30,11,0.5947712418300654,
46,2,car,crv,663,810,486,569,147,83,0.7781846,12,30,11,0.564625850340136,
47,2,car,crv,667,819,485,574,152,89,0.8128246,12,30,11,0.5855263157894737,
48,2,car,crv,666,820,482,577,154,95,0.80031437,9,0,11,0.6168831168831169,
49,2,car,crv,667,820,485,573,153,88,0.8438455,12,30,11,0.5751633986928104,
50,2,car,crv,667,819,484,575,152,91,0.9125865,12,30,11,0.5986842105263158,
51,2,car,crv,668,821,485,574,153,89,0.8785678,12,30,11,0.5816993464052288,
52,2,car,crv,667,819,485,574,152,89,0.71991515,12,30,11,0.5855263157894737,
53,2,car,crv,667,820,484,577,153,93,0.7404891,12,30,11,0.6078431372549019,
54,2,car,crv,667,819,484,575,152,91,0.7707914,12,30,11,0.5986842105263158,
55,2,car,crv,662,810,486,571,148,85,0.7150951,12,30,11,0.5743243243243243,
56,2,car,crv,669,820,485,574,151,89,0.83562523,12,30,11,0.5894039735099338,
57,2,car,crv,666,820,484,574,154,90,0.78819734,12,30,11,0.5844155844155844,
58,2,car,crv,667,819,483,575,152,92,0.8056975,12,30,11,0.6052631578947368,
59,2,car,crv,668,821,485,574,153,89,0.80433,12,30,11,0.5816993464052288,
60,2,car,crv,667,820,484,572,153,88,0.7759209,12,30,11,0.5751633986928104,
61,2,car,crv,667,819,484,572,152,88,0.7274725,12,30,11,0.5789473684210527,
62,2,car,crv,810,1001,490,585,191,95,0.9551184,9,30,11,0.4973821989528796,
63,2,car,crv,807,1006,489,583,199,94,0.9514729,12,60,11,0.4723618090452261,
0,2,car,crv,667,820,483,575,153,92,0.87416166,12,30,11,0.6013071895424836,
1,2,car,crv,667,820,484,575,153,91,0.91537607,12,30,11,0.5947712418300654,
2,2,car,crv,666,819,483,575,153,92,0.87749106,12,30,11,-12236371.056980057,
3,2,car,crv,667,819,484,575,152,91,0.7623789,12,30,11,-12669516.867256638,
4,2,car,crv,663,810,485,569,147,84,0.7043501,12,30,11,-12744706.9347181,
5,2,car,crv,667,820,484,575,153,91,0.8218401,12,30,11,-13134453.40061162,
6,2,car,crv,668,819,483,574,151,91,0.8174212,12,30,11,-13765918.567307692,
7,2,car,crv,666,820,483,574,154,91,0.80471843,12,30,11,-13634813.587301588,
8,2,car,crv,667,820,483,575,153,92,0.8773953,12,30,11,-13591665.107594937,
9,2,car,crv,667,820,484,575,153,91,0.7467092,12,30,11,-16207419.275471698,
10,2,car,crv,667,820,484,575,153,91,0.8247261,12,30,11,-17043516.26190476,
11,2,car,crv,669,819,484,574,150,90,0.81360966,12,30,11,-18592927.83982684,
12,2,car,crv,667,820,483,576,153,93,0.73838603,12,30,11,-17248860.90763052,
13,2,car,crv,667,819,483,575,152,92,0.8015768,12,30,11,-13421769.275,
14,2,car,crv,667,820,484,574,153,90,0.68943864,12,30,11,0.5882352941176471,
15,2,car,crv,667,819,483,573,152,90,0.8037294,12,30,11,-13174742.81595092,
16,2,car,crv,663,809,486,569,146,83,0.7675451,12,30,11,-12897796.35135135,
17,2,car,crv,668,819,484,575,151,91,0.8577185,12,30,11,-12413197.066473989,
18,2,car,crv,669,820,484,574,151,90,0.7934381,12,30,11,0.5960264900662252,
19,2,car,crv,669,820,485,574,151,89,0.8260642,12,30,11,0.5894039735099338,
20,2,car,crv,668,819,484,573,151,89,0.8000626,12,30,11,0.5894039735099338,
21,2,car,crv,667,821,485,574,154,89,0.80527765,12,30,11,0.577922077922078,
22,2,car,crv,664,809,487,570,145,83,0.8104471,12,30,11,0.5724137931034483,
23,2,car,crv,662,810,486,569,148,83,0.8144621,12,30,11,0.5608108108108109,
24,2,car,crv,667,820,484,577,153,93,0.8308673,12,30,11,0.6078431372549019,
25,2,car,crv,667,820,483,575,153,92,0.84983456,12,30,11,0.6013071895424836,
26,2,car,crv,667,820,485,574,153,89,0.8510291,12,30,11,0.5816993464052288,
27,2,car,crv,662,810,486,570,148,84,0.7822179,12,30,11,0.5675675675675675,
28,2,car,crv,667,819,484,575,152,91,0.8101879,12,30,11,0.5986842105263158,
29,2,car,crv,664,809,487,570,145,83,0.77994776,12,30,11,0.5724137931034483,
30,2,car,crv,667,819,484,575,152,91,0.8454891,12,30,11,0.5986842105263158,
31,2,car,crv,667,819,483,575,152,92,0.8094451,12,30,11,1.5625,
32,2,car,crv,667,820,482,574,153,92,0.6722521,12,30,11,0.6013071895424836,
33,2,car,crv,667,819,484,574,152,90,0.8371277,12,30,11,0.5921052631578947,
34,2,car,crv,667,819,484,574,152,90,0.77298564,12,30,11,0.5921052631578947,
35,2,car,crv,667,817,484,574,150,90,0.66427475,12,30,11,0.6,
36,2,car,crv,667,819,483,574,152,91,0.79131705,12,30,11,0.5986842105263158,
37,2,car,crv,667,819,484,575,152,91,0.83604145,12,30,11,0.5986842105263158,
38,2,car,crv,668,819,484,574,151,90,0.7223766,12,30,11,0.5960264900662252,
39,2,car,crv,668,818,483,573,150,90,0.7379781,12,30,11,0.6,
40,2,car,crv,668,821,484,575,153,91,0.7870298,12,30,11,0.5947712418300654,
41,2,car,crv,667,820,484,575,153,91,0.8413766,12,30,11,0.5947712418300654,
42,2,car,crv,668,820,484,574,152,90,0.8056128,12,30,11,0.5921052631578947,
43,2,car,crv,667,820,483,575,153,92,0.66239387,12,30,11,0.6013071895424836,
44,2,car,crv,667,820,484,575,153,91,0.772995,12,30,11,0.5947712418300654,
45,2,car,crv,667,820,485,574,153,89,0.8488218,12,30,11,0.5816993464052288,
46,2,car,crv,667,820,484,575,153,91,0.78723717,12,30,11,0.5947712418300654,
47,2,car,crv,663,810,486,569,147,83,0.7781846,12,30,11,0.564625850340136,
48,2,car,crv,667,819,485,574,152,89,0.8128246,12,30,11,0.5855263157894737,
49,2,car,crv,666,820,482,577,154,95,0.80031437,9,0,11,0.6168831168831169,
50,2,car,crv,667,820,485,573,153,88,0.8438455,12,30,11,0.5751633986928104,
51,2,car,crv,667,819,484,575,152,91,0.9125865,12,30,11,0.5986842105263158,
52,2,car,crv,668,821,485,574,153,89,0.8785678,12,30,11,0.5816993464052288,
53,2,car,crv,667,819,485,574,152,89,0.71991515,12,30,11,0.5855263157894737,
54,2,car,crv,667,820,484,577,153,93,0.7404891,12,30,11,0.6078431372549019,
55,2,car,crv,667,819,484,575,152,91,0.7707914,12,30,11,0.5986842105263158,
56,2,car,crv,662,810,486,571,148,85,0.7150951,12,30,11,0.5743243243243243,
57,2,car,crv,669,820,485,574,151,89,0.83562523,12,30,11,0.5894039735099338,
58,2,car,crv,666,820,484,574,154,90,0.78819734,12,30,11,0.5844155844155844,
59,2,car,crv,667,819,483,575,152,92,0.8056975,12,30,11,0.6052631578947368,
60,2,car,crv,668,821,485,574,153,89,0.80433,12,30,11,0.5816993464052288,
61,2,car,crv,667,820,484,572,153,88,0.7759209,12,30,11,0.5751633986928104,
62,2,car,crv,667,819,484,572,152,88,0.7274725,12,30,11,0.5789473684210527,
63,2,car,crv,810,1001,490,585,191,95,0.9551184,9,30,11,0.4973821989528796,
64,2,car,crv,807,1006,489,583,199,94,0.9514729,12,60,11,0.4723618090452261,
0,2,car,crv,667,820,483,575,153,92,0.8195698,12,30,11,0.6013071895424836,
1,2,car,crv,667,820,483,575,153,92,0.87416166,12,30,11,0.6013071895424836,
2,2,car,crv,667,820,484,575,153,91,0.91537607,12,30,11,0.5947712418300654,
3,2,car,crv,666,819,483,575,153,92,0.87749106,12,30,11,-12236371.056980057,
4,2,car,crv,667,819,484,575,152,91,0.7623789,12,30,11,-12669516.867256638,
5,2,car,crv,663,810,485,569,147,84,0.7043501,12,30,11,-12744706.9347181,
6,2,car,crv,667,820,484,575,153,91,0.8218401,12,30,11,-13134453.40061162,
7,2,car,crv,668,819,483,574,151,91,0.8174212,12,30,11,-13765918.567307692,
8,2,car,crv,666,820,483,574,154,91,0.80471843,12,30,11,-13634813.587301588,
9,2,car,crv,667,820,483,575,153,92,0.8773953,12,30,11,-13591665.107594937,
10,2,car,crv,667,820,484,575,153,91,0.7467092,12,30,11,-16207419.275471698,
11,2,car,crv,667,820,484,575,153,91,0.8247261,12,30,11,-17043516.26190476,
12,2,car,crv,669,819,484,574,150,90,0.81360966,12,30,11,-18592927.83982684,
13,2,car,crv,667,820,483,576,153,93,0.73838603,12,30,11,-17248860.90763052,
14,2,car,crv,667,819,483,575,152,92,0.8015768,12,30,11,-13421769.275,
15,2,car,crv,667,820,484,574,153,90,0.68943864,12,30,11,0.5882352941176471,
16,2,car,crv,667,819,483,573,152,90,0.8037294,12,30,11,-13174742.81595092,
17,2,car,crv,663,809,486,569,146,83,0.7675451,12,30,11,-12897796.35135135,
18,2,car,crv,668,819,484,575,151,91,0.8577185,12,30,11,-12413197.066473989,
19,2,car,crv,669,820,484,574,151,90,0.7934381,12,30,11,0.5960264900662252,
20,2,car,crv,669,820,485,574,151,89,0.8260642,12,30,11,0.5894039735099338,
21,2,car,crv,668,819,484,573,151,89,0.8000626,12,30,11,0.5894039735099338,
22,2,car,crv,667,821,485,574,154,89,0.80527765,12,30,11,0.577922077922078,
23,2,car,crv,664,809,487,570,145,83,0.8104471,12,30,11,0.5724137931034483,
24,2,car,crv,662,810,486,569,148,83,0.8144621,12,30,11,0.5608108108108109,
25,2,car,crv,667,820,484,577,153,93,0.8308673,12,30,11,0.6078431372549019,
26,2,car,crv,667,820,483,575,153,92,0.84983456,12,30,11,0.6013071895424836,
27,2,car,crv,667,820,485,574,153,89,0.8510291,12,30,11,0.5816993464052288,
28,2,car,crv,662,810,486,570,148,84,0.7822179,12,30,11,0.5675675675675675,
29,2,car,crv,667,819,484,575,152,91,0.8101879,12,30,11,0.5986842105263158,
30,2,car,crv,664,809,487,570,145,83,0.77994776,12,30,11,0.5724137931034483,
31,2,car,crv,667,819,484,575,152,91,0.8454891,12,30,11,0.5986842105263158,
32,2,car,crv,667,819,483,575,152,92,0.8094451,12,30,11,1.5625,
33,2,car,crv,667,820,482,574,153,92,0.6722521,12,30,11,0.6013071895424836,
34,2,car,crv,667,819,484,574,152,90,0.8371277,12,30,11,0.5921052631578947,
35,2,car,crv,667,819,484,574,152,90,0.77298564,12,30,11,0.5921052631578947,
36,2,car,crv,667,817,484,574,150,90,0.66427475,12,30,11,0.6,
37,2,car,crv,667,819,483,574,152,91,0.79131705,12,30,11,0.5986842105263158,
38,2,car,crv,667,819,484,575,152,91,0.83604145,12,30,11,0.5986842105263158,
39,2,car,crv,668,819,484,574,151,90,0.7223766,12,30,11,0.5960264900662252,
40,2,car,crv,668,818,483,573,150,90,0.7379781,12,30,11,0.6,
41,2,car,crv,668,821,484,575,153,91,0.7870298,12,30,11,0.5947712418300654,
42,2,car,crv,667,820,484,575,153,91,0.8413766,12,30,11,0.5947712418300654,
43,2,car,crv,668,820,484,574,152,90,0.8056128,12,30,11,0.5921052631578947,
44,2,car,crv,667,820,483,575,153,92,0.66239387,12,30,11,0.6013071895424836,
45,2,car,crv,667,820,484,575,153,91,0.772995,12,30,11,0.5947712418300654,
46,2,car,crv,667,820,485,574,153,89,0.8488218,12,30,11,0.5816993464052288,
47,2,car,crv,667,820,484,575,153,91,0.78723717,12,30,11,0.5947712418300654,
48,2,car,crv,663,810,486,569,147,83,0.7781846,12,30,11,0.564625850340136,
49,2,car,crv,667,819,485,574,152,89,0.8128246,12,30,11,0.5855263157894737,
50,2,car,crv,666,820,482,577,154,95,0.80031437,9,0,11,0.6168831168831169,
51,2,car,crv,667,820,485,573,153,88,0.8438455,12,30,11,0.5751633986928104,
52,2,car,crv,667,819,484,575,152,91,0.9125865,12,30,11,0.5986842105263158,
53,2,car,crv,668,821,485,574,153,89,0.8785678,12,30,11,0.5816993464052288,
54,2,car,crv,667,819,485,574,152,89,0.71991515,12,30,11,0.5855263157894737,
55,2,car,crv,667,820,484,577,153,93,0.7404891,12,30,11,0.6078431372549019,
56,2,car,crv,667,819,484,575,152,91,0.7707914,12,30,11,0.5986842105263158,
57,2,car,crv,662,810,486,571,148,85,0.7150951,12,30,11,0.5743243243243243,
58,2,car,crv,669,820,485,574,151,89,0.83562523,12,30,11,0.5894039735099338,
59,2,car,crv,666,820,484,574,154,90,0.78819734,12,30,11,0.5844155844155844,
60,2,car,crv,667,819,483,575,152,92,0.8056975,12,30,11,0.6052631578947368,
61,2,car,crv,668,821,485,574,153,89,0.80433,12,30,11,0.5816993464052288,
62,2,car,crv,667,820,484,572,153,88,0.7759209,12,30,11,0.5751633986928104,
63,2,car,crv,667,819,484,572,152,88,0.7274725,12,30,11,0.5789473684210527,
64,2,car,crv,810,1001,490,585,191,95,0.9551184,9,30,11,0.4973821989528796,
65,2,car,crv,807,1006,489,583,199,94,0.9514729,12,60,11,0.4723618090452261,
0,2,car,crv,666,820,484,575,154,91,0.8430035,12,30,11,0.5909090909090909,
1,2,car,crv,667,820,483,575,153,92,0.8195698,12,30,11,0.6013071895424836,
2,2,car,crv,667,820,483,575,153,92,0.87416166,12,30,11,0.6013071895424836,
3,2,car,crv,667,820,484,575,153,91,0.91537607,12,30,11,0.5947712418300654,
4,2,car,crv,666,819,483,575,153,92,0.87749106,12,30,11,-12236371.056980057,
5,2,car,crv,667,819,484,575,152,91,0.7623789,12,30,11,-12669516.867256638,
6,2,car,crv,663,810,485,569,147,84,0.7043501,12,30,11,-12744706.9347181,
7,2,car,crv,667,820,484,575,153,91,0.8218401,12,30,11,-13134453.40061162,
8,2,car,crv,668,819,483,574,151,91,0.8174212,12,30,11,-13765918.567307692,
9,2,car,crv,666,820,483,574,154,91,0.80471843,12,30,11,-13634813.587301588,
10,2,car,crv,667,820,483,575,153,92,0.8773953,12,30,11,-13591665.107594937,
11,2,car,crv,667,820,484,575,153,91,0.7467092,12,30,11,-16207419.275471698,
12,2,car,crv,667,820,484,575,153,91,0.8247261,12,30,11,-17043516.26190476,
13,2,car,crv,669,819,484,574,150,90,0.81360966,12,30,11,-18592927.83982684,
14,2,car,crv,667,820,483,576,153,93,0.73838603,12,30,11,-17248860.90763052,
15,2,car,crv,667,819,483,575,152,92,0.8015768,12,30,11,-13421769.275,
16,2,car,crv,667,820,484,574,153,90,0.68943864,12,30,11,0.5882352941176471,
17,2,car,crv,667,819,483,573,152,90,0.8037294,12,30,11,-13174742.81595092,
18,2,car,crv,663,809,486,569,146,83,0.7675451,12,30,11,-12897796.35135135,
19,2,car,crv,668,819,484,575,151,91,0.8577185,12,30,11,-12413197.066473989,
20,2,car,crv,669,820,484,574,151,90,0.7934381,12,30,11,0.5960264900662252,
21,2,car,crv,669,820,485,574,151,89,0.8260642,12,30,11,0.5894039735099338,
22,2,car,crv,668,819,484,573,151,89,0.8000626,12,30,11,0.5894039735099338,
23,2,car,crv,667,821,485,574,154,89,0.80527765,12,30,11,0.577922077922078,
24,2,car,crv,664,809,487,570,145,83,0.8104471,12,30,11,0.5724137931034483,
25,2,car,crv,662,810,486,569,148,83,0.8144621,12,30,11,0.5608108108108109,
26,2,car,crv,667,820,484,577,153,93,0.8308673,12,30,11,0.6078431372549019,
27,2,car,crv,667,820,483,575,153,92,0.84983456,12,30,11,0.6013071895424836,
28,2,car,crv,667,820,485,574,153,89,0.8510291,12,30,11,0.5816993464052288,
29,2,car,crv,662,810,486,570,148,84,0.7822179,12,30,11,0.5675675675675675,
30,2,car,crv,667,819,484,575,152,91,0.8101879,12,30,11,0.5986842105263158,
31,2,car,crv,664,809,487,570,145,83,0.77994776,12,30,11,0.5724137931034483,
32,2,car,crv,667,819,484,575,152,91,0.8454891,12,30,11,0.5986842105263158,
33,2,car,crv,667,819,483,575,152,92,0.8094451,12,30,11,1.5625,
34,2,car,crv,667,820,482,574,153,92,0.6722521,12,30,11,0.6013071895424836,
35,2,car,crv,667,819,484,574,152,90,0.8371277,12,30,11,0.5921052631578947,
36,2,car,crv,667,819,484,574,152,90,0.77298564,12,30,11,0.5921052631578947,
37,2,car,crv,667,817,484,574,150,90,0.66427475,12,30,11,0.6,
38,2,car,crv,667,819,483,574,152,91,0.79131705,12,30,11,0.5986842105263158,
39,2,car,crv,667,819,484,575,152,91,0.83604145,12,30,11,0.5986842105263158,
40,2,car,crv,668,819,484,574,151,90,0.7223766,12,30,11,0.5960264900662252,
41,2,car,crv,668,818,483,573,150,90,0.7379781,12,30,11,0.6,
42,2,car,crv,668,821,484,575,153,91,0.7870298,12,30,11,0.5947712418300654,
43,2,car,crv,667,820,484,575,153,91,0.8413766,12,30,11,0.5947712418300654,
44,2,car,crv,668,820,484,574,152,90,0.8056128,12,30,11,0.5921052631578947,
45,2,car,crv,667,820,483,575,153,92,0.66239387,12,30,11,0.6013071895424836,
46,2,car,crv,667,820,484,575,153,91,0.772995,12,30,11,0.5947712418300654,
47,2,car,crv,667,820,485,574,153,89,0.8488218,12,30,11,0.5816993464052288,
48,2,car,crv,667,820,484,575,153,91,0.78723717,12,30,11,0.5947712418300654,
49,2,car,crv,663,810,486,569,147,83,0.7781846,12,30,11,0.564625850340136,
50,2,car,crv,667,819,485,574,152,89,0.8128246,12,30,11,0.5855263157894737,
51,2,car,crv,666,820,482,577,154,95,0.80031437,9,0,11,0.6168831168831169,
52,2,car,crv,667,820,485,573,153,88,0.8438455,12,30,11,0.5751633986928104,
53,2,car,crv,667,819,484,575,152,91,0.9125865,12,30,11,0.5986842105263158,
54,2,car,crv,668,821,485,574,153,89,0.8785678,12,30,11,0.5816993464052288,
55,2,car,crv,667,819,485,574,152,89,0.71991515,12,30,11,0.5855263157894737,
56,2,car,crv,667,820,484,577,153,93,0.7404891,12,30,11,0.6078431372549019,
57,2,car,crv,667,819,484,575,152,91,0.7707914,12,30,11,0.5986842105263158,
58,2,car,crv,662,810,486,571,148,85,0.7150951,12,30,11,0.5743243243243243,
59,2,car,crv,669,820,485,574,151,89,0.83562523,12,30,11,0.5894039735099338,
60,2,car,crv,666,820,484,574,154,90,0.78819734,12,30,11,0.5844155844155844,
61,2,car,crv,667,819,483,575,152,92,0.8056975,12,30,11,0.6052631578947368,
62,2,car,crv,668,821,485,574,153,89,0.80433,12,30,11,0.5816993464052288,
63,2,car,crv,667,820,484,572,153,88,0.7759209,12,30,11,0.5751633986928104,
64,2,car,crv,667,819,484,572,152,88,0.7274725,12,30,11,0.5789473684210527,
65,2,car,crv,810,1001,490,585,191,95,0.9551184,9,30,11,0.4973821989528796,
66,2,car,crv,807,1006,489,583,199,94,0.9514729,12,60,11,0.4723618090452261,
0,2,car,crv,667,820,483,573,153,90,0.8686103,12,30,11,0.5882352941176471,
1,2,car,crv,666,820,484,575,154,91,0.8430035,12,30,11,0.5909090909090909,
2,2,car,crv,667,820,483,575,153,92,0.8195698,12,30,11,0.6013071895424836,
3,2,car,crv,667,820,483,575,153,92,0.87416166,12,30,11,0.6013071895424836,
4,2,car,crv,667,820,484,575,153,91,0.91537607,12,30,11,0.5947712418300654,
5,2,car,crv,666,819,483,575,153,92,0.87749106,12,30,11,-12236371.056980057,
6,2,car,crv,667,819,484,575,152,91,0.7623789,12,30,11,-12669516.867256638,
7,2,car,crv,663,810,485,569,147,84,0.7043501,12,30,11,-12744706.9347181,
8,2,car,crv,667,820,484,575,153,91,0.8218401,12,30,11,-13134453.40061162,
9,2,car,crv,668,819,483,574,151,91,0.8174212,12,30,11,-13765918.567307692,
10,2,car,crv,666,820,483,574,154,91,0.80471843,12,30,11,-13634813.587301588,
11,2,car,crv,667,820,483,575,153,92,0.8773953,12,30,11,-13591665.107594937,
12,2,car,crv,667,820,484,575,153,91,0.7467092,12,30,11,-16207419.275471698,
13,2,car,crv,667,820,484,575,153,91,0.8247261,12,30,11,-17043516.26190476,
14,2,car,crv,669,819,484,574,150,90,0.81360966,12,30,11,-18592927.83982684,
15,2,car,crv,667,820,483,576,153,93,0.73838603,12,30,11,-17248860.90763052,
16,2,car,crv,667,819,483,575,152,92,0.8015768,12,30,11,-13421769.275,
17,2,car,crv,667,820,484,574,153,90,0.68943864,12,30,11,0.5882352941176471,
18,2,car,crv,667,819,483,573,152,90,0.8037294,12,30,11,-13174742.81595092,
19,2,car,crv,663,809,486,569,146,83,0.7675451,12,30,11,-12897796.35135135,
20,2,car,crv,668,819,484,575,151,91,0.8577185,12,30,11,-12413197.066473989,
21,2,car,crv,669,820,484,574,151,90,0.7934381,12,30,11,0.5960264900662252,
22,2,car,crv,669,820,485,574,151,89,0.8260642,12,30,11,0.5894039735099338,
23,2,car,crv,668,819,484,573,151,89,0.8000626,12,30,11,0.5894039735099338,
24,2,car,crv,667,821,485,574,154,89,0.80527765,12,30,11,0.577922077922078,
25,2,car,crv,664,809,487,570,145,83,0.8104471,12,30,11,0.5724137931034483,
26,2,car,crv,662,810,486,569,148,83,0.8144621,12,30,11,0.5608108108108109,
27,2,car,crv,667,820,484,577,153,93,0.8308673,12,30,11,0.6078431372549019,
28,2,car,crv,667,820,483,575,153,92,0.84983456,12,30,11,0.6013071895424836,
29,2,car,crv,667,820,485,574,153,89,0.8510291,12,30,11,0.5816993464052288,
30,2,car,crv,662,810,486,570,148,84,0.7822179,12,30,11,0.5675675675675675,
31,2,car,crv,667,819,484,575,152,91,0.8101879,12,30,11,0.5986842105263158,
32,2,car,crv,664,809,487,570,145,83,0.77994776,12,30,11,0.5724137931034483,
33,2,car,crv,667,819,484,575,152,91,0.8454891,12,30,11,0.5986842105263158,
34,2,car,crv,667,819,483,575,152,92,0.8094451,12,30,11,1.5625,
35,2,car,crv,667,820,482,574,153,92,0.6722521,12,30,11,0.6013071895424836,
36,2,car,crv,667,819,484,574,152,90,0.8371277,12,30,11,0.5921052631578947,
37,2,car,crv,667,819,484,574,152,90,0.77298564,12,30,11,0.5921052631578947,
38,2,car,crv,667,817,484,574,150,90,0.66427475,12,30,11,0.6,
39,2,car,crv,667,819,483,574,152,91,0.79131705,12,30,11,0.5986842105263158,
40,2,car,crv,667,819,484,575,152,91,0.83604145,12,30,11,0.5986842105263158,
41,2,car,crv,668,819,484,574,151,90,0.7223766,12,30,11,0.5960264900662252,
42,2,car,crv,668,818,483,573,150,90,0.7379781,12,30,11,0.6,
43,2,car,crv,668,821,484,575,153,91,0.7870298,12,30,11,0.5947712418300654,
44,2,car,crv,667,820,484,575,153,91,0.8413766,12,30,11,0.5947712418300654,
45,2,car,crv,668,820,484,574,152,90,0.8056128,12,30,11,0.5921052631578947,
46,2,car,crv,667,820,483,575,153,92,0.66239387,12,30,11,0.6013071895424836,
47,2,car,crv,667,820,484,575,153,91,0.772995,12,30,11,0.5947712418300654,
48,2,car,crv,667,820,485,574,153,89,0.8488218,12,30,11,0.5816993464052288,
49,2,car,crv,667,820,484,575,153,91,0.78723717,12,30,11,0.5947712418300654,
50,2,car,crv,663,810,486,569,147,83,0.7781846,12,30,11,0.564625850340136,
51,2,car,crv,667,819,485,574,152,89,0.8128246,12,30,11,0.5855263157894737,
52,2,car,crv,666,820,482,577,154,95,0.80031437,9,0,11,0.6168831168831169,
53,2,car,crv,667,820,485,573,153,88,0.8438455,12,30,11,0.5751633986928104,
54,2,car,crv,667,819,484,575,152,91,0.9125865,12,30,11,0.5986842105263158,
55,2,car,crv,668,821,485,574,153,89,0.8785678,12,30,11,0.5816993464052288,
56,2,car,crv,667,819,485,574,152,89,0.71991515,12,30,11,0.5855263157894737,
57,2,car,crv,667,820,484,577,153,93,0.7404891,12,30,11,0.6078431372549019,
58,2,car,crv,667,819,484,575,152,91,0.7707914,12,30,11,0.5986842105263158,
59,2,car,crv,662,810,486,571,148,85,0.7150951,12,30,11,0.5743243243243243,
60,2,car,crv,669,820,485,574,151,89,0.83562523,12,30,11,0.5894039735099338,
61,2,car,crv,666,820,484,574,154,90,0.78819734,12,30,11,0.5844155844155844,
62,2,car,crv,667,819,483,575,152,92,0.8056975,12,30,11,0.6052631578947368,
63,2,car,crv,668,821,485,574,153,89,0.80433,12,30,11,0.5816993464052288,
64,2,car,crv,667,820,484,572,153,88,0.7759209,12,30,11,0.5751633986928104,
65,2,car,crv,667,819,484,572,152,88,0.7274725,12,30,11,0.5789473684210527,
66,2,car,crv,810,1001,490,585,191,95,0.9551184,9,30,11,0.4973821989528796,
67,2,car,crv,807,1006,489,583,199,94,0.9514729,12,60,11,0.4723618090452261,
0,2,car,crv,667,820,484,574,153,90,0.7872868,12,30,11,0.5882352941176471,
1,2,car,crv,667,820,483,573,153,90,0.8686103,12,30,11,0.5882352941176471,
2,2,car,crv,666,820,484,575,154,91,0.8430035,12,30,11,0.5909090909090909,
3,2,car,crv,667,820,483,575,153,92,0.8195698,12,30,11,0.6013071895424836,
4,2,car,crv,667,820,483,575,153,92,0.87416166,12,30,11,0.6013071895424836,
5,2,car,crv,667,820,484,575,153,91,0.91537607,12,30,11,0.5947712418300654,
6,2,car,crv,666,819,483,575,153,92,0.87749106,12,30,11,-12236371.056980057,
7,2,car,crv,667,819,484,575,152,91,0.7623789,12,30,11,-12669516.867256638,
8,2,car,crv,663,810,485,569,147,84,0.7043501,12,30,11,-12744706.9347181,
9,2,car,crv,667,820,484,575,153,91,0.8218401,12,30,11,-13134453.40061162,
10,2,car,crv,668,819,483,574,151,91,0.8174212,12,30,11,-13765918.567307692,
11,2,car,crv,666,820,483,574,154,91,0.80471843,12,30,11,-13634813.587301588,
12,2,car,crv,667,820,483,575,153,92,0.8773953,12,30,11,-13591665.107594937,
13,2,car,crv,667,820,484,575,153,91,0.7467092,12,30,11,-16207419.275471698,
14,2,car,crv,667,820,484,575,153,91,0.8247261,12,30,11,-17043516.26190476,
15,2,car,crv,669,819,484,574,150,90,0.81360966,12,30,11,-18592927.83982684,
16,2,car,crv,667,820,483,576,153,93,0.73838603,12,30,11,-17248860.90763052,
17,2,car,crv,667,819,483,575,152,92,0.8015768,12,30,11,-13421769.275,
18,2,car,crv,667,820,484,574,153,90,0.68943864,12,30,11,0.5882352941176471,
19,2,car,crv,667,819,483,573,152,90,0.8037294,12,30,11,-13174742.81595092,
20,2,car,crv,663,809,486,569,146,83,0.7675451,12,30,11,-12897796.35135135,
21,2,car,crv,668,819,484,575,151,91,0.8577185,12,30,11,-12413197.066473989,
22,2,car,crv,669,820,484,574,151,90,0.7934381,12,30,11,0.5960264900662252,
23,2,car,crv,669,820,485,574,151,89,0.8260642,12,30,11,0.5894039735099338,
24,2,car,crv,668,819,484,573,151,89,0.8000626,12,30,11,0.5894039735099338,
25,2,car,crv,667,821,485,574,154,89,0.80527765,12,30,11,0.577922077922078,
26,2,car,crv,664,809,487,570,145,83,0.8104471,12,30,11,0.5724137931034483,
27,2,car,crv,662,810,486,569,148,83,0.8144621,12,30,11,0.5608108108108109,
28,2,car,crv,667,820,484,577,153,93,0.8308673,12,30,11,0.6078431372549019,
29,2,car,crv,667,820,483,575,153,92,0.84983456,12,30,11,0.6013071895424836,
30,2,car,crv,667,820,485,574,153,89,0.8510291,12,30,11,0.5816993464052288,
31,2,car,crv,662,810,486,570,148,84,0.7822179,12,30,11,0.5675675675675675,
32,2,car,crv,667,819,484,575,152,91,0.8101879,12,30,11,0.5986842105263158,
33,2,car,crv,664,809,487,570,145,83,0.77994776,12,30,11,0.5724137931034483,
34,2,car,crv,667,819,484,575,152,91,0.8454891,12,30,11,0.5986842105263158,
35,2,car,crv,667,819,483,575,152,92,0.8094451,12,30,11,1.5625,
36,2,car,crv,667,820,482,574,153,92,0.6722521,12,30,11,0.6013071895424836,
37,2,car,crv,667,819,484,574,152,90,0.8371277,12,30,11,0.5921052631578947,
38,2,car,crv,667,819,484,574,152,90,0.77298564,12,30,11,0.5921052631578947,
39,2,car,crv,667,817,484,574,150,90,0.66427475,12,30,11,0.6,
40,2,car,crv,667,819,483,574,152,91,0.79131705,12,30,11,0.5986842105263158,
41,2,car,crv,667,819,484,575,152,91,0.83604145,12,30,11,0.5986842105263158,
42,2,car,crv,668,819,484,574,151,90,0.7223766,12,30,11,0.5960264900662252,
43,2,car,crv,668,818,483,573,150,90,0.7379781,12,30,11,0.6,
44,2,car,crv,668,821,484,575,153,91,0.7870298,12,30,11,0.5947712418300654,
45,2,car,crv,667,820,484,575,153,91,0.8413766,12,30,11,0.5947712418300654,
46,2,car,crv,668,820,484,574,152,90,0.8056128,12,30,11,0.5921052631578947,
47,2,car,crv,667,820,483,575,153,92,0.66239387,12,30,11,0.6013071895424836,
48,2,car,crv,667,820,484,575,153,91,0.772995,12,30,11,0.5947712418300654,
49,2,car,crv,667,820,485,574,153,89,0.8488218,12,30,11,0.5816993464052288,
50,2,car,crv,667,820,484,575,153,91,0.78723717,12,30,11,0.5947712418300654,
51,2,car,crv,663,810,486,569,147,83,0.7781846,12,30,11,0.564625850340136,
52,2,car,crv,667,819,485,574,152,89,0.8128246,12,30,11,0.5855263157894737,
53,2,car,crv,666,820,482,577,154,95,0.80031437,9,0,11,0.6168831168831169,
54,2,car,crv,667,820,485,573,153,88,0.8438455,12,30,11,0.5751633986928104,
55,2,car,crv,667,819,484,575,152,91,0.9125865,12,30,11,0.5986842105263158,
56,2,car,crv,668,821,485,574,153,89,0.8785678,12,30,11,0.5816993464052288,
57,2,car,crv,667,819,485,574,152,89,0.71991515,12,30,11,0.5855263157894737,
58,2,car,crv,667,820,484,577,153,93,0.7404891,12,30,11,0.6078431372549019,
59,2,car,crv,667,819,484,575,152,91,0.7707914,12,30,11,0.5986842105263158,
60,2,car,crv,662,810,486,571,148,85,0.7150951,12,30,11,0.5743243243243243,
61,2,car,crv,669,820,485,574,151,89,0.83562523,12,30,11,0.5894039735099338,
62,2,car,crv,666,820,484,574,154,90,0.78819734,12,30,11,0.5844155844155844,
63,2,car,crv,667,819,483,575,152,92,0.8056975,12,30,11,0.6052631578947368,
64,2,car,crv,668,821,485,574,153,89,0.80433,12,30,11,0.5816993464052288,
65,2,car,crv,667,820,484,572,153,88,0.7759209,12,30,11,0.5751633986928104,
66,2,car,crv,667,819,484,572,152,88,0.7274725,12,30,11,0.5789473684210527,
67,2,car,crv,810,1001,490,585,191,95,0.9551184,9,30,11,0.4973821989528796,
68,2,car,crv,807,1006,489,583,199,94,0.9514729,12,60,11,0.4723618090452261,
0,2,car,crv,663,810,486,571,147,85,0.8805993,12,30,11,0.5782312925170068,
1,2,car,crv,667,820,484,574,153,90,0.7872868,12,30,11,0.5882352941176471,
2,2,car,crv,667,820,483,573,153,90,0.8686103,12,30,11,0.5882352941176471,
3,2,car,crv,666,820,484,575,154,91,0.8430035,12,30,11,0.5909090909090909,
4,2,car,crv,667,820,483,575,153,92,0.8195698,12,30,11,0.6013071895424836,
5,2,car,crv,667,820,483,575,153,92,0.87416166,12,30,11,0.6013071895424836,
6,2,car,crv,667,820,484,575,153,91,0.91537607,12,30,11,0.5947712418300654,
7,2,car,crv,666,819,483,575,153,92,0.87749106,12,30,11,-12236371.056980057,
8,2,car,crv,667,819,484,575,152,91,0.7623789,12,30,11,-12669516.867256638,
9,2,car,crv,663,810,485,569,147,84,0.7043501,12,30,11,-12744706.9347181,
10,2,car,crv,667,820,484,575,153,91,0.8218401,12,30,11,-13134453.40061162,
11,2,car,crv,668,819,483,574,151,91,0.8174212,12,30,11,-13765918.567307692,
12,2,car,crv,666,820,483,574,154,91,0.80471843,12,30,11,-13634813.587301588,
13,2,car,crv,667,820,483,575,153,92,0.8773953,12,30,11,-13591665.107594937,
14,2,car,crv,667,820,484,575,153,91,0.7467092,12,30,11,-16207419.275471698,
15,2,car,crv,667,820,484,575,153,91,0.8247261,12,30,11,-17043516.26190476,
16,2,car,crv,669,819,484,574,150,90,0.81360966,12,30,11,-18592927.83982684,
17,2,car,crv,667,820,483,576,153,93,0.73838603,12,30,11,-17248860.90763052,
18,2,car,crv,667,819,483,575,152,92,0.8015768,12,30,11,-13421769.275,
19,2,car,crv,667,820,484,574,153,90,0.68943864,12,30,11,0.5882352941176471,
20,2,car,crv,667,819,483,573,152,90,0.8037294,12,30,11,-13174742.81595092,
21,2,car,crv,663,809,486,569,146,83,0.7675451,12,30,11,-12897796.35135135,
22,2,car,crv,668,819,484,575,151,91,0.8577185,12,30,11,-12413197.066473989,
23,2,car,crv,669,820,484,574,151,90,0.7934381,12,30,11,0.5960264900662252,
24,2,car,crv,669,820,485,574,151,89,0.8260642,12,30,11,0.5894039735099338,
25,2,car,crv,668,819,484,573,151,89,0.8000626,12,30,11,0.5894039735099338,
26,2,car,crv,667,821,485,574,154,89,0.80527765,12,30,11,0.577922077922078,
27,2,car,crv,664,809,487,570,145,83,0.8104471,12,30,11,0.5724137931034483,
28,2,car,crv,662,810,486,569,148,83,0.8144621,12,30,11,0.5608108108108109,
29,2,car,crv,667,820,484,577,153,93,0.8308673,12,30,11,0.6078431372549019,
30,2,car,crv,667,820,483,575,153,92,0.84983456,12,30,11,0.6013071895424836,
31,2,car,crv,667,820,485,574,153,89,0.8510291,12,30,11,0.5816993464052288,
32,2,car,crv,662,810,486,570,148,84,0.7822179,12,30,11,0.5675675675675675,
33,2,car,crv,667,819,484,575,152,91,0.8101879,12,30,11,0.5986842105263158,
34,2,car,crv,664,809,487,570,145,83,0.77994776,12,30,11,0.5724137931034483,
35,2,car,crv,667,819,484,575,152,91,0.8454891,12,30,11,0.5986842105263158,
36,2,car,crv,667,819,483,575,152,92,0.8094451,12,30,11,1.5625,
37,2,car,crv,667,820,482,574,153,92,0.6722521,12,30,11,0.6013071895424836,
38,2,car,crv,667,819,484,574,152,90,0.8371277,12,30,11,0.5921052631578947,
39,2,car,crv,667,819,484,574,152,90,0.77298564,12,30,11,0.5921052631578947,
40,2,car,crv,667,817,484,574,150,90,0.66427475,12,30,11,0.6,
41,2,car,crv,667,819,483,574,152,91,0.79131705,12,30,11,0.5986842105263158,
42,2,car,crv,667,819,484,575,152,91,0.83604145,12,30,11,0.5986842105263158,
43,2,car,crv,668,819,484,574,151,90,0.7223766,12,30,11,0.5960264900662252,
44,2,car,crv,668,818,483,573,150,90,0.7379781,12,30,11,0.6,
45,2,car,crv,668,821,484,575,153,91,0.7870298,12,30,11,0.5947712418300654,
46,2,car,crv,667,820,484,575,153,91,0.8413766,12,30,11,0.5947712418300654,
47,2,car,crv,668,820,484,574,152,90,0.8056128,12,30,11,0.5921052631578947,
48,2,car,crv,667,820,483,575,153,92,0.66239387,12,30,11,0.6013071895424836,
49,2,car,crv,667,820,484,575,153,91,0.772995,12,30,11,0.5947712418300654,
50,2,car,crv,667,820,485,574,153,89,0.8488218,12,30,11,0.5816993464052288,
51,2,car,crv,667,820,484,575,153,91,0.78723717,12,30,11,0.5947712418300654,
52,2,car,crv,663,810,486,569,147,83,0.7781846,12,30,11,0.564625850340136,
53,2,car,crv,667,819,485,574,152,89,0.8128246,12,30,11,0.5855263157894737,
54,2,car,crv,666,820,482,577,154,95,0.80031437,9,0,11,0.6168831168831169,
55,2,car,crv,667,820,485,573,153,88,0.8438455,12,30,11,0.5751633986928104,
56,2,car,crv,667,819,484,575,152,91,0.9125865,12,30,11,0.5986842105263158,
57,2,car,crv,668,821,485,574,153,89,0.8785678,12,30,11,0.5816993464052288,
58,2,car,crv,667,819,485,574,152,89,0.71991515,12,30,11,0.5855263157894737,
59,2,car,crv,667,820,484,577,153,93,0.7404891,12,30,11,0.6078431372549019,
60,2,car,crv,667,819,484,575,152,91,0.7707914,12,30,11,0.5986842105263158,
61,2,car,crv,662,810,486,571,148,85,0.7150951,12,30,11,0.5743243243243243,
62,2,car,crv,669,820,485,574,151,89,0.83562523,12,30,11,0.5894039735099338,
63,2,car,crv,666,820,484,574,154,90,0.78819734,12,30,11,0.5844155844155844,
64,2,car,crv,667,819,483,575,152,92,0.8056975,12,30,11,0.6052631578947368,
65,2,car,crv,668,821,485,574,153,89,0.80433,12,30,11,0.5816993464052288,
66,2,car,crv,667,820,484,572,153,88,0.7759209,12,30,11,0.5751633986928104,
67,2,car,crv,667,819,484,572,152,88,0.7274725,12,30,11,0.5789473684210527,
68,2,car,crv,810,1001,490,585,191,95,0.9551184,9,30,11,0.4973821989528796,
69,2,car,crv,807,1006,489,583,199,94,0.9514729,12,60,11,0.4723618090452261,
0,2,car,crv,667,819,483,574,152,91,0.7576286,12,30,11,0.5986842105263158,
1,2,car,crv,663,810,486,571,147,85,0.8805993,12,30,11,0.5782312925170068,
2,2,car,crv,667,820,484,574,153,90,0.7872868,12,30,11,0.5882352941176471,
3,2,car,crv,667,820,483,573,153,90,0.8686103,12,30,11,0.5882352941176471,
4,2,car,crv,666,820,484,575,154,91,0.8430035,12,30,11,0.5909090909090909,
5,2,car,crv,667,820,483,575,153,92,0.8195698,12,30,11,0.6013071895424836,
6,2,car,crv,667,820,483,575,153,92,0.87416166,12,30,11,0.6013071895424836,
7,2,car,crv,667,820,484,575,153,91,0.91537607,12,30,11,0.5947712418300654,
8,2,car,crv,666,819,483,575,153,92,0.87749106,12,30,11,-12236371.056980057,
9,2,car,crv,667,819,484,575,152,91,0.7623789,12,30,11,-12669516.867256638,
10,2,car,crv,663,810,485,569,147,84,0.7043501,12,30,11,-12744706.9347181,
11,2,car,crv,667,820,484,575,153,91,0.8218401,12,30,11,-13134453.40061162,
12,2,car,crv,668,819,483,574,151,91,0.8174212,12,30,11,-13765918.567307692,
13,2,car,crv,666,820,483,574,154,91,0.80471843,12,30,11,-13634813.587301588,
14,2,car,crv,667,820,483,575,153,92,0.8773953,12,30,11,-13591665.107594937,
15,2,car,crv,667,820,484,575,153,91,0.7467092,12,30,11,-16207419.275471698,
16,2,car,crv,667,820,484,575,153,91,0.8247261,12,30,11,-17043516.26190476,
17,2,car,crv,669,819,484,574,150,90,0.81360966,12,30,11,-18592927.83982684,
18,2,car,crv,667,820,483,576,153,93,0.73838603,12,30,11,-17248860.90763052,
19,2,car,crv,667,819,483,575,152,92,0.8015768,12,30,11,-13421769.275,
20,2,car,crv,667,820,484,574,153,90,0.68943864,12,30,11,0.5882352941176471,
21,2,car,crv,667,819,483,573,152,90,0.8037294,12,30,11,-13174742.81595092,
22,2,car,crv,663,809,486,569,146,83,0.7675451,12,30,11,-12897796.35135135,
23,2,car,crv,668,819,484,575,151,91,0.8577185,12,30,11,-12413197.066473989,
24,2,car,crv,669,820,484,574,151,90,0.7934381,12,30,11,0.5960264900662252,
25,2,car,crv,669,820,485,574,151,89,0.8260642,12,30,11,0.5894039735099338,
26,2,car,crv,668,819,484,573,151,89,0.8000626,12,30,11,0.5894039735099338,
27,2,car,crv,667,821,485,574,154,89,0.80527765,12,30,11,0.577922077922078,
28,2,car,crv,664,809,487,570,145,83,0.8104471,12,30,11,0.5724137931034483,
29,2,car,crv,662,810,486,569,148,83,0.8144621,12,30,11,0.5608108108108109,
30,2,car,crv,667,820,484,577,153,93,0.8308673,12,30,11,0.6078431372549019,
31,2,car,crv,667,820,483,575,153,92,0.84983456,12,30,11,0.6013071895424836,
32,2,car,crv,667,820,485,574,153,89,0.8510291,12,30,11,0.5816993464052288,
33,2,car,crv,662,810,486,570,148,84,0.7822179,12,30,11,0.5675675675675675,
34,2,car,crv,667,819,484,575,152,91,0.8101879,12,30,11,0.5986842105263158,
35,2,car,crv,664,809,487,570,145,83,0.77994776,12,30,11,0.5724137931034483,
36,2,car,crv,667,819,484,575,152,91,0.8454891,12,30,11,0.5986842105263158,
37,2,car,crv,667,819,483,575,152,92,0.8094451,12,30,11,1.5625,
38,2,car,crv,667,820,482,574,153,92,0.6722521,12,30,11,0.6013071895424836,
39,2,car,crv,667,819,484,574,152,90,0.8371277,12,30,11,0.5921052631578947,
40,2,car,crv,667,819,484,574,152,90,0.77298564,12,30,11,0.5921052631578947,
41,2,car,crv,667,817,484,574,150,90,0.66427475,12,30,11,0.6,
42,2,car,crv,667,819,483,574,152,91,0.79131705,12,30,11,0.5986842105263158,
43,2,car,crv,667,819,484,575,152,91,0.83604145,12,30,11,0.5986842105263158,
44,2,car,crv,668,819,484,574,151,90,0.7223766,12,30,11,0.5960264900662252,
45,2,car,crv,668,818,483,573,150,90,0.7379781,12,30,11,0.6,
46,2,car,crv,668,821,484,575,153,91,0.7870298,12,30,11,0.5947712418300654,
47,2,car,crv,667,820,484,575,153,91,0.8413766,12,30,11,0.5947712418300654,
48,2,car,crv,668,820,484,574,152,90,0.8056128,12,30,11,0.5921052631578947,
49,2,car,crv,667,820,483,575,153,92,0.66239387,12,30,11,0.6013071895424836,
50,2,car,crv,667,820,484,575,153,91,0.772995,12,30,11,0.5947712418300654,
51,2,car,crv,667,820,485,574,153,89,0.8488218,12,30,11,0.5816993464052288,
52,2,car,crv,667,820,484,575,153,91,0.78723717,12,30,11,0.5947712418300654,
53,2,car,crv,663,810,486,569,147,83,0.7781846,12,30,11,0.564625850340136,
54,2,car,crv,667,819,485,574,152,89,0.8128246,12,30,11,0.5855263157894737,
55,2,car,crv,666,820,482,577,154,95,0.80031437,9,0,11,0.6168831168831169,
56,2,car,crv,667,820,485,573,153,88,0.8438455,12,30,11,0.5751633986928104,
57,2,car,crv,667,819,484,575,152,91,0.9125865,12,30,11,0.5986842105263158,
58,2,car,crv,668,821,485,574,153,89,0.8785678,12,30,11,0.5816993464052288,
59,2,car,crv,667,819,485,574,152,89,0.71991515,12,30,11,0.5855263157894737,
60,2,car,crv,667,820,484,577,153,93,0.7404891,12,30,11,0.6078431372549019,
61,2,car,crv,667,819,484,575,152,91,0.7707914,12,30,11,0.5986842105263158,
62,2,car,crv,662,810,486,571,148,85,0.7150951,12,30,11,0.5743243243243243,
63,2,car,crv,669,820,485,574,151,89,0.83562523,12,30,11,0.5894039735099338,
64,2,car,crv,666,820,484,574,154,90,0.78819734,12,30,11,0.5844155844155844,
65,2,car,crv,667,819,483,575,152,92,0.8056975,12,30,11,0.6052631578947368,
66,2,car,crv,668,821,485,574,153,89,0.80433,12,30,11,0.5816993464052288,
67,2,car,crv,667,820,484,572,153,88,0.7759209,12,30,11,0.5751633986928104,
68,2,car,crv,667,819,484,572,152,88,0.7274725,12,30,11,0.5789473684210527,
69,2,car,crv,810,1001,490,585,191,95,0.9551184,9,30,11,0.4973821989528796,
70,2,car,crv,807,1006,489,583,199,94,0.9514729,12,60,11,0.4723618090452261,
0,2,car,crv,667,820,483,575,153,92,0.8377369,12,30,11,0.6013071895424836,
1,2,car,crv,667,819,483,574,152,91,0.7576286,12,30,11,0.5986842105263158,
2,2,car,crv,663,810,486,571,147,85,0.8805993,12,30,11,0.5782312925170068,
3,2,car,crv,667,820,484,574,153,90,0.7872868,12,30,11,0.5882352941176471,
4,2,car,crv,667,820,483,573,153,90,0.8686103,12,30,11,0.5882352941176471,
5,2,car,crv,666,820,484,575,154,91,0.8430035,12,30,11,0.5909090909090909,
6,2,car,crv,667,820,483,575,153,92,0.8195698,12,30,11,0.6013071895424836,
7,2,car,crv,667,820,483,575,153,92,0.87416166,12,30,11,0.6013071895424836,
8,2,car,crv,667,820,484,575,153,91,0.91537607,12,30,11,0.5947712418300654,
9,2,car,crv,666,819,483,575,153,92,0.87749106,12,30,11,-12236371.056980057,
10,2,car,crv,667,819,484,575,152,91,0.7623789,12,30,11,-12669516.867256638,
11,2,car,crv,663,810,485,569,147,84,0.7043501,12,30,11,-12744706.9347181,
12,2,car,crv,667,820,484,575,153,91,0.8218401,12,30,11,-13134453.40061162,
13,2,car,crv,668,819,483,574,151,91,0.8174212,12,30,11,-13765918.567307692,
14,2,car,crv,666,820,483,574,154,91,0.80471843,12,30,11,-13634813.587301588,
15,2,car,crv,667,820,483,575,153,92,0.8773953,12,30,11,-13591665.107594937,
16,2,car,crv,667,820,484,575,153,91,0.7467092,12,30,11,-16207419.275471698,
17,2,car,crv,667,820,484,575,153,91,0.8247261,12,30,11,-17043516.26190476,
18,2,car,crv,669,819,484,574,150,90,0.81360966,12,30,11,-18592927.83982684,
19,2,car,crv,667,820,483,576,153,93,0.73838603,12,30,11,-17248860.90763052,
20,2,car,crv,667,819,483,575,152,92,0.8015768,12,30,11,-13421769.275,
21,2,car,crv,667,820,484,574,153,90,0.68943864,12,30,11,0.5882352941176471,
22,2,car,crv,667,819,483,573,152,90,0.8037294,12,30,11,-13174742.81595092,
23,2,car,crv,663,809,486,569,146,83,0.7675451,12,30,11,-12897796.35135135,
24,2,car,crv,668,819,484,575,151,91,0.8577185,12,30,11,-12413197.066473989,
25,2,car,crv,669,820,484,574,151,90,0.7934381,12,30,11,0.5960264900662252,
26,2,car,crv,669,820,485,574,151,89,0.8260642,12,30,11,0.5894039735099338,
27,2,car,crv,668,819,484,573,151,89,0.8000626,12,30,11,0.5894039735099338,
28,2,car,crv,667,821,485,574,154,89,0.80527765,12,30,11,0.577922077922078,
29,2,car,crv,664,809,487,570,145,83,0.8104471,12,30,11,0.5724137931034483,
30,2,car,crv,662,810,486,569,148,83,0.8144621,12,30,11,0.5608108108108109,
31,2,car,crv,667,820,484,577,153,93,0.8308673,12,30,11,0.6078431372549019,
32,2,car,crv,667,820,483,575,153,92,0.84983456,12,30,11,0.6013071895424836,
33,2,car,crv,667,820,485,574,153,89,0.8510291,12,30,11,0.5816993464052288,
34,2,car,crv,662,810,486,570,148,84,0.7822179,12,30,11,0.5675675675675675,
35,2,car,crv,667,819,484,575,152,91,0.8101879,12,30,11,0.5986842105263158,
36,2,car,crv,664,809,487,570,145,83,0.77994776,12,30,11,0.5724137931034483,
37,2,car,crv,667,819,484,575,152,91,0.8454891,12,30,11,0.5986842105263158,
38,2,car,crv,667,819,483,575,152,92,0.8094451,12,30,11,1.5625,
39,2,car,crv,667,820,482,574,153,92,0.6722521,12,30,11,0.6013071895424836,
40,2,car,crv,667,819,484,574,152,90,0.8371277,12,30,11,0.5921052631578947,
41,2,car,crv,667,819,484,574,152,90,0.77298564,12,30,11,0.5921052631578947,
42,2,car,crv,667,817,484,574,150,90,0.66427475,12,30,11,0.6,
43,2,car,crv,667,819,483,574,152,91,0.79131705,12,30,11,0.5986842105263158,
44,2,car,crv,667,819,484,575,152,91,0.83604145,12,30,11,0.5986842105263158,
45,2,car,crv,668,819,484,574,151,90,0.7223766,12,30,11,0.5960264900662252,
46,2,car,crv,668,818,483,573,150,90,0.7379781,12,30,11,0.6,
47,2,car,crv,668,821,484,575,153,91,0.7870298,12,30,11,0.5947712418300654,
48,2,car,crv,667,820,484,575,153,91,0.8413766,12,30,11,0.5947712418300654,
49,2,car,crv,668,820,484,574,152,90,0.8056128,12,30,11,0.5921052631578947,
50,2,car,crv,667,820,483,575,153,92,0.66239387,12,30,11,0.6013071895424836,
51,2,car,crv,667,820,484,575,153,91,0.772995,12,30,11,0.5947712418300654,
52,2,car,crv,667,820,485,574,153,89,0.8488218,12,30,11,0.5816993464052288,
53,2,car,crv,667,820,484,575,153,91,0.78723717,12,30,11,0.5947712418300654,
54,2,car,crv,663,810,486,569,147,83,0.7781846,12,30,11,0.564625850340136,
55,2,car,crv,667,819,485,574,152,89,0.8128246,12,30,11,0.5855263157894737,
56,2,car,crv,666,820,482,577,154,95,0.80031437,9,0,11,0.6168831168831169,
57,2,car,crv,667,820,485,573,153,88,0.8438455,12,30,11,0.5751633986928104,
58,2,car,crv,667,819,484,575,152,91,0.9125865,12,30,11,0.5986842105263158,
59,2,car,crv,668,821,485,574,153,89,0.8785678,12,30,11,0.5816993464052288,
60,2,car,crv,667,819,485,574,152,89,0.71991515,12,30,11,0.5855263157894737,
61,2,car,crv,667,820,484,577,153,93,0.7404891,12,30,11,0.6078431372549019,
62,2,car,crv,667,819,484,575,152,91,0.7707914,12,30,11,0.5986842105263158,
63,2,car,crv,662,810,486,571,148,85,0.7150951,12,30,11,0.5743243243243243,
64,2,car,crv,669,820,485,574,151,89,0.83562523,12,30,11,0.5894039735099338,
65,2,car,crv,666,820,484,574,154,90,0.78819734,12,30,11,0.5844155844155844,
66,2,car,crv,667,819,483,575,152,92,0.8056975,12,30,11,0.6052631578947368,
67,2,car,crv,668,821,485,574,153,89,0.80433,12,30,11,0.5816993464052288,
68,2,car,crv,667,820,484,572,153,88,0.7759209,12,30,11,0.5751633986928104,
69,2,car,crv,667,819,484,572,152,88,0.7274725,12,30,11,0.5789473684210527,
70,2,car,crv,810,1001,490,585,191,95,0.9551184,9,30,11,0.4973821989528796,
71,2,car,crv,807,1006,489,583,199,94,0.9514729,12,60,11,0.4723618090452261,
0,2,car,crv,667,820,484,575,153,91,0.85702145,12,30,11,0.5947712418300654,
1,2,car,crv,667,820,483,575,153,92,0.8377369,12,30,11,0.6013071895424836,
2,2,car,crv,667,819,483,574,152,91,0.7576286,12,30,11,0.5986842105263158,
3,2,car,crv,663,810,486,571,147,85,0.8805993,12,30,11,0.5782312925170068,
4,2,car,crv,667,820,484,574,153,90,0.7872868,12,30,11,0.5882352941176471,
5,2,car,crv,667,820,483,573,153,90,0.8686103,12,30,11,0.5882352941176471,
6,2,car,crv,666,820,484,575,154,91,0.8430035,12,30,11,0.5909090909090909,
7,2,car,crv,667,820,483,575,153,92,0.8195698,12,30,11,0.6013071895424836,
8,2,car,crv,667,820,483,575,153,92,0.87416166,12,30,11,0.6013071895424836,
9,2,car,crv,667,820,484,575,153,91,0.91537607,12,30,11,0.5947712418300654,
10,2,car,crv,666,819,483,575,153,92,0.87749106,12,30,11,-12236371.056980057,
11,2,car,crv,667,819,484,575,152,91,0.7623789,12,30,11,-12669516.867256638,
12,2,car,crv,663,810,485,569,147,84,0.7043501,12,30,11,-12744706.9347181,
13,2,car,crv,667,820,484,575,153,91,0.8218401,12,30,11,-13134453.40061162,
14,2,car,crv,668,819,483,574,151,91,0.8174212,12,30,11,-13765918.567307692,
15,2,car,crv,666,820,483,574,154,91,0.80471843,12,30,11,-13634813.587301588,
16,2,car,crv,667,820,483,575,153,92,0.8773953,12,30,11,-13591665.107594937,
17,2,car,crv,667,820,484,575,153,91,0.7467092,12,30,11,-16207419.275471698,
18,2,car,crv,667,820,484,575,153,91,0.8247261,12,30,11,-17043516.26190476,
19,2,car,crv,669,819,484,574,150,90,0.81360966,12,30,11,-18592927.83982684,
20,2,car,crv,667,820,483,576,153,93,0.73838603,12,30,11,-17248860.90763052,
21,2,car,crv,667,819,483,575,152,92,0.8015768,12,30,11,-13421769.275,
22,2,car,crv,667,820,484,574,153,90,0.68943864,12,30,11,0.5882352941176471,
23,2,car,crv,667,819,483,573,152,90,0.8037294,12,30,11,-13174742.81595092,
24,2,car,crv,663,809,486,569,146,83,0.7675451,12,30,11,-12897796.35135135,
25,2,car,crv,668,819,484,575,151,91,0.8577185,12,30,11,-12413197.066473989,
26,2,car,crv,669,820,484,574,151,90,0.7934381,12,30,11,0.5960264900662252,
27,2,car,crv,669,820,485,574,151,89,0.8260642,12,30,11,0.5894039735099338,
28,2,car,crv,668,819,484,573,151,89,0.8000626,12,30,11,0.5894039735099338,
29,2,car,crv,667,821,485,574,154,89,0.80527765,12,30,11,0.577922077922078,
30,2,car,crv,664,809,487,570,145,83,0.8104471,12,30,11,0.5724137931034483,
31,2,car,crv,662,810,486,569,148,83,0.8144621,12,30,11,0.5608108108108109,
32,2,car,crv,667,820,484,577,153,93,0.8308673,12,30,11,0.6078431372549019,
33,2,car,crv,667,820,483,575,153,92,0.84983456,12,30,11,0.6013071895424836,
34,2,car,crv,667,820,485,574,153,89,0.8510291,12,30,11,0.5816993464052288,
35,2,car,crv,662,810,486,570,148,84,0.7822179,12,30,11,0.5675675675675675,
36,2,car,crv,667,819,484,575,152,91,0.8101879,12,30,11,0.5986842105263158,
37,2,car,crv,664,809,487,570,145,83,0.77994776,12,30,11,0.5724137931034483,
38,2,car,crv,667,819,484,575,152,91,0.8454891,12,30,11,0.5986842105263158,
39,2,car,crv,667,819,483,575,152,92,0.8094451,12,30,11,1.5625,
40,2,car,crv,667,820,482,574,153,92,0.6722521,12,30,11,0.6013071895424836,
41,2,car,crv,667,819,484,574,152,90,0.8371277,12,30,11,0.5921052631578947,
42,2,car,crv,667,819,484,574,152,90,0.77298564,12,30,11,0.5921052631578947,
43,2,car,crv,667,817,484,574,150,90,0.66427475,12,30,11,0.6,
44,2,car,crv,667,819,483,574,152,91,0.79131705,12,30,11,0.5986842105263158,
45,2,car,crv,667,819,484,575,152,91,0.83604145,12,30,11,0.5986842105263158,
46,2,car,crv,668,819,484,574,151,90,0.7223766,12,30,11,0.5960264900662252,
47,2,car,crv,668,818,483,573,150,90,0.7379781,12,30,11,0.6,
48,2,car,crv,668,821,484,575,153,91,0.7870298,12,30,11,0.5947712418300654,
49,2,car,crv,667,820,484,575,153,91,0.8413766,12,30,11,0.5947712418300654,
50,2,car,crv,668,820,484,574,152,90,0.8056128,12,30,11,0.5921052631578947,
51,2,car,crv,667,820,483,575,153,92,0.66239387,12,30,11,0.6013071895424836,
52,2,car,crv,667,820,484,575,153,91,0.772995,12,30,11,0.5947712418300654,
53,2,car,crv,667,820,485,574,153,89,0.8488218,12,30,11,0.5816993464052288,
54,2,car,crv,667,820,484,575,153,91,0.78723717,12,30,11,0.5947712418300654,
55,2,car,crv,663,810,486,569,147,83,0.7781846,12,30,11,0.564625850340136,
56,2,car,crv,667,819,485,574,152,89,0.8128246,12,30,11,0.5855263157894737,
57,2,car,crv,666,820,482,577,154,95,0.80031437,9,0,11,0.6168831168831169,
58,2,car,crv,667,820,485,573,153,88,0.8438455,12,30,11,0.5751633986928104,
59,2,car,crv,667,819,484,575,152,91,0.9125865,12,30,11,0.5986842105263158,
60,2,car,crv,668,821,485,574,153,89,0.8785678,12,30,11,0.5816993464052288,
61,2,car,crv,667,819,485,574,152,89,0.71991515,12,30,11,0.5855263157894737,
62,2,car,crv,667,820,484,577,153,93,0.7404891,12,30,11,0.6078431372549019,
63,2,car,crv,667,819,484,575,152,91,0.7707914,12,30,11,0.5986842105263158,
64,2,car,crv,662,810,486,571,148,85,0.7150951,12,30,11,0.5743243243243243,
65,2,car,crv,669,820,485,574,151,89,0.83562523,12,30,11,0.5894039735099338,
66,2,car,crv,666,820,484,574,154,90,0.78819734,12,30,11,0.5844155844155844,
67,2,car,crv,667,819,483,575,152,92,0.8056975,12,30,11,0.6052631578947368,
68,2,car,crv,668,821,485,574,153,89,0.80433,12,30,11,0.5816993464052288,
69,2,car,crv,667,820,484,572,153,88,0.7759209,12,30,11,0.5751633986928104,
70,2,car,crv,667,819,484,572,152,88,0.7274725,12,30,11,0.5789473684210527,
71,2,car,crv,810,1001,490,585,191,95,0.9551184,9,30,11,0.4973821989528796,
72,2,car,crv,807,1006,489,583,199,94,0.9514729,12,60,11,0.4723618090452261,
0,2,car,crv,668,821,484,574,153,90,0.911769,12,30,11,-10324438.079326924,
1,2,car,crv,667,820,484,575,153,91,0.85702145,12,30,11,0.5947712418300654,
2,2,car,crv,667,820,483,575,153,92,0.8377369,12,30,11,0.6013071895424836,
3,2,car,crv,667,819,483,574,152,91,0.7576286,12,30,11,0.5986842105263158,
4,2,car,crv,663,810,486,571,147,85,0.8805993,12,30,11,0.5782312925170068,
5,2,car,crv,667,820,484,574,153,90,0.7872868,12,30,11,0.5882352941176471,
6,2,car,crv,667,820,483,573,153,90,0.8686103,12,30,11,0.5882352941176471,
7,2,car,crv,666,820,484,575,154,91,0.8430035,12,30,11,0.5909090909090909,
8,2,car,crv,667,820,483,575,153,92,0.8195698,12,30,11,0.6013071895424836,
9,2,car,crv,667,820,483,575,153,92,0.87416166,12,30,11,0.6013071895424836,
10,2,car,crv,667,820,484,575,153,91,0.91537607,12,30,11,0.5947712418300654,
11,2,car,crv,666,819,483,575,153,92,0.87749106,12,30,11,-12236371.056980057,
12,2,car,crv,667,819,484,575,152,91,0.7623789,12,30,11,-12669516.867256638,
13,2,car,crv,663,810,485,569,147,84,0.7043501,12,30,11,-12744706.9347181,
14,2,car,crv,667,820,484,575,153,91,0.8218401,12,30,11,-13134453.40061162,
15,2,car,crv,668,819,483,574,151,91,0.8174212,12,30,11,-13765918.567307692,
16,2,car,crv,666,820,483,574,154,91,0.80471843,12,30,11,-13634813.587301588,
17,2,car,crv,667,820,483,575,153,92,0.8773953,12,30,11,-13591665.107594937,
18,2,car,crv,667,820,484,575,153,91,0.7467092,12,30,11,-16207419.275471698,
19,2,car,crv,667,820,484,575,153,91,0.8247261,12,30,11,-17043516.26190476,
20,2,car,crv,669,819,484,574,150,90,0.81360966,12,30,11,-18592927.83982684,
21,2,car,crv,667,820,483,576,153,93,0.73838603,12,30,11,-17248860.90763052,
22,2,car,crv,667,819,483,575,152,92,0.8015768,12,30,11,-13421769.275,
23,2,car,crv,667,820,484,574,153,90,0.68943864,12,30,11,0.5882352941176471,
24,2,car,crv,667,819,483,573,152,90,0.8037294,12,30,11,-13174742.81595092,
25,2,car,crv,663,809,486,569,146,83,0.7675451,12,30,11,-12897796.35135135,
26,2,car,crv,668,819,484,575,151,91,0.8577185,12,30,11,-12413197.066473989,
27,2,car,crv,669,820,484,574,151,90,0.7934381,12,30,11,0.5960264900662252,
28,2,car,crv,669,820,485,574,151,89,0.8260642,12,30,11,0.5894039735099338,
29,2,car,crv,668,819,484,573,151,89,0.8000626,12,30,11,0.5894039735099338,
30,2,car,crv,667,821,485,574,154,89,0.80527765,12,30,11,0.577922077922078,
31,2,car,crv,664,809,487,570,145,83,0.8104471,12,30,11,0.5724137931034483,
32,2,car,crv,662,810,486,569,148,83,0.8144621,12,30,11,0.5608108108108109,
33,2,car,crv,667,820,484,577,153,93,0.8308673,12,30,11,0.6078431372549019,
34,2,car,crv,667,820,483,575,153,92,0.84983456,12,30,11,0.6013071895424836,
35,2,car,crv,667,820,485,574,153,89,0.8510291,12,30,11,0.5816993464052288,
36,2,car,crv,662,810,486,570,148,84,0.7822179,12,30,11,0.5675675675675675,
37,2,car,crv,667,819,484,575,152,91,0.8101879,12,30,11,0.5986842105263158,
38,2,car,crv,664,809,487,570,145,83,0.77994776,12,30,11,0.5724137931034483,
39,2,car,crv,667,819,484,575,152,91,0.8454891,12,30,11,0.5986842105263158,
40,2,car,crv,667,819,483,575,152,92,0.8094451,12,30,11,1.5625,
41,2,car,crv,667,820,482,574,153,92,0.6722521,12,30,11,0.6013071895424836,
42,2,car,crv,667,819,484,574,152,90,0.8371277,12,30,11,0.5921052631578947,
43,2,car,crv,667,819,484,574,152,90,0.77298564,12,30,11,0.5921052631578947,
44,2,car,crv,667,817,484,574,150,90,0.66427475,12,30,11,0.6,
45,2,car,crv,667,819,483,574,152,91,0.79131705,12,30,11,0.5986842105263158,
46,2,car,crv,667,819,484,575,152,91,0.83604145,12,30,11,0.5986842105263158,
47,2,car,crv,668,819,484,574,151,90,0.7223766,12,30,11,0.5960264900662252,
48,2,car,crv,668,818,483,573,150,90,0.7379781,12,30,11,0.6,
49,2,car,crv,668,821,484,575,153,91,0.7870298,12,30,11,0.5947712418300654,
50,2,car,crv,667,820,484,575,153,91,0.8413766,12,30,11,0.5947712418300654,
51,2,car,crv,668,820,484,574,152,90,0.8056128,12,30,11,0.5921052631578947,
52,2,car,crv,667,820,483,575,153,92,0.66239387,12,30,11,0.6013071895424836,
53,2,car,crv,667,820,484,575,153,91,0.772995,12,30,11,0.5947712418300654,
54,2,car,crv,667,820,485,574,153,89,0.8488218,12,30,11,0.5816993464052288,
55,2,car,crv,667,820,484,575,153,91,0.78723717,12,30,11,0.5947712418300654,
56,2,car,crv,663,810,486,569,147,83,0.7781846,12,30,11,0.564625850340136,
57,2,car,crv,667,819,485,574,152,89,0.8128246,12,30,11,0.5855263157894737,
58,2,car,crv,666,820,482,577,154,95,0.80031437,9,0,11,0.6168831168831169,
59,2,car,crv,667,820,485,573,153,88,0.8438455,12,30,11,0.5751633986928104,
60,2,car,crv,667,819,484,575,152,91,0.9125865,12,30,11,0.5986842105263158,
61,2,car,crv,668,821,485,574,153,89,0.8785678,12,30,11,0.5816993464052288,
62,2,car,crv,667,819,485,574,152,89,0.71991515,12,30,11,0.5855263157894737,
63,2,car,crv,667,820,484,577,153,93,0.7404891,12,30,11,0.6078431372549019,
64,2,car,crv,667,819,484,575,152,91,0.7707914,12,30,11,0.5986842105263158,
65,2,car,crv,662,810,486,571,148,85,0.7150951,12,30,11,0.5743243243243243,
66,2,car,crv,669,820,485,574,151,89,0.83562523,12,30,11,0.5894039735099338,
67,2,car,crv,666,820,484,574,154,90,0.78819734,12,30,11,0.5844155844155844,
68,2,car,crv,667,819,483,575,152,92,0.8056975,12,30,11,0.6052631578947368,
69,2,car,crv,668,821,485,574,153,89,0.80433,12,30,11,0.5816993464052288,
70,2,car,crv,667,820,484,572,153,88,0.7759209,12,30,11,0.5751633986928104,
71,2,car,crv,667,819,484,572,152,88,0.7274725,12,30,11,0.5789473684210527,
72,2,car,crv,810,1001,490,585,191,95,0.9551184,9,30,11,0.4973821989528796,
73,2,car,crv,807,1006,489,583,199,94,0.9514729,12,60,11,0.4723618090452261,
0,2,car,crv,666,820,483,573,154,90,0.83617496,12,30,11,2.5509708737864076,
1,2,car,crv,668,821,484,574,153,90,0.911769,12,30,11,-10324438.079326924,
2,2,car,crv,667,820,484,575,153,91,0.85702145,12,30,11,0.5947712418300654,
3,2,car,crv,667,820,483,575,153,92,0.8377369,12,30,11,0.6013071895424836,
4,2,car,crv,667,819,483,574,152,91,0.7576286,12,30,11,0.5986842105263158,
5,2,car,crv,663,810,486,571,147,85,0.8805993,12,30,11,0.5782312925170068,
6,2,car,crv,667,820,484,574,153,90,0.7872868,12,30,11,0.5882352941176471,
7,2,car,crv,667,820,483,573,153,90,0.8686103,12,30,11,0.5882352941176471,
8,2,car,crv,666,820,484,575,154,91,0.8430035,12,30,11,0.5909090909090909,
9,2,car,crv,667,820,483,575,153,92,0.8195698,12,30,11,0.6013071895424836,
10,2,car,crv,667,820,483,575,153,92,0.87416166,12,30,11,0.6013071895424836,
11,2,car,crv,667,820,484,575,153,91,0.91537607,12,30,11,0.5947712418300654,
12,2,car,crv,666,819,483,575,153,92,0.87749106,12,30,11,-12236371.056980057,
13,2,car,crv,667,819,484,575,152,91,0.7623789,12,30,11,-12669516.867256638,
14,2,car,crv,663,810,485,569,147,84,0.7043501,12,30,11,-12744706.9347181,
15,2,car,crv,667,820,484,575,153,91,0.8218401,12,30,11,-13134453.40061162,
16,2,car,crv,668,819,483,574,151,91,0.8174212,12,30,11,-13765918.567307692,
17,2,car,crv,666,820,483,574,154,91,0.80471843,12,30,11,-13634813.587301588,
18,2,car,crv,667,820,483,575,153,92,0.8773953,12,30,11,-13591665.107594937,
19,2,car,crv,667,820,484,575,153,91,0.7467092,12,30,11,-16207419.275471698,
20,2,car,crv,667,820,484,575,153,91,0.8247261,12,30,11,-17043516.26190476,
21,2,car,crv,669,819,484,574,150,90,0.81360966,12,30,11,-18592927.83982684,
22,2,car,crv,667,820,483,576,153,93,0.73838603,12,30,11,-17248860.90763052,
23,2,car,crv,667,819,483,575,152,92,0.8015768,12,30,11,-13421769.275,
24,2,car,crv,667,820,484,574,153,90,0.68943864,12,30,11,0.5882352941176471,
25,2,car,crv,667,819,483,573,152,90,0.8037294,12,30,11,-13174742.81595092,
26,2,car,crv,663,809,486,569,146,83,0.7675451,12,30,11,-12897796.35135135,
27,2,car,crv,668,819,484,575,151,91,0.8577185,12,30,11,-12413197.066473989,
28,2,car,crv,669,820,484,574,151,90,0.7934381,12,30,11,0.5960264900662252,
29,2,car,crv,669,820,485,574,151,89,0.8260642,12,30,11,0.5894039735099338,
30,2,car,crv,668,819,484,573,151,89,0.8000626,12,30,11,0.5894039735099338,
31,2,car,crv,667,821,485,574,154,89,0.80527765,12,30,11,0.577922077922078,
32,2,car,crv,664,809,487,570,145,83,0.8104471,12,30,11,0.5724137931034483,
33,2,car,crv,662,810,486,569,148,83,0.8144621,12,30,11,0.5608108108108109,
34,2,car,crv,667,820,484,577,153,93,0.8308673,12,30,11,0.6078431372549019,
35,2,car,crv,667,820,483,575,153,92,0.84983456,12,30,11,0.6013071895424836,
36,2,car,crv,667,820,485,574,153,89,0.8510291,12,30,11,0.5816993464052288,
37,2,car,crv,662,810,486,570,148,84,0.7822179,12,30,11,0.5675675675675675,
38,2,car,crv,667,819,484,575,152,91,0.8101879,12,30,11,0.5986842105263158,
39,2,car,crv,664,809,487,570,145,83,0.77994776,12,30,11,0.5724137931034483,
40,2,car,crv,667,819,484,575,152,91,0.8454891,12,30,11,0.5986842105263158,
41,2,car,crv,667,819,483,575,152,92,0.8094451,12,30,11,1.5625,
42,2,car,crv,667,820,482,574,153,92,0.6722521,12,30,11,0.6013071895424836,
43,2,car,crv,667,819,484,574,152,90,0.8371277,12,30,11,0.5921052631578947,
44,2,car,crv,667,819,484,574,152,90,0.77298564,12,30,11,0.5921052631578947,
45,2,car,crv,667,817,484,574,150,90,0.66427475,12,30,11,0.6,
46,2,car,crv,667,819,483,574,152,91,0.79131705,12,30,11,0.5986842105263158,
47,2,car,crv,667,819,484,575,152,91,0.83604145,12,30,11,0.5986842105263158,
48,2,car,crv,668,819,484,574,151,90,0.7223766,12,30,11,0.5960264900662252,
49,2,car,crv,668,818,483,573,150,90,0.7379781,12,30,11,0.6,
50,2,car,crv,668,821,484,575,153,91,0.7870298,12,30,11,0.5947712418300654,
51,2,car,crv,667,820,484,575,153,91,0.8413766,12,30,11,0.5947712418300654,
52,2,car,crv,668,820,484,574,152,90,0.8056128,12,30,11,0.5921052631578947,
53,2,car,crv,667,820,483,575,153,92,0.66239387,12,30,11,0.6013071895424836,
54,2,car,crv,667,820,484,575,153,91,0.772995,12,30,11,0.5947712418300654,
55,2,car,crv,667,820,485,574,153,89,0.8488218,12,30,11,0.5816993464052288,
56,2,car,crv,667,820,484,575,153,91,0.78723717,12,30,11,0.5947712418300654,
57,2,car,crv,663,810,486,569,147,83,0.7781846,12,30,11,0.564625850340136,
58,2,car,crv,667,819,485,574,152,89,0.8128246,12,30,11,0.5855263157894737,
59,2,car,crv,666,820,482,577,154,95,0.80031437,9,0,11,0.6168831168831169,
60,2,car,crv,667,820,485,573,153,88,0.8438455,12,30,11,0.5751633986928104,
61,2,car,crv,667,819,484,575,152,91,0.9125865,12,30,11,0.5986842105263158,
62,2,car,crv,668,821,485,574,153,89,0.8785678,12,30,11,0.5816993464052288,
63,2,car,crv,667,819,485,574,152,89,0.71991515,12,30,11,0.5855263157894737,
64,2,car,crv,667,820,484,577,153,93,0.7404891,12,30,11,0.6078431372549019,
65,2,car,crv,667,819,484,575,152,91,0.7707914,12,30,11,0.5986842105263158,
66,2,car,crv,662,810,486,571,148,85,0.7150951,12,30,11,0.5743243243243243,
67,2,car,crv,669,820,485,574,151,89,0.83562523,12,30,11,0.5894039735099338,
68,2,car,crv,666,820,484,574,154,90,0.78819734,12,30,11,0.5844155844155844,
69,2,car,crv,667,819,483,575,152,92,0.8056975,12,30,11,0.6052631578947368,
70,2,car,crv,668,821,485,574,153,89,0.80433,12,30,11,0.5816993464052288,
71,2,car,crv,667,820,484,572,153,88,0.7759209,12,30,11,0.5751633986928104,
72,2,car,crv,667,819,484,572,152,88,0.7274725,12,30,11,0.5789473684210527,
73,2,car,crv,810,1001,490,585,191,95,0.9551184,9,30,11,0.4973821989528796,
74,2,car,crv,807,1006,489,583,199,94,0.9514729,12,60,11,0.4723618090452261,
0,2,car,crv,667,819,483,574,152,91,0.80771464,12,30,11,-10791372.680904523,
1,2,car,crv,666,820,483,573,154,90,0.83617496,12,30,11,2.5509708737864076,
2,2,car,crv,668,821,484,574,153,90,0.911769,12,30,11,-10324438.079326924,
3,2,car,crv,667,820,484,575,153,91,0.85702145,12,30,11,0.5947712418300654,
4,2,car,crv,667,820,483,575,153,92,0.8377369,12,30,11,0.6013071895424836,
5,2,car,crv,667,819,483,574,152,91,0.7576286,12,30,11,0.5986842105263158,
6,2,car,crv,663,810,486,571,147,85,0.8805993,12,30,11,0.5782312925170068,
7,2,car,crv,667,820,484,574,153,90,0.7872868,12,30,11,0.5882352941176471,
8,2,car,crv,667,820,483,573,153,90,0.8686103,12,30,11,0.5882352941176471,
9,2,car,crv,666,820,484,575,154,91,0.8430035,12,30,11,0.5909090909090909,
10,2,car,crv,667,820,483,575,153,92,0.8195698,12,30,11,0.6013071895424836,
11,2,car,crv,667,820,483,575,153,92,0.87416166,12,30,11,0.6013071895424836,
12,2,car,crv,667,820,484,575,153,91,0.91537607,12,30,11,0.5947712418300654,
13,2,car,crv,666,819,483,575,153,92,0.87749106,12,30,11,-12236371.056980057,
14,2,car,crv,667,819,484,575,152,91,0.7623789,12,30,11,-12669516.867256638,
15,2,car,crv,663,810,485,569,147,84,0.7043501,12,30,11,-12744706.9347181,
16,2,car,crv,667,820,484,575,153,91,0.8218401,12,30,11,-13134453.40061162,
17,2,car,crv,668,819,483,574,151,91,0.8174212,12,30,11,-13765918.567307692,
18,2,car,crv,666,820,483,574,154,91,0.80471843,12,30,11,-13634813.587301588,
19,2,car,crv,667,820,483,575,153,92,0.8773953,12,30,11,-13591665.107594937,
20,2,car,crv,667,820,484,575,153,91,0.7467092,12,30,11,-16207419.275471698,
21,2,car,crv,667,820,484,575,153,91,0.8247261,12,30,11,-17043516.26190476,
22,2,car,crv,669,819,484,574,150,90,0.81360966,12,30,11,-18592927.83982684,
23,2,car,crv,667,820,483,576,153,93,0.73838603,12,30,11,-17248860.90763052,
24,2,car,crv,667,819,483,575,152,92,0.8015768,12,30,11,-13421769.275,
25,2,car,crv,667,820,484,574,153,90,0.68943864,12,30,11,0.5882352941176471,
26,2,car,crv,667,819,483,573,152,90,0.8037294,12,30,11,-13174742.81595092,
27,2,car,crv,663,809,486,569,146,83,0.7675451,12,30,11,-12897796.35135135,
28,2,car,crv,668,819,484,575,151,91,0.8577185,12,30,11,-12413197.066473989,
29,2,car,crv,669,820,484,574,151,90,0.7934381,12,30,11,0.5960264900662252,
30,2,car,crv,669,820,485,574,151,89,0.8260642,12,30,11,0.5894039735099338,
31,2,car,crv,668,819,484,573,151,89,0.8000626,12,30,11,0.5894039735099338,
32,2,car,crv,667,821,485,574,154,89,0.80527765,12,30,11,0.577922077922078,
33,2,car,crv,664,809,487,570,145,83,0.8104471,12,30,11,0.5724137931034483,
34,2,car,crv,662,810,486,569,148,83,0.8144621,12,30,11,0.5608108108108109,
35,2,car,crv,667,820,484,577,153,93,0.8308673,12,30,11,0.6078431372549019,
36,2,car,crv,667,820,483,575,153,92,0.84983456,12,30,11,0.6013071895424836,
37,2,car,crv,667,820,485,574,153,89,0.8510291,12,30,11,0.5816993464052288,
38,2,car,crv,662,810,486,570,148,84,0.7822179,12,30,11,0.5675675675675675,
39,2,car,crv,667,819,484,575,152,91,0.8101879,12,30,11,0.5986842105263158,
40,2,car,crv,664,809,487,570,145,83,0.77994776,12,30,11,0.5724137931034483,
41,2,car,crv,667,819,484,575,152,91,0.8454891,12,30,11,0.5986842105263158,
42,2,car,crv,667,819,483,575,152,92,0.8094451,12,30,11,1.5625,
43,2,car,crv,667,820,482,574,153,92,0.6722521,12,30,11,0.6013071895424836,
44,2,car,crv,667,819,484,574,152,90,0.8371277,12,30,11,0.5921052631578947,
45,2,car,crv,667,819,484,574,152,90,0.77298564,12,30,11,0.5921052631578947,
46,2,car,crv,667,817,484,574,150,90,0.66427475,12,30,11,0.6,
47,2,car,crv,667,819,483,574,152,91,0.79131705,12,30,11,0.5986842105263158,
48,2,car,crv,667,819,484,575,152,91,0.83604145,12,30,11,0.5986842105263158,
49,2,car,crv,668,819,484,574,151,90,0.7223766,12,30,11,0.5960264900662252,
50,2,car,crv,668,818,483,573,150,90,0.7379781,12,30,11,0.6,
51,2,car,crv,668,821,484,575,153,91,0.7870298,12,30,11,0.5947712418300654,
52,2,car,crv,667,820,484,575,153,91,0.8413766,12,30,11,0.5947712418300654,
53,2,car,crv,668,820,484,574,152,90,0.8056128,12,30,11,0.5921052631578947,
54,2,car,crv,667,820,483,575,153,92,0.66239387,12,30,11,0.6013071895424836,
55,2,car,crv,667,820,484,575,153,91,0.772995,12,30,11,0.5947712418300654,
56,2,car,crv,667,820,485,574,153,89,0.8488218,12,30,11,0.5816993464052288,
57,2,car,crv,667,820,484,575,153,91,0.78723717,12,30,11,0.5947712418300654,
58,2,car,crv,663,810,486,569,147,83,0.7781846,12,30,11,0.564625850340136,
59,2,car,crv,667,819,485,574,152,89,0.8128246,12,30,11,0.5855263157894737,
60,2,car,crv,666,820,482,577,154,95,0.80031437,9,0,11,0.6168831168831169,
61,2,car,crv,667,820,485,573,153,88,0.8438455,12,30,11,0.5751633986928104,
62,2,car,crv,667,819,484,575,152,91,0.9125865,12,30,11,0.5986842105263158,
63,2,car,crv,668,821,485,574,153,89,0.8785678,12,30,11,0.5816993464052288,
64,2,car,crv,667,819,485,574,152,89,0.71991515,12,30,11,0.5855263157894737,
65,2,car,crv,667,820,484,577,153,93,0.7404891,12,30,11,0.6078431372549019,
66,2,car,crv,667,819,484,575,152,91,0.7707914,12,30,11,0.5986842105263158,
67,2,car,crv,662,810,486,571,148,85,0.7150951,12,30,11,0.5743243243243243,
68,2,car,crv,669,820,485,574,151,89,0.83562523,12,30,11,0.5894039735099338,
69,2,car,crv,666,820,484,574,154,90,0.78819734,12,30,11,0.5844155844155844,
70,2,car,crv,667,819,483,575,152,92,0.8056975,12,30,11,0.6052631578947368,
71,2,car,crv,668,821,485,574,153,89,0.80433,12,30,11,0.5816993464052288,
72,2,car,crv,667,820,484,572,153,88,0.7759209,12,30,11,0.5751633986928104,
73,2,car,crv,667,819,484,572,152,88,0.7274725,12,30,11,0.5789473684210527,
74,2,car,crv,810,1001,490,585,191,95,0.9551184,9,30,11,0.4973821989528796,
75,2,car,crv,807,1006,489,583,199,94,0.9514729,12,60,11,0.4723618090452261,
0,2,car,crv,669,820,485,573,151,88,0.84929025,12,30,11,0.5827814569536424,
1,2,car,crv,667,819,483,574,152,91,0.80771464,12,30,11,-10791372.680904523,
2,2,car,crv,666,820,483,573,154,90,0.83617496,12,30,11,2.5509708737864076,
3,2,car,crv,668,821,484,574,153,90,0.911769,12,30,11,-10324438.079326924,
4,2,car,crv,667,820,484,575,153,91,0.85702145,12,30,11,0.5947712418300654,
5,2,car,crv,667,820,483,575,153,92,0.8377369,12,30,11,0.6013071895424836,
6,2,car,crv,667,819,483,574,152,91,0.7576286,12,30,11,0.5986842105263158,
7,2,car,crv,663,810,486,571,147,85,0.8805993,12,30,11,0.5782312925170068,
8,2,car,crv,667,820,484,574,153,90,0.7872868,12,30,11,0.5882352941176471,
9,2,car,crv,667,820,483,573,153,90,0.8686103,12,30,11,0.5882352941176471,
10,2,car,crv,666,820,484,575,154,91,0.8430035,12,30,11,0.5909090909090909,
11,2,car,crv,667,820,483,575,153,92,0.8195698,12,30,11,0.6013071895424836,
12,2,car,crv,667,820,483,575,153,92,0.87416166,12,30,11,0.6013071895424836,
13,2,car,crv,667,820,484,575,153,91,0.91537607,12,30,11,0.5947712418300654,
14,2,car,crv,666,819,483,575,153,92,0.87749106,12,30,11,-12236371.056980057,
15,2,car,crv,667,819,484,575,152,91,0.7623789,12,30,11,-12669516.867256638,
16,2,car,crv,663,810,485,569,147,84,0.7043501,12,30,11,-12744706.9347181,
17,2,car,crv,667,820,484,575,153,91,0.8218401,12,30,11,-13134453.40061162,
18,2,car,crv,668,819,483,574,151,91,0.8174212,12,30,11,-13765918.567307692,
19,2,car,crv,666,820,483,574,154,91,0.80471843,12,30,11,-13634813.587301588,
20,2,car,crv,667,820,483,575,153,92,0.8773953,12,30,11,-13591665.107594937,
21,2,car,crv,667,820,484,575,153,91,0.7467092,12,30,11,-16207419.275471698,
22,2,car,crv,667,820,484,575,153,91,0.8247261,12,30,11,-17043516.26190476,
23,2,car,crv,669,819,484,574,150,90,0.81360966,12,30,11,-18592927.83982684,
24,2,car,crv,667,820,483,576,153,93,0.73838603,12,30,11,-17248860.90763052,
25,2,car,crv,667,819,483,575,152,92,0.8015768,12,30,11,-13421769.275,
26,2,car,crv,667,820,484,574,153,90,0.68943864,12,30,11,0.5882352941176471,
27,2,car,crv,667,819,483,573,152,90,0.8037294,12,30,11,-13174742.81595092,
28,2,car,crv,663,809,486,569,146,83,0.7675451,12,30,11,-12897796.35135135,
29,2,car,crv,668,819,484,575,151,91,0.8577185,12,30,11,-12413197.066473989,
30,2,car,crv,669,820,484,574,151,90,0.7934381,12,30,11,0.5960264900662252,
31,2,car,crv,669,820,485,574,151,89,0.8260642,12,30,11,0.5894039735099338,
32,2,car,crv,668,819,484,573,151,89,0.8000626,12,30,11,0.5894039735099338,
33,2,car,crv,667,821,485,574,154,89,0.80527765,12,30,11,0.577922077922078,
34,2,car,crv,664,809,487,570,145,83,0.8104471,12,30,11,0.5724137931034483,
35,2,car,crv,662,810,486,569,148,83,0.8144621,12,30,11,0.5608108108108109,
36,2,car,crv,667,820,484,577,153,93,0.8308673,12,30,11,0.6078431372549019,
37,2,car,crv,667,820,483,575,153,92,0.84983456,12,30,11,0.6013071895424836,
38,2,car,crv,667,820,485,574,153,89,0.8510291,12,30,11,0.5816993464052288,
39,2,car,crv,662,810,486,570,148,84,0.7822179,12,30,11,0.5675675675675675,
40,2,car,crv,667,819,484,575,152,91,0.8101879,12,30,11,0.5986842105263158,
41,2,car,crv,664,809,487,570,145,83,0.77994776,12,30,11,0.5724137931034483,
42,2,car,crv,667,819,484,575,152,91,0.8454891,12,30,11,0.5986842105263158,
43,2,car,crv,667,819,483,575,152,92,0.8094451,12,30,11,1.5625,
44,2,car,crv,667,820,482,574,153,92,0.6722521,12,30,11,0.6013071895424836,
45,2,car,crv,667,819,484,574,152,90,0.8371277,12,30,11,0.5921052631578947,
46,2,car,crv,667,819,484,574,152,90,0.77298564,12,30,11,0.5921052631578947,
47,2,car,crv,667,817,484,574,150,90,0.66427475,12,30,11,0.6,
48,2,car,crv,667,819,483,574,152,91,0.79131705,12,30,11,0.5986842105263158,
49,2,car,crv,667,819,484,575,152,91,0.83604145,12,30,11,0.5986842105263158,
50,2,car,crv,668,819,484,574,151,90,0.7223766,12,30,11,0.5960264900662252,
51,2,car,crv,668,818,483,573,150,90,0.7379781,12,30,11,0.6,
52,2,car,crv,668,821,484,575,153,91,0.7870298,12,30,11,0.5947712418300654,
53,2,car,crv,667,820,484,575,153,91,0.8413766,12,30,11,0.5947712418300654,
54,2,car,crv,668,820,484,574,152,90,0.8056128,12,30,11,0.5921052631578947,
55,2,car,crv,667,820,483,575,153,92,0.66239387,12,30,11,0.6013071895424836,
56,2,car,crv,667,820,484,575,153,91,0.772995,12,30,11,0.5947712418300654,
57,2,car,crv,667,820,485,574,153,89,0.8488218,12,30,11,0.5816993464052288,
58,2,car,crv,667,820,484,575,153,91,0.78723717,12,30,11,0.5947712418300654,
59,2,car,crv,663,810,486,569,147,83,0.7781846,12,30,11,0.564625850340136,
60,2,car,crv,667,819,485,574,152,89,0.8128246,12,30,11,0.5855263157894737,
61,2,car,crv,666,820,482,577,154,95,0.80031437,9,0,11,0.6168831168831169,
62,2,car,crv,667,820,485,573,153,88,0.8438455,12,30,11,0.5751633986928104,
63,2,car,crv,667,819,484,575,152,91,0.9125865,12,30,11,0.5986842105263158,
64,2,car,crv,668,821,485,574,153,89,0.8785678,12,30,11,0.5816993464052288,
65,2,car,crv,667,819,485,574,152,89,0.71991515,12,30,11,0.5855263157894737,
66,2,car,crv,667,820,484,577,153,93,0.7404891,12,30,11,0.6078431372549019,
67,2,car,crv,667,819,484,575,152,91,0.7707914,12,30,11,0.5986842105263158,
68,2,car,crv,662,810,486,571,148,85,0.7150951,12,30,11,0.5743243243243243,
69,2,car,crv,669,820,485,574,151,89,0.83562523,12,30,11,0.5894039735099338,
70,2,car,crv,666,820,484,574,154,90,0.78819734,12,30,11,0.5844155844155844,
71,2,car,crv,667,819,483,575,152,92,0.8056975,12,30,11,0.6052631578947368,
72,2,car,crv,668,821,485,574,153,89,0.80433,12,30,11,0.5816993464052288,
73,2,car,crv,667,820,484,572,153,88,0.7759209,12,30,11,0.5751633986928104,
74,2,car,crv,667,819,484,572,152,88,0.7274725,12,30,11,0.5789473684210527,
75,2,car,crv,810,1001,490,585,191,95,0.9551184,9,30,11,0.4973821989528796,
76,2,car,crv,807,1006,489,583,199,94,0.9514729,12,60,11,0.4723618090452261,
