,cid,label,vehicle,left,right,top,bottom,width,height,score,distance_estimate,angle_estimate,real_distance,ratio,elapsed_time
0,2,car,crv,335,709,444,701,374,257,0.9452533,3,0,2,0.6871657754010695,
0,2,car,crv,336,711,446,700,375,254,0.9036748,3,0,2,0.6773333333333333,
1,2,car,crv,335,709,444,701,374,257,0.9452533,3,0,2,0.6871657754010695,
0,2,car,crv,334,710,446,701,376,255,0.92716336,3,0,2,0.6781914893617021,
1,2,car,crv,336,711,446,700,375,254,0.9036748,3,0,2,0.6773333333333333,
2,2,car,crv,335,709,444,701,374,257,0.9452533,3,0,2,0.6871657754010695,
0,2,car,crv,116,1322,388,811,1206,423,0.44209528,20,,2,1.28,
1,2,car,crv,241,764,450,741,523,291,0.8834957,20,,2,1.28,
2,2,car,crv,334,710,446,701,376,255,0.92716336,3,0,2,0.6781914893617021,
3,2,car,crv,336,711,446,700,375,254,0.9036748,3,0,2,0.6773333333333333,
4,2,car,crv,335,709,444,701,374,257,0.9452533,3,0,2,0.6871657754010695,
0,2,car,crv,119,1325,389,808,1206,419,0.46840343,20,,2,1.24,
1,2,car,crv,244,759,447,741,515,294,0.83414143,20,,2,1.24,
2,2,car,crv,116,1322,388,811,1206,423,0.44209528,20,,2,1.28,
3,2,car,crv,241,764,450,741,523,291,0.8834957,20,,2,1.28,
4,2,car,crv,334,710,446,701,376,255,0.92716336,3,0,2,0.6781914893617021,
5,2,car,crv,336,711,446,700,375,254,0.9036748,3,0,2,0.6773333333333333,
6,2,car,crv,335,709,444,701,374,257,0.9452533,3,0,2,0.6871657754010695,
0,2,car,crv,114,1318,387,813,1204,426,0.43434885,20,,2,1.2916666666666667,
1,2,car,crv,246,759,446,744,513,298,0.9186257,20,,2,1.2916666666666667,
2,2,car,crv,119,1325,389,808,1206,419,0.46840343,20,,2,1.24,
3,2,car,crv,244,759,447,741,515,294,0.83414143,20,,2,1.24,
4,2,car,crv,116,1322,388,811,1206,423,0.44209528,20,,2,1.28,
5,2,car,crv,241,764,450,741,523,291,0.8834957,20,,2,1.28,
6,2,car,crv,334,710,446,701,376,255,0.92716336,3,0,2,0.6781914893617021,
7,2,car,crv,336,711,446,700,375,254,0.9036748,3,0,2,0.6773333333333333,
8,2,car,crv,335,709,444,701,374,257,0.9452533,3,0,2,0.6871657754010695,
0,2,car,crv,119,1319,386,815,1200,429,0.44753623,20,,2,1.28,
1,2,car,crv,248,759,450,741,511,291,0.8263495,20,,2,1.28,
2,2,car,crv,114,1318,387,813,1204,426,0.43434885,20,,2,1.2916666666666667,
3,2,car,crv,246,759,446,744,513,298,0.9186257,20,,2,1.2916666666666667,
4,2,car,crv,119,1325,389,808,1206,419,0.46840343,20,,2,1.24,
5,2,car,crv,244,759,447,741,515,294,0.83414143,20,,2,1.24,
6,2,car,crv,116,1322,388,811,1206,423,0.44209528,20,,2,1.28,
7,2,car,crv,241,764,450,741,523,291,0.8834957,20,,2,1.28,
8,2,car,crv,334,710,446,701,376,255,0.92716336,3,0,2,0.6781914893617021,
9,2,car,crv,336,711,446,700,375,254,0.9036748,3,0,2,0.6773333333333333,
10,2,car,crv,335,709,444,701,374,257,0.9452533,3,0,2,0.6871657754010695,
0,2,car,crv,119,1322,385,815,1203,430,0.42900166,20,,2,1.24,
1,2,car,crv,246,762,447,741,516,294,0.790523,20,,2,1.24,
2,2,car,crv,119,1319,386,815,1200,429,0.44753623,20,,2,1.28,
3,2,car,crv,248,759,450,741,511,291,0.8263495,20,,2,1.28,
4,2,car,crv,114,1318,387,813,1204,426,0.43434885,20,,2,1.2916666666666667,
5,2,car,crv,246,759,446,744,513,298,0.9186257,20,,2,1.2916666666666667,
6,2,car,crv,119,1325,389,808,1206,419,0.46840343,20,,2,1.24,
7,2,car,crv,244,759,447,741,515,294,0.83414143,20,,2,1.24,
8,2,car,crv,116,1322,388,811,1206,423,0.44209528,20,,2,1.28,
9,2,car,crv,241,764,450,741,523,291,0.8834957,20,,2,1.28,
10,2,car,crv,334,710,446,701,376,255,0.92716336,3,0,2,0.6781914893617021,
11,2,car,crv,336,711,446,700,375,254,0.9036748,3,0,2,0.6773333333333333,
12,2,car,crv,335,709,444,701,374,257,0.9452533,3,0,2,0.6871657754010695,
0,2,car,crv,118,1319,389,813,1201,424,0.4023961,20,,2,1.28,
1,2,car,crv,243,757,448,743,514,295,0.94143236,20,,2,1.28,
2,2,car,crv,119,1322,385,815,1203,430,0.42900166,20,,2,1.24,
3,2,car,crv,246,762,447,741,516,294,0.790523,20,,2,1.24,
4,2,car,crv,119,1319,386,815,1200,429,0.44753623,20,,2,1.28,
5,2,car,crv,248,759,450,741,511,291,0.8263495,20,,2,1.28,
6,2,car,crv,114,1318,387,813,1204,426,0.43434885,20,,2,1.2916666666666667,
7,2,car,crv,246,759,446,744,513,298,0.9186257,20,,2,1.2916666666666667,
8,2,car,crv,119,1325,389,808,1206,419,0.46840343,20,,2,1.24,
9,2,car,crv,244,759,447,741,515,294,0.83414143,20,,2,1.24,
10,2,car,crv,116,1322,388,811,1206,423,0.44209528,20,,2,1.28,
11,2,car,crv,241,764,450,741,523,291,0.8834957,20,,2,1.28,
12,2,car,crv,334,710,446,701,376,255,0.92716336,3,0,2,0.6781914893617021,
13,2,car,crv,336,711,446,700,375,254,0.9036748,3,0,2,0.6773333333333333,
14,2,car,crv,335,709,444,701,374,257,0.9452533,3,0,2,0.6871657754010695,
0,2,car,crv,118,1312,389,813,1194,424,0.25691053,20,,2,0.35510887772194305,
1,2,car,crv,249,756,447,742,507,295,0.96910256,20,,2,0.35510887772194305,
2,2,car,crv,118,1319,389,813,1201,424,0.4023961,20,,2,1.28,
3,2,car,crv,243,757,448,743,514,295,0.94143236,20,,2,1.28,
4,2,car,crv,119,1322,385,815,1203,430,0.42900166,20,,2,1.24,
5,2,car,crv,246,762,447,741,516,294,0.790523,20,,2,1.24,
6,2,car,crv,119,1319,386,815,1200,429,0.44753623,20,,2,1.28,
7,2,car,crv,248,759,450,741,511,291,0.8263495,20,,2,1.28,
8,2,car,crv,114,1318,387,813,1204,426,0.43434885,20,,2,1.2916666666666667,
9,2,car,crv,246,759,446,744,513,298,0.9186257,20,,2,1.2916666666666667,
10,2,car,crv,119,1325,389,808,1206,419,0.46840343,20,,2,1.24,
11,2,car,crv,244,759,447,741,515,294,0.83414143,20,,2,1.24,
12,2,car,crv,116,1322,388,811,1206,423,0.44209528,20,,2,1.28,
13,2,car,crv,241,764,450,741,523,291,0.8834957,20,,2,1.28,
14,2,car,crv,334,710,446,701,376,255,0.92716336,3,0,2,0.6781914893617021,
15,2,car,crv,336,711,446,700,375,254,0.9036748,3,0,2,0.6773333333333333,
16,2,car,crv,335,709,444,701,374,257,0.9452533,3,0,2,0.6871657754010695,
0,2,car,crv,123,1315,388,811,1192,423,0.4968379,20,,2,1.24,
1,2,car,crv,246,758,446,743,512,297,0.87933147,20,,2,1.24,
2,2,car,crv,118,1312,389,813,1194,424,0.25691053,20,,2,0.35510887772194305,
3,2,car,crv,249,756,447,742,507,295,0.96910256,20,,2,0.35510887772194305,
4,2,car,crv,118,1319,389,813,1201,424,0.4023961,20,,2,1.28,
5,2,car,crv,243,757,448,743,514,295,0.94143236,20,,2,1.28,
6,2,car,crv,119,1322,385,815,1203,430,0.42900166,20,,2,1.24,
7,2,car,crv,246,762,447,741,516,294,0.790523,20,,2,1.24,
8,2,car,crv,119,1319,386,815,1200,429,0.44753623,20,,2,1.28,
9,2,car,crv,248,759,450,741,511,291,0.8263495,20,,2,1.28,
10,2,car,crv,114,1318,387,813,1204,426,0.43434885,20,,2,1.2916666666666667,
11,2,car,crv,246,759,446,744,513,298,0.9186257,20,,2,1.2916666666666667,
12,2,car,crv,119,1325,389,808,1206,419,0.46840343,20,,2,1.24,
13,2,car,crv,244,759,447,741,515,294,0.83414143,20,,2,1.24,
14,2,car,crv,116,1322,388,811,1206,423,0.44209528,20,,2,1.28,
15,2,car,crv,241,764,450,741,523,291,0.8834957,20,,2,1.28,
16,2,car,crv,334,710,446,701,376,255,0.92716336,3,0,2,0.6781914893617021,
17,2,car,crv,336,711,446,700,375,254,0.9036748,3,0,2,0.6773333333333333,
18,2,car,crv,335,709,444,701,374,257,0.9452533,3,0,2,0.6871657754010695,
0,2,car,crv,131,1307,388,812,1176,424,0.43397242,20,,2,1.2916666666666667,
1,2,car,crv,247,764,447,744,517,297,0.9014591,20,,2,1.2916666666666667,
2,2,car,crv,123,1315,388,811,1192,423,0.4968379,20,,2,1.24,
3,2,car,crv,246,758,446,743,512,297,0.87933147,20,,2,1.24,
4,2,car,crv,118,1312,389,813,1194,424,0.25691053,20,,2,0.35510887772194305,
5,2,car,crv,249,756,447,742,507,295,0.96910256,20,,2,0.35510887772194305,
6,2,car,crv,118,1319,389,813,1201,424,0.4023961,20,,2,1.28,
7,2,car,crv,243,757,448,743,514,295,0.94143236,20,,2,1.28,
8,2,car,crv,119,1322,385,815,1203,430,0.42900166,20,,2,1.24,
9,2,car,crv,246,762,447,741,516,294,0.790523,20,,2,1.24,
10,2,car,crv,119,1319,386,815,1200,429,0.44753623,20,,2,1.28,
11,2,car,crv,248,759,450,741,511,291,0.8263495,20,,2,1.28,
12,2,car,crv,114,1318,387,813,1204,426,0.43434885,20,,2,1.2916666666666667,
13,2,car,crv,246,759,446,744,513,298,0.9186257,20,,2,1.2916666666666667,
14,2,car,crv,119,1325,389,808,1206,419,0.46840343,20,,2,1.24,
15,2,car,crv,244,759,447,741,515,294,0.83414143,20,,2,1.24,
16,2,car,crv,116,1322,388,811,1206,423,0.44209528,20,,2,1.28,
17,2,car,crv,241,764,450,741,523,291,0.8834957,20,,2,1.28,
18,2,car,crv,334,710,446,701,376,255,0.92716336,3,0,2,0.6781914893617021,
19,2,car,crv,336,711,446,700,375,254,0.9036748,3,0,2,0.6773333333333333,
20,2,car,crv,335,709,444,701,374,257,0.9452533,3,0,2,0.6871657754010695,
0,2,car,crv,125,1312,392,805,1187,413,0.30284005,20,,2,1.24,
1,2,car,crv,245,760,447,739,515,292,0.9596912,20,,2,1.24,
2,2,car,crv,131,1307,388,812,1176,424,0.43397242,20,,2,1.2916666666666667,
3,2,car,crv,247,764,447,744,517,297,0.9014591,20,,2,1.2916666666666667,
4,2,car,crv,123,1315,388,811,1192,423,0.4968379,20,,2,1.24,
5,2,car,crv,246,758,446,743,512,297,0.87933147,20,,2,1.24,
6,2,car,crv,118,1312,389,813,1194,424,0.25691053,20,,2,0.35510887772194305,
7,2,car,crv,249,756,447,742,507,295,0.96910256,20,,2,0.35510887772194305,
8,2,car,crv,118,1319,389,813,1201,424,0.4023961,20,,2,1.28,
9,2,car,crv,243,757,448,743,514,295,0.94143236,20,,2,1.28,
10,2,car,crv,119,1322,385,815,1203,430,0.42900166,20,,2,1.24,
11,2,car,crv,246,762,447,741,516,294,0.790523,20,,2,1.24,
12,2,car,crv,119,1319,386,815,1200,429,0.44753623,20,,2,1.28,
13,2,car,crv,248,759,450,741,511,291,0.8263495,20,,2,1.28,
14,2,car,crv,114,1318,387,813,1204,426,0.43434885,20,,2,1.2916666666666667,
15,2,car,crv,246,759,446,744,513,298,0.9186257,20,,2,1.2916666666666667,
16,2,car,crv,119,1325,389,808,1206,419,0.46840343,20,,2,1.24,
17,2,car,crv,244,759,447,741,515,294,0.83414143,20,,2,1.24,
18,2,car,crv,116,1322,388,811,1206,423,0.44209528,20,,2,1.28,
19,2,car,crv,241,764,450,741,523,291,0.8834957,20,,2,1.28,
20,2,car,crv,334,710,446,701,376,255,0.92716336,3,0,2,0.6781914893617021,
21,2,car,crv,336,711,446,700,375,254,0.9036748,3,0,2,0.6773333333333333,
22,2,car,crv,335,709,444,701,374,257,0.9452533,3,0,2,0.6871657754010695,
0,2,car,crv,121,1316,389,809,1195,420,0.4096516,20,,2,1.24,
1,2,car,crv,244,761,447,742,517,295,0.9289579,20,,2,1.24,
2,2,car,crv,125,1312,392,805,1187,413,0.30284005,20,,2,1.24,
3,2,car,crv,245,760,447,739,515,292,0.9596912,20,,2,1.24,
4,2,car,crv,131,1307,388,812,1176,424,0.43397242,20,,2,1.2916666666666667,
5,2,car,crv,247,764,447,744,517,297,0.9014591,20,,2,1.2916666666666667,
6,2,car,crv,123,1315,388,811,1192,423,0.4968379,20,,2,1.24,
7,2,car,crv,246,758,446,743,512,297,0.87933147,20,,2,1.24,
8,2,car,crv,118,1312,389,813,1194,424,0.25691053,20,,2,0.35510887772194305,
9,2,car,crv,249,756,447,742,507,295,0.96910256,20,,2,0.35510887772194305,
10,2,car,crv,118,1319,389,813,1201,424,0.4023961,20,,2,1.28,
11,2,car,crv,243,757,448,743,514,295,0.94143236,20,,2,1.28,
12,2,car,crv,119,1322,385,815,1203,430,0.42900166,20,,2,1.24,
13,2,car,crv,246,762,447,741,516,294,0.790523,20,,2,1.24,
14,2,car,crv,119,1319,386,815,1200,429,0.44753623,20,,2,1.28,
15,2,car,crv,248,759,450,741,511,291,0.8263495,20,,2,1.28,
16,2,car,crv,114,1318,387,813,1204,426,0.43434885,20,,2,1.2916666666666667,
17,2,car,crv,246,759,446,744,513,298,0.9186257,20,,2,1.2916666666666667,
18,2,car,crv,119,1325,389,808,1206,419,0.46840343,20,,2,1.24,
19,2,car,crv,244,759,447,741,515,294,0.83414143,20,,2,1.24,
20,2,car,crv,116,1322,388,811,1206,423,0.44209528,20,,2,1.28,
21,2,car,crv,241,764,450,741,523,291,0.8834957,20,,2,1.28,
22,2,car,crv,334,710,446,701,376,255,0.92716336,3,0,2,0.6781914893617021,
23,2,car,crv,336,711,446,700,375,254,0.9036748,3,0,2,0.6773333333333333,
24,2,car,crv,335,709,444,701,374,257,0.9452533,3,0,2,0.6871657754010695,
0,2,car,crv,126,1312,388,815,1186,427,0.3965622,20,,2,1.24,
1,2,car,crv,252,758,446,743,506,297,0.9420341,20,,2,1.24,
2,2,car,crv,121,1316,389,809,1195,420,0.4096516,20,,2,1.24,
3,2,car,crv,244,761,447,742,517,295,0.9289579,20,,2,1.24,
4,2,car,crv,125,1312,392,805,1187,413,0.30284005,20,,2,1.24,
5,2,car,crv,245,760,447,739,515,292,0.9596912,20,,2,1.24,
6,2,car,crv,131,1307,388,812,1176,424,0.43397242,20,,2,1.2916666666666667,
7,2,car,crv,247,764,447,744,517,297,0.9014591,20,,2,1.2916666666666667,
8,2,car,crv,123,1315,388,811,1192,423,0.4968379,20,,2,1.24,
9,2,car,crv,246,758,446,743,512,297,0.87933147,20,,2,1.24,
10,2,car,crv,118,1312,389,813,1194,424,0.25691053,20,,2,0.35510887772194305,
11,2,car,crv,249,756,447,742,507,295,0.96910256,20,,2,0.35510887772194305,
12,2,car,crv,118,1319,389,813,1201,424,0.4023961,20,,2,1.28,
13,2,car,crv,243,757,448,743,514,295,0.94143236,20,,2,1.28,
14,2,car,crv,119,1322,385,815,1203,430,0.42900166,20,,2,1.24,
15,2,car,crv,246,762,447,741,516,294,0.790523,20,,2,1.24,
16,2,car,crv,119,1319,386,815,1200,429,0.44753623,20,,2,1.28,
17,2,car,crv,248,759,450,741,511,291,0.8263495,20,,2,1.28,
18,2,car,crv,114,1318,387,813,1204,426,0.43434885,20,,2,1.2916666666666667,
19,2,car,crv,246,759,446,744,513,298,0.9186257,20,,2,1.2916666666666667,
20,2,car,crv,119,1325,389,808,1206,419,0.46840343,20,,2,1.24,
21,2,car,crv,244,759,447,741,515,294,0.83414143,20,,2,1.24,
22,2,car,crv,116,1322,388,811,1206,423,0.44209528,20,,2,1.28,
23,2,car,crv,241,764,450,741,523,291,0.8834957,20,,2,1.28,
24,2,car,crv,334,710,446,701,376,255,0.92716336,3,0,2,0.6781914893617021,
25,2,car,crv,336,711,446,700,375,254,0.9036748,3,0,2,0.6773333333333333,
26,2,car,crv,335,709,444,701,374,257,0.9452533,3,0,2,0.6871657754010695,
0,2,car,crv,134,1300,387,818,1166,431,0.35928637,20,,2,1.28,
1,2,car,crv,251,757,447,743,506,296,0.9412378,20,,2,1.28,
2,2,car,crv,126,1312,388,815,1186,427,0.3965622,20,,2,1.24,
3,2,car,crv,252,758,446,743,506,297,0.9420341,20,,2,1.24,
4,2,car,crv,121,1316,389,809,1195,420,0.4096516,20,,2,1.24,
5,2,car,crv,244,761,447,742,517,295,0.9289579,20,,2,1.24,
6,2,car,crv,125,1312,392,805,1187,413,0.30284005,20,,2,1.24,
7,2,car,crv,245,760,447,739,515,292,0.9596912,20,,2,1.24,
8,2,car,crv,131,1307,388,812,1176,424,0.43397242,20,,2,1.2916666666666667,
9,2,car,crv,247,764,447,744,517,297,0.9014591,20,,2,1.2916666666666667,
10,2,car,crv,123,1315,388,811,1192,423,0.4968379,20,,2,1.24,
11,2,car,crv,246,758,446,743,512,297,0.87933147,20,,2,1.24,
12,2,car,crv,118,1312,389,813,1194,424,0.25691053,20,,2,0.35510887772194305,
13,2,car,crv,249,756,447,742,507,295,0.96910256,20,,2,0.35510887772194305,
14,2,car,crv,118,1319,389,813,1201,424,0.4023961,20,,2,1.28,
15,2,car,crv,243,757,448,743,514,295,0.94143236,20,,2,1.28,
16,2,car,crv,119,1322,385,815,1203,430,0.42900166,20,,2,1.24,
17,2,car,crv,246,762,447,741,516,294,0.790523,20,,2,1.24,
18,2,car,crv,119,1319,386,815,1200,429,0.44753623,20,,2,1.28,
19,2,car,crv,248,759,450,741,511,291,0.8263495,20,,2,1.28,
20,2,car,crv,114,1318,387,813,1204,426,0.43434885,20,,2,1.2916666666666667,
21,2,car,crv,246,759,446,744,513,298,0.9186257,20,,2,1.2916666666666667,
22,2,car,crv,119,1325,389,808,1206,419,0.46840343,20,,2,1.24,
23,2,car,crv,244,759,447,741,515,294,0.83414143,20,,2,1.24,
24,2,car,crv,116,1322,388,811,1206,423,0.44209528,20,,2,1.28,
25,2,car,crv,241,764,450,741,523,291,0.8834957,20,,2,1.28,
26,2,car,crv,334,710,446,701,376,255,0.92716336,3,0,2,0.6781914893617021,
27,2,car,crv,336,711,446,700,375,254,0.9036748,3,0,2,0.6773333333333333,
28,2,car,crv,335,709,444,701,374,257,0.9452533,3,0,2,0.6871657754010695,
0,2,car,crv,111,1317,390,811,1206,421,0.2941505,20,,2,0.3490878938640133,
1,2,car,crv,247,756,446,741,509,295,0.96245986,20,,2,0.3490878938640133,
2,2,car,crv,134,1300,387,818,1166,431,0.35928637,20,,2,1.28,
3,2,car,crv,251,757,447,743,506,296,0.9412378,20,,2,1.28,
4,2,car,crv,126,1312,388,815,1186,427,0.3965622,20,,2,1.24,
5,2,car,crv,252,758,446,743,506,297,0.9420341,20,,2,1.24,
6,2,car,crv,121,1316,389,809,1195,420,0.4096516,20,,2,1.24,
7,2,car,crv,244,761,447,742,517,295,0.9289579,20,,2,1.24,
8,2,car,crv,125,1312,392,805,1187,413,0.30284005,20,,2,1.24,
9,2,car,crv,245,760,447,739,515,292,0.9596912,20,,2,1.24,
10,2,car,crv,131,1307,388,812,1176,424,0.43397242,20,,2,1.2916666666666667,
11,2,car,crv,247,764,447,744,517,297,0.9014591,20,,2,1.2916666666666667,
12,2,car,crv,123,1315,388,811,1192,423,0.4968379,20,,2,1.24,
13,2,car,crv,246,758,446,743,512,297,0.87933147,20,,2,1.24,
14,2,car,crv,118,1312,389,813,1194,424,0.25691053,20,,2,0.35510887772194305,
15,2,car,crv,249,756,447,742,507,295,0.96910256,20,,2,0.35510887772194305,
16,2,car,crv,118,1319,389,813,1201,424,0.4023961,20,,2,1.28,
17,2,car,crv,243,757,448,743,514,295,0.94143236,20,,2,1.28,
18,2,car,crv,119,1322,385,815,1203,430,0.42900166,20,,2,1.24,
19,2,car,crv,246,762,447,741,516,294,0.790523,20,,2,1.24,
20,2,car,crv,119,1319,386,815,1200,429,0.44753623,20,,2,1.28,
21,2,car,crv,248,759,450,741,511,291,0.8263495,20,,2,1.28,
22,2,car,crv,114,1318,387,813,1204,426,0.43434885,20,,2,1.2916666666666667,
23,2,car,crv,246,759,446,744,513,298,0.9186257,20,,2,1.2916666666666667,
24,2,car,crv,119,1325,389,808,1206,419,0.46840343,20,,2,1.24,
25,2,car,crv,244,759,447,741,515,294,0.83414143,20,,2,1.24,
26,2,car,crv,116,1322,388,811,1206,423,0.44209528,20,,2,1.28,
27,2,car,crv,241,764,450,741,523,291,0.8834957,20,,2,1.28,
28,2,car,crv,334,710,446,701,376,255,0.92716336,3,0,2,0.6781914893617021,
29,2,car,crv,336,711,446,700,375,254,0.9036748,3,0,2,0.6773333333333333,
30,2,car,crv,335,709,444,701,374,257,0.9452533,3,0,2,0.6871657754010695,
0,2,car,crv,126,1309,390,814,1183,424,0.30222148,20,,2,1.2916666666666667,
1,2,car,crv,249,757,448,740,508,292,0.91383094,20,,2,1.2916666666666667,
2,2,car,crv,111,1317,390,811,1206,421,0.2941505,20,,2,0.3490878938640133,
3,2,car,crv,247,756,446,741,509,295,0.96245986,20,,2,0.3490878938640133,
4,2,car,crv,134,1300,387,818,1166,431,0.35928637,20,,2,1.28,
5,2,car,crv,251,757,447,743,506,296,0.9412378,20,,2,1.28,
6,2,car,crv,126,1312,388,815,1186,427,0.3965622,20,,2,1.24,
7,2,car,crv,252,758,446,743,506,297,0.9420341,20,,2,1.24,
8,2,car,crv,121,1316,389,809,1195,420,0.4096516,20,,2,1.24,
9,2,car,crv,244,761,447,742,517,295,0.9289579,20,,2,1.24,
10,2,car,crv,125,1312,392,805,1187,413,0.30284005,20,,2,1.24,
11,2,car,crv,245,760,447,739,515,292,0.9596912,20,,2,1.24,
12,2,car,crv,131,1307,388,812,1176,424,0.43397242,20,,2,1.2916666666666667,
13,2,car,crv,247,764,447,744,517,297,0.9014591,20,,2,1.2916666666666667,
14,2,car,crv,123,1315,388,811,1192,423,0.4968379,20,,2,1.24,
15,2,car,crv,246,758,446,743,512,297,0.87933147,20,,2,1.24,
16,2,car,crv,118,1312,389,813,1194,424,0.25691053,20,,2,0.35510887772194305,
17,2,car,crv,249,756,447,742,507,295,0.96910256,20,,2,0.35510887772194305,
18,2,car,crv,118,1319,389,813,1201,424,0.4023961,20,,2,1.28,
19,2,car,crv,243,757,448,743,514,295,0.94143236,20,,2,1.28,
20,2,car,crv,119,1322,385,815,1203,430,0.42900166,20,,2,1.24,
21,2,car,crv,246,762,447,741,516,294,0.790523,20,,2,1.24,
22,2,car,crv,119,1319,386,815,1200,429,0.44753623,20,,2,1.28,
23,2,car,crv,248,759,450,741,511,291,0.8263495,20,,2,1.28,
24,2,car,crv,114,1318,387,813,1204,426,0.43434885,20,,2,1.2916666666666667,
25,2,car,crv,246,759,446,744,513,298,0.9186257,20,,2,1.2916666666666667,
26,2,car,crv,119,1325,389,808,1206,419,0.46840343,20,,2,1.24,
27,2,car,crv,244,759,447,741,515,294,0.83414143,20,,2,1.24,
28,2,car,crv,116,1322,388,811,1206,423,0.44209528,20,,2,1.28,
29,2,car,crv,241,764,450,741,523,291,0.8834957,20,,2,1.28,
30,2,car,crv,334,710,446,701,376,255,0.92716336,3,0,2,0.6781914893617021,
31,2,car,crv,336,711,446,700,375,254,0.9036748,3,0,2,0.6773333333333333,
32,2,car,crv,335,709,444,701,374,257,0.9452533,3,0,2,0.6871657754010695,
0,2,car,crv,111,1317,390,812,1206,422,0.27479288,20,,2,0.34991708126036486,
1,2,car,crv,251,753,447,740,502,293,0.9438285,20,,2,0.34991708126036486,
2,2,car,crv,126,1309,390,814,1183,424,0.30222148,20,,2,1.2916666666666667,
3,2,car,crv,249,757,448,740,508,292,0.91383094,20,,2,1.2916666666666667,
4,2,car,crv,111,1317,390,811,1206,421,0.2941505,20,,2,0.3490878938640133,
5,2,car,crv,247,756,446,741,509,295,0.96245986,20,,2,0.3490878938640133,
6,2,car,crv,134,1300,387,818,1166,431,0.35928637,20,,2,1.28,
7,2,car,crv,251,757,447,743,506,296,0.9412378,20,,2,1.28,
8,2,car,crv,126,1312,388,815,1186,427,0.3965622,20,,2,1.24,
9,2,car,crv,252,758,446,743,506,297,0.9420341,20,,2,1.24,
10,2,car,crv,121,1316,389,809,1195,420,0.4096516,20,,2,1.24,
11,2,car,crv,244,761,447,742,517,295,0.9289579,20,,2,1.24,
12,2,car,crv,125,1312,392,805,1187,413,0.30284005,20,,2,1.24,
13,2,car,crv,245,760,447,739,515,292,0.9596912,20,,2,1.24,
14,2,car,crv,131,1307,388,812,1176,424,0.43397242,20,,2,1.2916666666666667,
15,2,car,crv,247,764,447,744,517,297,0.9014591,20,,2,1.2916666666666667,
16,2,car,crv,123,1315,388,811,1192,423,0.4968379,20,,2,1.24,
17,2,car,crv,246,758,446,743,512,297,0.87933147,20,,2,1.24,
18,2,car,crv,118,1312,389,813,1194,424,0.25691053,20,,2,0.35510887772194305,
19,2,car,crv,249,756,447,742,507,295,0.96910256,20,,2,0.35510887772194305,
20,2,car,crv,118,1319,389,813,1201,424,0.4023961,20,,2,1.28,
21,2,car,crv,243,757,448,743,514,295,0.94143236,20,,2,1.28,
22,2,car,crv,119,1322,385,815,1203,430,0.42900166,20,,2,1.24,
23,2,car,crv,246,762,447,741,516,294,0.790523,20,,2,1.24,
24,2,car,crv,119,1319,386,815,1200,429,0.44753623,20,,2,1.28,
25,2,car,crv,248,759,450,741,511,291,0.8263495,20,,2,1.28,
26,2,car,crv,114,1318,387,813,1204,426,0.43434885,20,,2,1.2916666666666667,
27,2,car,crv,246,759,446,744,513,298,0.9186257,20,,2,1.2916666666666667,
28,2,car,crv,119,1325,389,808,1206,419,0.46840343,20,,2,1.24,
29,2,car,crv,244,759,447,741,515,294,0.83414143,20,,2,1.24,
30,2,car,crv,116,1322,388,811,1206,423,0.44209528,20,,2,1.28,
31,2,car,crv,241,764,450,741,523,291,0.8834957,20,,2,1.28,
32,2,car,crv,334,710,446,701,376,255,0.92716336,3,0,2,0.6781914893617021,
33,2,car,crv,336,711,446,700,375,254,0.9036748,3,0,2,0.6773333333333333,
34,2,car,crv,335,709,444,701,374,257,0.9452533,3,0,2,0.6871657754010695,
0,2,car,crv,124,1305,387,820,1181,433,0.27402008,20,,2,0.36663844199830653,
1,2,car,crv,252,750,447,746,498,299,0.9501165,20,,2,0.36663844199830653,
2,2,car,crv,111,1317,390,812,1206,422,0.27479288,20,,2,0.34991708126036486,
3,2,car,crv,251,753,447,740,502,293,0.9438285,20,,2,0.34991708126036486,
4,2,car,crv,126,1309,390,814,1183,424,0.30222148,20,,2,1.2916666666666667,
5,2,car,crv,249,757,448,740,508,292,0.91383094,20,,2,1.2916666666666667,
6,2,car,crv,111,1317,390,811,1206,421,0.2941505,20,,2,0.3490878938640133,
7,2,car,crv,247,756,446,741,509,295,0.96245986,20,,2,0.3490878938640133,
8,2,car,crv,134,1300,387,818,1166,431,0.35928637,20,,2,1.28,
9,2,car,crv,251,757,447,743,506,296,0.9412378,20,,2,1.28,
10,2,car,crv,126,1312,388,815,1186,427,0.3965622,20,,2,1.24,
11,2,car,crv,252,758,446,743,506,297,0.9420341,20,,2,1.24,
12,2,car,crv,121,1316,389,809,1195,420,0.4096516,20,,2,1.24,
13,2,car,crv,244,761,447,742,517,295,0.9289579,20,,2,1.24,
14,2,car,crv,125,1312,392,805,1187,413,0.30284005,20,,2,1.24,
15,2,car,crv,245,760,447,739,515,292,0.9596912,20,,2,1.24,
16,2,car,crv,131,1307,388,812,1176,424,0.43397242,20,,2,1.2916666666666667,
17,2,car,crv,247,764,447,744,517,297,0.9014591,20,,2,1.2916666666666667,
18,2,car,crv,123,1315,388,811,1192,423,0.4968379,20,,2,1.24,
19,2,car,crv,246,758,446,743,512,297,0.87933147,20,,2,1.24,
20,2,car,crv,118,1312,389,813,1194,424,0.25691053,20,,2,0.35510887772194305,
21,2,car,crv,249,756,447,742,507,295,0.96910256,20,,2,0.35510887772194305,
22,2,car,crv,118,1319,389,813,1201,424,0.4023961,20,,2,1.28,
23,2,car,crv,243,757,448,743,514,295,0.94143236,20,,2,1.28,
24,2,car,crv,119,1322,385,815,1203,430,0.42900166,20,,2,1.24,
25,2,car,crv,246,762,447,741,516,294,0.790523,20,,2,1.24,
26,2,car,crv,119,1319,386,815,1200,429,0.44753623,20,,2,1.28,
27,2,car,crv,248,759,450,741,511,291,0.8263495,20,,2,1.28,
28,2,car,crv,114,1318,387,813,1204,426,0.43434885,20,,2,1.2916666666666667,
29,2,car,crv,246,759,446,744,513,298,0.9186257,20,,2,1.2916666666666667,
30,2,car,crv,119,1325,389,808,1206,419,0.46840343,20,,2,1.24,
31,2,car,crv,244,759,447,741,515,294,0.83414143,20,,2,1.24,
32,2,car,crv,116,1322,388,811,1206,423,0.44209528,20,,2,1.28,
33,2,car,crv,241,764,450,741,523,291,0.8834957,20,,2,1.28,
34,2,car,crv,334,710,446,701,376,255,0.92716336,3,0,2,0.6781914893617021,
35,2,car,crv,336,711,446,700,375,254,0.9036748,3,0,2,0.6773333333333333,
36,2,car,crv,335,709,444,701,374,257,0.9452533,3,0,2,0.6871657754010695,
0,2,car,crv,117,1313,388,818,1196,430,0.27251616,20,,2,0.3595317725752508,
1,2,car,crv,247,762,449,740,515,291,0.96550846,20,,2,0.3595317725752508,
2,2,car,crv,124,1305,387,820,1181,433,0.27402008,20,,2,0.36663844199830653,
3,2,car,crv,252,750,447,746,498,299,0.9501165,20,,2,0.36663844199830653,
4,2,car,crv,111,1317,390,812,1206,422,0.27479288,20,,2,0.34991708126036486,
5,2,car,crv,251,753,447,740,502,293,0.9438285,20,,2,0.34991708126036486,
6,2,car,crv,126,1309,390,814,1183,424,0.30222148,20,,2,1.2916666666666667,
7,2,car,crv,249,757,448,740,508,292,0.91383094,20,,2,1.2916666666666667,
8,2,car,crv,111,1317,390,811,1206,421,0.2941505,20,,2,0.3490878938640133,
9,2,car,crv,247,756,446,741,509,295,0.96245986,20,,2,0.3490878938640133,
10,2,car,crv,134,1300,387,818,1166,431,0.35928637,20,,2,1.28,
11,2,car,crv,251,757,447,743,506,296,0.9412378,20,,2,1.28,
12,2,car,crv,126,1312,388,815,1186,427,0.3965622,20,,2,1.24,
13,2,car,crv,252,758,446,743,506,297,0.9420341,20,,2,1.24,
14,2,car,crv,121,1316,389,809,1195,420,0.4096516,20,,2,1.24,
15,2,car,crv,244,761,447,742,517,295,0.9289579,20,,2,1.24,
16,2,car,crv,125,1312,392,805,1187,413,0.30284005,20,,2,1.24,
17,2,car,crv,245,760,447,739,515,292,0.9596912,20,,2,1.24,
18,2,car,crv,131,1307,388,812,1176,424,0.43397242,20,,2,1.2916666666666667,
19,2,car,crv,247,764,447,744,517,297,0.9014591,20,,2,1.2916666666666667,
20,2,car,crv,123,1315,388,811,1192,423,0.4968379,20,,2,1.24,
21,2,car,crv,246,758,446,743,512,297,0.87933147,20,,2,1.24,
22,2,car,crv,118,1312,389,813,1194,424,0.25691053,20,,2,0.35510887772194305,
23,2,car,crv,249,756,447,742,507,295,0.96910256,20,,2,0.35510887772194305,
24,2,car,crv,118,1319,389,813,1201,424,0.4023961,20,,2,1.28,
25,2,car,crv,243,757,448,743,514,295,0.94143236,20,,2,1.28,
26,2,car,crv,119,1322,385,815,1203,430,0.42900166,20,,2,1.24,
27,2,car,crv,246,762,447,741,516,294,0.790523,20,,2,1.24,
28,2,car,crv,119,1319,386,815,1200,429,0.44753623,20,,2,1.28,
29,2,car,crv,248,759,450,741,511,291,0.8263495,20,,2,1.28,
30,2,car,crv,114,1318,387,813,1204,426,0.43434885,20,,2,1.2916666666666667,
31,2,car,crv,246,759,446,744,513,298,0.9186257,20,,2,1.2916666666666667,
32,2,car,crv,119,1325,389,808,1206,419,0.46840343,20,,2,1.24,
33,2,car,crv,244,759,447,741,515,294,0.83414143,20,,2,1.24,
34,2,car,crv,116,1322,388,811,1206,423,0.44209528,20,,2,1.28,
35,2,car,crv,241,764,450,741,523,291,0.8834957,20,,2,1.28,
36,2,car,crv,334,710,446,701,376,255,0.92716336,3,0,2,0.6781914893617021,
37,2,car,crv,336,711,446,700,375,254,0.9036748,3,0,2,0.6773333333333333,
38,2,car,crv,335,709,444,701,374,257,0.9452533,3,0,2,0.6871657754010695,
0,2,car,crv,128,1307,388,817,1179,429,0.32914877,20,,2,1.2916666666666667,
1,2,car,crv,247,762,447,741,515,294,0.9441378,20,,2,1.2916666666666667,
2,2,car,crv,117,1313,388,818,1196,430,0.27251616,20,,2,0.3595317725752508,
3,2,car,crv,247,762,449,740,515,291,0.96550846,20,,2,0.3595317725752508,
4,2,car,crv,124,1305,387,820,1181,433,0.27402008,20,,2,0.36663844199830653,
5,2,car,crv,252,750,447,746,498,299,0.9501165,20,,2,0.36663844199830653,
6,2,car,crv,111,1317,390,812,1206,422,0.27479288,20,,2,0.34991708126036486,
7,2,car,crv,251,753,447,740,502,293,0.9438285,20,,2,0.34991708126036486,
8,2,car,crv,126,1309,390,814,1183,424,0.30222148,20,,2,1.2916666666666667,
9,2,car,crv,249,757,448,740,508,292,0.91383094,20,,2,1.2916666666666667,
10,2,car,crv,111,1317,390,811,1206,421,0.2941505,20,,2,0.3490878938640133,
11,2,car,crv,247,756,446,741,509,295,0.96245986,20,,2,0.3490878938640133,
12,2,car,crv,134,1300,387,818,1166,431,0.35928637,20,,2,1.28,
13,2,car,crv,251,757,447,743,506,296,0.9412378,20,,2,1.28,
14,2,car,crv,126,1312,388,815,1186,427,0.3965622,20,,2,1.24,
15,2,car,crv,252,758,446,743,506,297,0.9420341,20,,2,1.24,
16,2,car,crv,121,1316,389,809,1195,420,0.4096516,20,,2,1.24,
17,2,car,crv,244,761,447,742,517,295,0.9289579,20,,2,1.24,
18,2,car,crv,125,1312,392,805,1187,413,0.30284005,20,,2,1.24,
19,2,car,crv,245,760,447,739,515,292,0.9596912,20,,2,1.24,
20,2,car,crv,131,1307,388,812,1176,424,0.43397242,20,,2,1.2916666666666667,
21,2,car,crv,247,764,447,744,517,297,0.9014591,20,,2,1.2916666666666667,
22,2,car,crv,123,1315,388,811,1192,423,0.4968379,20,,2,1.24,
23,2,car,crv,246,758,446,743,512,297,0.87933147,20,,2,1.24,
24,2,car,crv,118,1312,389,813,1194,424,0.25691053,20,,2,0.35510887772194305,
25,2,car,crv,249,756,447,742,507,295,0.96910256,20,,2,0.35510887772194305,
26,2,car,crv,118,1319,389,813,1201,424,0.4023961,20,,2,1.28,
27,2,car,crv,243,757,448,743,514,295,0.94143236,20,,2,1.28,
28,2,car,crv,119,1322,385,815,1203,430,0.42900166,20,,2,1.24,
29,2,car,crv,246,762,447,741,516,294,0.790523,20,,2,1.24,
30,2,car,crv,119,1319,386,815,1200,429,0.44753623,20,,2,1.28,
31,2,car,crv,248,759,450,741,511,291,0.8263495,20,,2,1.28,
32,2,car,crv,114,1318,387,813,1204,426,0.43434885,20,,2,1.2916666666666667,
33,2,car,crv,246,759,446,744,513,298,0.9186257,20,,2,1.2916666666666667,
34,2,car,crv,119,1325,389,808,1206,419,0.46840343,20,,2,1.24,
35,2,car,crv,244,759,447,741,515,294,0.83414143,20,,2,1.24,
36,2,car,crv,116,1322,388,811,1206,423,0.44209528,20,,2,1.28,
37,2,car,crv,241,764,450,741,523,291,0.8834957,20,,2,1.28,
38,2,car,crv,334,710,446,701,376,255,0.92716336,3,0,2,0.6781914893617021,
39,2,car,crv,336,711,446,700,375,254,0.9036748,3,0,2,0.6773333333333333,
40,2,car,crv,335,709,444,701,374,257,0.9452533,3,0,2,0.6871657754010695,
0,2,car,crv,253,756,446,744,503,298,0.97629297,20,,2,1.24,
1,2,car,crv,128,1307,388,817,1179,429,0.32914877,20,,2,1.2916666666666667,
2,2,car,crv,247,762,447,741,515,294,0.9441378,20,,2,1.2916666666666667,
3,2,car,crv,117,1313,388,818,1196,430,0.27251616,20,,2,0.3595317725752508,
4,2,car,crv,247,762,449,740,515,291,0.96550846,20,,2,0.3595317725752508,
5,2,car,crv,124,1305,387,820,1181,433,0.27402008,20,,2,0.36663844199830653,
6,2,car,crv,252,750,447,746,498,299,0.9501165,20,,2,0.36663844199830653,
7,2,car,crv,111,1317,390,812,1206,422,0.27479288,20,,2,0.34991708126036486,
8,2,car,crv,251,753,447,740,502,293,0.9438285,20,,2,0.34991708126036486,
9,2,car,crv,126,1309,390,814,1183,424,0.30222148,20,,2,1.2916666666666667,
10,2,car,crv,249,757,448,740,508,292,0.91383094,20,,2,1.2916666666666667,
11,2,car,crv,111,1317,390,811,1206,421,0.2941505,20,,2,0.3490878938640133,
12,2,car,crv,247,756,446,741,509,295,0.96245986,20,,2,0.3490878938640133,
13,2,car,crv,134,1300,387,818,1166,431,0.35928637,20,,2,1.28,
14,2,car,crv,251,757,447,743,506,296,0.9412378,20,,2,1.28,
15,2,car,crv,126,1312,388,815,1186,427,0.3965622,20,,2,1.24,
16,2,car,crv,252,758,446,743,506,297,0.9420341,20,,2,1.24,
17,2,car,crv,121,1316,389,809,1195,420,0.4096516,20,,2,1.24,
18,2,car,crv,244,761,447,742,517,295,0.9289579,20,,2,1.24,
19,2,car,crv,125,1312,392,805,1187,413,0.30284005,20,,2,1.24,
20,2,car,crv,245,760,447,739,515,292,0.9596912,20,,2,1.24,
21,2,car,crv,131,1307,388,812,1176,424,0.43397242,20,,2,1.2916666666666667,
22,2,car,crv,247,764,447,744,517,297,0.9014591,20,,2,1.2916666666666667,
23,2,car,crv,123,1315,388,811,1192,423,0.4968379,20,,2,1.24,
24,2,car,crv,246,758,446,743,512,297,0.87933147,20,,2,1.24,
25,2,car,crv,118,1312,389,813,1194,424,0.25691053,20,,2,0.35510887772194305,
26,2,car,crv,249,756,447,742,507,295,0.96910256,20,,2,0.35510887772194305,
27,2,car,crv,118,1319,389,813,1201,424,0.4023961,20,,2,1.28,
28,2,car,crv,243,757,448,743,514,295,0.94143236,20,,2,1.28,
29,2,car,crv,119,1322,385,815,1203,430,0.42900166,20,,2,1.24,
30,2,car,crv,246,762,447,741,516,294,0.790523,20,,2,1.24,
31,2,car,crv,119,1319,386,815,1200,429,0.44753623,20,,2,1.28,
32,2,car,crv,248,759,450,741,511,291,0.8263495,20,,2,1.28,
33,2,car,crv,114,1318,387,813,1204,426,0.43434885,20,,2,1.2916666666666667,
34,2,car,crv,246,759,446,744,513,298,0.9186257,20,,2,1.2916666666666667,
35,2,car,crv,119,1325,389,808,1206,419,0.46840343,20,,2,1.24,
36,2,car,crv,244,759,447,741,515,294,0.83414143,20,,2,1.24,
37,2,car,crv,116,1322,388,811,1206,423,0.44209528,20,,2,1.28,
38,2,car,crv,241,764,450,741,523,291,0.8834957,20,,2,1.28,
39,2,car,crv,334,710,446,701,376,255,0.92716336,3,0,2,0.6781914893617021,
40,2,car,crv,336,711,446,700,375,254,0.9036748,3,0,2,0.6773333333333333,
41,2,car,crv,335,709,444,701,374,257,0.9452533,3,0,2,0.6871657754010695,
0,2,car,crv,129,1303,386,819,1174,433,0.2341652,20,,2,0.368824531516184,
1,2,car,crv,252,756,447,744,504,297,0.9354642,20,,2,0.368824531516184,
2,2,car,crv,253,756,446,744,503,298,0.97629297,20,,2,1.24,
3,2,car,crv,128,1307,388,817,1179,429,0.32914877,20,,2,1.2916666666666667,
4,2,car,crv,247,762,447,741,515,294,0.9441378,20,,2,1.2916666666666667,
5,2,car,crv,117,1313,388,818,1196,430,0.27251616,20,,2,0.3595317725752508,
6,2,car,crv,247,762,449,740,515,291,0.96550846,20,,2,0.3595317725752508,
7,2,car,crv,124,1305,387,820,1181,433,0.27402008,20,,2,0.36663844199830653,
8,2,car,crv,252,750,447,746,498,299,0.9501165,20,,2,0.36663844199830653,
9,2,car,crv,111,1317,390,812,1206,422,0.27479288,20,,2,0.34991708126036486,
10,2,car,crv,251,753,447,740,502,293,0.9438285,20,,2,0.34991708126036486,
11,2,car,crv,126,1309,390,814,1183,424,0.30222148,20,,2,1.2916666666666667,
12,2,car,crv,249,757,448,740,508,292,0.91383094,20,,2,1.2916666666666667,
13,2,car,crv,111,1317,390,811,1206,421,0.2941505,20,,2,0.3490878938640133,
14,2,car,crv,247,756,446,741,509,295,0.96245986,20,,2,0.3490878938640133,
15,2,car,crv,134,1300,387,818,1166,431,0.35928637,20,,2,1.28,
16,2,car,crv,251,757,447,743,506,296,0.9412378,20,,2,1.28,
17,2,car,crv,126,1312,388,815,1186,427,0.3965622,20,,2,1.24,
18,2,car,crv,252,758,446,743,506,297,0.9420341,20,,2,1.24,
19,2,car,crv,121,1316,389,809,1195,420,0.4096516,20,,2,1.24,
20,2,car,crv,244,761,447,742,517,295,0.9289579,20,,2,1.24,
21,2,car,crv,125,1312,392,805,1187,413,0.30284005,20,,2,1.24,
22,2,car,crv,245,760,447,739,515,292,0.9596912,20,,2,1.24,
23,2,car,crv,131,1307,388,812,1176,424,0.43397242,20,,2,1.2916666666666667,
24,2,car,crv,247,764,447,744,517,297,0.9014591,20,,2,1.2916666666666667,
25,2,car,crv,123,1315,388,811,1192,423,0.4968379,20,,2,1.24,
26,2,car,crv,246,758,446,743,512,297,0.87933147,20,,2,1.24,
27,2,car,crv,118,1312,389,813,1194,424,0.25691053,20,,2,0.35510887772194305,
28,2,car,crv,249,756,447,742,507,295,0.96910256,20,,2,0.35510887772194305,
29,2,car,crv,118,1319,389,813,1201,424,0.4023961,20,,2,1.28,
30,2,car,crv,243,757,448,743,514,295,0.94143236,20,,2,1.28,
31,2,car,crv,119,1322,385,815,1203,430,0.42900166,20,,2,1.24,
32,2,car,crv,246,762,447,741,516,294,0.790523,20,,2,1.24,
33,2,car,crv,119,1319,386,815,1200,429,0.44753623,20,,2,1.28,
34,2,car,crv,248,759,450,741,511,291,0.8263495,20,,2,1.28,
35,2,car,crv,114,1318,387,813,1204,426,0.43434885,20,,2,1.2916666666666667,
36,2,car,crv,246,759,446,744,513,298,0.9186257,20,,2,1.2916666666666667,
37,2,car,crv,119,1325,389,808,1206,419,0.46840343,20,,2,1.24,
38,2,car,crv,244,759,447,741,515,294,0.83414143,20,,2,1.24,
39,2,car,crv,116,1322,388,811,1206,423,0.44209528,20,,2,1.28,
40,2,car,crv,241,764,450,741,523,291,0.8834957,20,,2,1.28,
41,2,car,crv,334,710,446,701,376,255,0.92716336,3,0,2,0.6781914893617021,
42,2,car,crv,336,711,446,700,375,254,0.9036748,3,0,2,0.6773333333333333,
43,2,car,crv,335,709,444,701,374,257,0.9452533,3,0,2,0.6871657754010695,
0,2,car,crv,122,1312,391,808,1190,417,0.34383425,20,,2,1.28,
1,2,car,crv,248,755,446,741,507,295,0.90284395,20,,2,1.28,
2,2,car,crv,129,1303,386,819,1174,433,0.2341652,20,,2,0.368824531516184,
3,2,car,crv,252,756,447,744,504,297,0.9354642,20,,2,0.368824531516184,
4,2,car,crv,253,756,446,744,503,298,0.97629297,20,,2,1.24,
5,2,car,crv,128,1307,388,817,1179,429,0.32914877,20,,2,1.2916666666666667,
6,2,car,crv,247,762,447,741,515,294,0.9441378,20,,2,1.2916666666666667,
7,2,car,crv,117,1313,388,818,1196,430,0.27251616,20,,2,0.3595317725752508,
8,2,car,crv,247,762,449,740,515,291,0.96550846,20,,2,0.3595317725752508,
9,2,car,crv,124,1305,387,820,1181,433,0.27402008,20,,2,0.36663844199830653,
10,2,car,crv,252,750,447,746,498,299,0.9501165,20,,2,0.36663844199830653,
11,2,car,crv,111,1317,390,812,1206,422,0.27479288,20,,2,0.34991708126036486,
12,2,car,crv,251,753,447,740,502,293,0.9438285,20,,2,0.34991708126036486,
13,2,car,crv,126,1309,390,814,1183,424,0.30222148,20,,2,1.2916666666666667,
14,2,car,crv,249,757,448,740,508,292,0.91383094,20,,2,1.2916666666666667,
15,2,car,crv,111,1317,390,811,1206,421,0.2941505,20,,2,0.3490878938640133,
16,2,car,crv,247,756,446,741,509,295,0.96245986,20,,2,0.3490878938640133,
17,2,car,crv,134,1300,387,818,1166,431,0.35928637,20,,2,1.28,
18,2,car,crv,251,757,447,743,506,296,0.9412378,20,,2,1.28,
19,2,car,crv,126,1312,388,815,1186,427,0.3965622,20,,2,1.24,
20,2,car,crv,252,758,446,743,506,297,0.9420341,20,,2,1.24,
21,2,car,crv,121,1316,389,809,1195,420,0.4096516,20,,2,1.24,
22,2,car,crv,244,761,447,742,517,295,0.9289579,20,,2,1.24,
23,2,car,crv,125,1312,392,805,1187,413,0.30284005,20,,2,1.24,
24,2,car,crv,245,760,447,739,515,292,0.9596912,20,,2,1.24,
25,2,car,crv,131,1307,388,812,1176,424,0.43397242,20,,2,1.2916666666666667,
26,2,car,crv,247,764,447,744,517,297,0.9014591,20,,2,1.2916666666666667,
27,2,car,crv,123,1315,388,811,1192,423,0.4968379,20,,2,1.24,
28,2,car,crv,246,758,446,743,512,297,0.87933147,20,,2,1.24,
29,2,car,crv,118,1312,389,813,1194,424,0.25691053,20,,2,0.35510887772194305,
30,2,car,crv,249,756,447,742,507,295,0.96910256,20,,2,0.35510887772194305,
31,2,car,crv,118,1319,389,813,1201,424,0.4023961,20,,2,1.28,
32,2,car,crv,243,757,448,743,514,295,0.94143236,20,,2,1.28,
33,2,car,crv,119,1322,385,815,1203,430,0.42900166,20,,2,1.24,
34,2,car,crv,246,762,447,741,516,294,0.790523,20,,2,1.24,
35,2,car,crv,119,1319,386,815,1200,429,0.44753623,20,,2,1.28,
36,2,car,crv,248,759,450,741,511,291,0.8263495,20,,2,1.28,
37,2,car,crv,114,1318,387,813,1204,426,0.43434885,20,,2,1.2916666666666667,
38,2,car,crv,246,759,446,744,513,298,0.9186257,20,,2,1.2916666666666667,
39,2,car,crv,119,1325,389,808,1206,419,0.46840343,20,,2,1.24,
40,2,car,crv,244,759,447,741,515,294,0.83414143,20,,2,1.24,
41,2,car,crv,116,1322,388,811,1206,423,0.44209528,20,,2,1.28,
42,2,car,crv,241,764,450,741,523,291,0.8834957,20,,2,1.28,
43,2,car,crv,334,710,446,701,376,255,0.92716336,3,0,2,0.6781914893617021,
44,2,car,crv,336,711,446,700,375,254,0.9036748,3,0,2,0.6773333333333333,
45,2,car,crv,335,709,444,701,374,257,0.9452533,3,0,2,0.6871657754010695,
0,2,car,crv,122,1311,385,813,1189,428,0.35830083,20,,2,1.24,
1,2,car,crv,246,757,442,746,511,304,0.9668414,20,,2,1.24,
2,2,car,crv,122,1312,391,808,1190,417,0.34383425,20,,2,1.28,
3,2,car,crv,248,755,446,741,507,295,0.90284395,20,,2,1.28,
4,2,car,crv,129,1303,386,819,1174,433,0.2341652,20,,2,0.368824531516184,
5,2,car,crv,252,756,447,744,504,297,0.9354642,20,,2,0.368824531516184,
6,2,car,crv,253,756,446,744,503,298,0.97629297,20,,2,1.24,
7,2,car,crv,128,1307,388,817,1179,429,0.32914877,20,,2,1.2916666666666667,
8,2,car,crv,247,762,447,741,515,294,0.9441378,20,,2,1.2916666666666667,
9,2,car,crv,117,1313,388,818,1196,430,0.27251616,20,,2,0.3595317725752508,
10,2,car,crv,247,762,449,740,515,291,0.96550846,20,,2,0.3595317725752508,
11,2,car,crv,124,1305,387,820,1181,433,0.27402008,20,,2,0.36663844199830653,
12,2,car,crv,252,750,447,746,498,299,0.9501165,20,,2,0.36663844199830653,
13,2,car,crv,111,1317,390,812,1206,422,0.27479288,20,,2,0.34991708126036486,
14,2,car,crv,251,753,447,740,502,293,0.9438285,20,,2,0.34991708126036486,
15,2,car,crv,126,1309,390,814,1183,424,0.30222148,20,,2,1.2916666666666667,
16,2,car,crv,249,757,448,740,508,292,0.91383094,20,,2,1.2916666666666667,
17,2,car,crv,111,1317,390,811,1206,421,0.2941505,20,,2,0.3490878938640133,
18,2,car,crv,247,756,446,741,509,295,0.96245986,20,,2,0.3490878938640133,
19,2,car,crv,134,1300,387,818,1166,431,0.35928637,20,,2,1.28,
20,2,car,crv,251,757,447,743,506,296,0.9412378,20,,2,1.28,
21,2,car,crv,126,1312,388,815,1186,427,0.3965622,20,,2,1.24,
22,2,car,crv,252,758,446,743,506,297,0.9420341,20,,2,1.24,
23,2,car,crv,121,1316,389,809,1195,420,0.4096516,20,,2,1.24,
24,2,car,crv,244,761,447,742,517,295,0.9289579,20,,2,1.24,
25,2,car,crv,125,1312,392,805,1187,413,0.30284005,20,,2,1.24,
26,2,car,crv,245,760,447,739,515,292,0.9596912,20,,2,1.24,
27,2,car,crv,131,1307,388,812,1176,424,0.43397242,20,,2,1.2916666666666667,
28,2,car,crv,247,764,447,744,517,297,0.9014591,20,,2,1.2916666666666667,
29,2,car,crv,123,1315,388,811,1192,423,0.4968379,20,,2,1.24,
30,2,car,crv,246,758,446,743,512,297,0.87933147,20,,2,1.24,
31,2,car,crv,118,1312,389,813,1194,424,0.25691053,20,,2,0.35510887772194305,
32,2,car,crv,249,756,447,742,507,295,0.96910256,20,,2,0.35510887772194305,
33,2,car,crv,118,1319,389,813,1201,424,0.4023961,20,,2,1.28,
34,2,car,crv,243,757,448,743,514,295,0.94143236,20,,2,1.28,
35,2,car,crv,119,1322,385,815,1203,430,0.42900166,20,,2,1.24,
36,2,car,crv,246,762,447,741,516,294,0.790523,20,,2,1.24,
37,2,car,crv,119,1319,386,815,1200,429,0.44753623,20,,2,1.28,
38,2,car,crv,248,759,450,741,511,291,0.8263495,20,,2,1.28,
39,2,car,crv,114,1318,387,813,1204,426,0.43434885,20,,2,1.2916666666666667,
40,2,car,crv,246,759,446,744,513,298,0.9186257,20,,2,1.2916666666666667,
41,2,car,crv,119,1325,389,808,1206,419,0.46840343,20,,2,1.24,
42,2,car,crv,244,759,447,741,515,294,0.83414143,20,,2,1.24,
43,2,car,crv,116,1322,388,811,1206,423,0.44209528,20,,2,1.28,
44,2,car,crv,241,764,450,741,523,291,0.8834957,20,,2,1.28,
45,2,car,crv,334,710,446,701,376,255,0.92716336,3,0,2,0.6781914893617021,
46,2,car,crv,336,711,446,700,375,254,0.9036748,3,0,2,0.6773333333333333,
47,2,car,crv,335,709,444,701,374,257,0.9452533,3,0,2,0.6871657754010695,
0,2,car,crv,129,1303,389,814,1174,425,0.27334884,20,,2,1.28,
1,2,car,crv,247,760,448,741,513,293,0.9333165,20,,2,1.28,
2,2,car,crv,122,1311,385,813,1189,428,0.35830083,20,,2,1.24,
3,2,car,crv,246,757,442,746,511,304,0.9668414,20,,2,1.24,
4,2,car,crv,122,1312,391,808,1190,417,0.34383425,20,,2,1.28,
5,2,car,crv,248,755,446,741,507,295,0.90284395,20,,2,1.28,
6,2,car,crv,129,1303,386,819,1174,433,0.2341652,20,,2,0.368824531516184,
7,2,car,crv,252,756,447,744,504,297,0.9354642,20,,2,0.368824531516184,
8,2,car,crv,253,756,446,744,503,298,0.97629297,20,,2,1.24,
9,2,car,crv,128,1307,388,817,1179,429,0.32914877,20,,2,1.2916666666666667,
10,2,car,crv,247,762,447,741,515,294,0.9441378,20,,2,1.2916666666666667,
11,2,car,crv,117,1313,388,818,1196,430,0.27251616,20,,2,0.3595317725752508,
12,2,car,crv,247,762,449,740,515,291,0.96550846,20,,2,0.3595317725752508,
13,2,car,crv,124,1305,387,820,1181,433,0.27402008,20,,2,0.36663844199830653,
14,2,car,crv,252,750,447,746,498,299,0.9501165,20,,2,0.36663844199830653,
15,2,car,crv,111,1317,390,812,1206,422,0.27479288,20,,2,0.34991708126036486,
16,2,car,crv,251,753,447,740,502,293,0.9438285,20,,2,0.34991708126036486,
17,2,car,crv,126,1309,390,814,1183,424,0.30222148,20,,2,1.2916666666666667,
18,2,car,crv,249,757,448,740,508,292,0.91383094,20,,2,1.2916666666666667,
19,2,car,crv,111,1317,390,811,1206,421,0.2941505,20,,2,0.3490878938640133,
20,2,car,crv,247,756,446,741,509,295,0.96245986,20,,2,0.3490878938640133,
21,2,car,crv,134,1300,387,818,1166,431,0.35928637,20,,2,1.28,
22,2,car,crv,251,757,447,743,506,296,0.9412378,20,,2,1.28,
23,2,car,crv,126,1312,388,815,1186,427,0.3965622,20,,2,1.24,
24,2,car,crv,252,758,446,743,506,297,0.9420341,20,,2,1.24,
25,2,car,crv,121,1316,389,809,1195,420,0.4096516,20,,2,1.24,
26,2,car,crv,244,761,447,742,517,295,0.9289579,20,,2,1.24,
27,2,car,crv,125,1312,392,805,1187,413,0.30284005,20,,2,1.24,
28,2,car,crv,245,760,447,739,515,292,0.9596912,20,,2,1.24,
29,2,car,crv,131,1307,388,812,1176,424,0.43397242,20,,2,1.2916666666666667,
30,2,car,crv,247,764,447,744,517,297,0.9014591,20,,2,1.2916666666666667,
31,2,car,crv,123,1315,388,811,1192,423,0.4968379,20,,2,1.24,
32,2,car,crv,246,758,446,743,512,297,0.87933147,20,,2,1.24,
33,2,car,crv,118,1312,389,813,1194,424,0.25691053,20,,2,0.35510887772194305,
34,2,car,crv,249,756,447,742,507,295,0.96910256,20,,2,0.35510887772194305,
35,2,car,crv,118,1319,389,813,1201,424,0.4023961,20,,2,1.28,
36,2,car,crv,243,757,448,743,514,295,0.94143236,20,,2,1.28,
37,2,car,crv,119,1322,385,815,1203,430,0.42900166,20,,2,1.24,
38,2,car,crv,246,762,447,741,516,294,0.790523,20,,2,1.24,
39,2,car,crv,119,1319,386,815,1200,429,0.44753623,20,,2,1.28,
40,2,car,crv,248,759,450,741,511,291,0.8263495,20,,2,1.28,
41,2,car,crv,114,1318,387,813,1204,426,0.43434885,20,,2,1.2916666666666667,
42,2,car,crv,246,759,446,744,513,298,0.9186257,20,,2,1.2916666666666667,
43,2,car,crv,119,1325,389,808,1206,419,0.46840343,20,,2,1.24,
44,2,car,crv,244,759,447,741,515,294,0.83414143,20,,2,1.24,
45,2,car,crv,116,1322,388,811,1206,423,0.44209528,20,,2,1.28,
46,2,car,crv,241,764,450,741,523,291,0.8834957,20,,2,1.28,
47,2,car,crv,334,710,446,701,376,255,0.92716336,3,0,2,0.6781914893617021,
48,2,car,crv,336,711,446,700,375,254,0.9036748,3,0,2,0.6773333333333333,
49,2,car,crv,335,709,444,701,374,257,0.9452533,3,0,2,0.6871657754010695,
0,2,car,crv,122,1310,388,817,1188,429,0.29904467,20,,2,0.3611111111111111,
1,2,car,crv,250,760,448,741,510,293,0.927252,20,,2,0.3611111111111111,
2,2,car,crv,129,1303,389,814,1174,425,0.27334884,20,,2,1.28,
3,2,car,crv,247,760,448,741,513,293,0.9333165,20,,2,1.28,
4,2,car,crv,122,1311,385,813,1189,428,0.35830083,20,,2,1.24,
5,2,car,crv,246,757,442,746,511,304,0.9668414,20,,2,1.24,
6,2,car,crv,122,1312,391,808,1190,417,0.34383425,20,,2,1.28,
7,2,car,crv,248,755,446,741,507,295,0.90284395,20,,2,1.28,
8,2,car,crv,129,1303,386,819,1174,433,0.2341652,20,,2,0.368824531516184,
9,2,car,crv,252,756,447,744,504,297,0.9354642,20,,2,0.368824531516184,
10,2,car,crv,253,756,446,744,503,298,0.97629297,20,,2,1.24,
11,2,car,crv,128,1307,388,817,1179,429,0.32914877,20,,2,1.2916666666666667,
12,2,car,crv,247,762,447,741,515,294,0.9441378,20,,2,1.2916666666666667,
13,2,car,crv,117,1313,388,818,1196,430,0.27251616,20,,2,0.3595317725752508,
14,2,car,crv,247,762,449,740,515,291,0.96550846,20,,2,0.3595317725752508,
15,2,car,crv,124,1305,387,820,1181,433,0.27402008,20,,2,0.36663844199830653,
16,2,car,crv,252,750,447,746,498,299,0.9501165,20,,2,0.36663844199830653,
17,2,car,crv,111,1317,390,812,1206,422,0.27479288,20,,2,0.34991708126036486,
18,2,car,crv,251,753,447,740,502,293,0.9438285,20,,2,0.34991708126036486,
19,2,car,crv,126,1309,390,814,1183,424,0.30222148,20,,2,1.2916666666666667,
20,2,car,crv,249,757,448,740,508,292,0.91383094,20,,2,1.2916666666666667,
21,2,car,crv,111,1317,390,811,1206,421,0.2941505,20,,2,0.3490878938640133,
22,2,car,crv,247,756,446,741,509,295,0.96245986,20,,2,0.3490878938640133,
23,2,car,crv,134,1300,387,818,1166,431,0.35928637,20,,2,1.28,
24,2,car,crv,251,757,447,743,506,296,0.9412378,20,,2,1.28,
25,2,car,crv,126,1312,388,815,1186,427,0.3965622,20,,2,1.24,
26,2,car,crv,252,758,446,743,506,297,0.9420341,20,,2,1.24,
27,2,car,crv,121,1316,389,809,1195,420,0.4096516,20,,2,1.24,
28,2,car,crv,244,761,447,742,517,295,0.9289579,20,,2,1.24,
29,2,car,crv,125,1312,392,805,1187,413,0.30284005,20,,2,1.24,
30,2,car,crv,245,760,447,739,515,292,0.9596912,20,,2,1.24,
31,2,car,crv,131,1307,388,812,1176,424,0.43397242,20,,2,1.2916666666666667,
32,2,car,crv,247,764,447,744,517,297,0.9014591,20,,2,1.2916666666666667,
33,2,car,crv,123,1315,388,811,1192,423,0.4968379,20,,2,1.24,
34,2,car,crv,246,758,446,743,512,297,0.87933147,20,,2,1.24,
35,2,car,crv,118,1312,389,813,1194,424,0.25691053,20,,2,0.35510887772194305,
36,2,car,crv,249,756,447,742,507,295,0.96910256,20,,2,0.35510887772194305,
37,2,car,crv,118,1319,389,813,1201,424,0.4023961,20,,2,1.28,
38,2,car,crv,243,757,448,743,514,295,0.94143236,20,,2,1.28,
39,2,car,crv,119,1322,385,815,1203,430,0.42900166,20,,2,1.24,
40,2,car,crv,246,762,447,741,516,294,0.790523,20,,2,1.24,
41,2,car,crv,119,1319,386,815,1200,429,0.44753623,20,,2,1.28,
42,2,car,crv,248,759,450,741,511,291,0.8263495,20,,2,1.28,
43,2,car,crv,114,1318,387,813,1204,426,0.43434885,20,,2,1.2916666666666667,
44,2,car,crv,246,759,446,744,513,298,0.9186257,20,,2,1.2916666666666667,
45,2,car,crv,119,1325,389,808,1206,419,0.46840343,20,,2,1.24,
46,2,car,crv,244,759,447,741,515,294,0.83414143,20,,2,1.24,
47,2,car,crv,116,1322,388,811,1206,423,0.44209528,20,,2,1.28,
48,2,car,crv,241,764,450,741,523,291,0.8834957,20,,2,1.28,
49,2,car,crv,334,710,446,701,376,255,0.92716336,3,0,2,0.6781914893617021,
50,2,car,crv,336,711,446,700,375,254,0.9036748,3,0,2,0.6773333333333333,
51,2,car,crv,335,709,444,701,374,257,0.9452533,3,0,2,0.6871657754010695,
0,2,car,crv,109,1315,384,827,1206,443,0.2820505,20,,2,1.24,
1,2,car,crv,249,758,449,736,509,287,0.91024953,20,,2,1.24,
2,2,car,crv,122,1310,388,817,1188,429,0.29904467,20,,2,0.3611111111111111,
3,2,car,crv,250,760,448,741,510,293,0.927252,20,,2,0.3611111111111111,
4,2,car,crv,129,1303,389,814,1174,425,0.27334884,20,,2,1.28,
5,2,car,crv,247,760,448,741,513,293,0.9333165,20,,2,1.28,
6,2,car,crv,122,1311,385,813,1189,428,0.35830083,20,,2,1.24,
7,2,car,crv,246,757,442,746,511,304,0.9668414,20,,2,1.24,
8,2,car,crv,122,1312,391,808,1190,417,0.34383425,20,,2,1.28,
9,2,car,crv,248,755,446,741,507,295,0.90284395,20,,2,1.28,
10,2,car,crv,129,1303,386,819,1174,433,0.2341652,20,,2,0.368824531516184,
11,2,car,crv,252,756,447,744,504,297,0.9354642,20,,2,0.368824531516184,
12,2,car,crv,253,756,446,744,503,298,0.97629297,20,,2,1.24,
13,2,car,crv,128,1307,388,817,1179,429,0.32914877,20,,2,1.2916666666666667,
14,2,car,crv,247,762,447,741,515,294,0.9441378,20,,2,1.2916666666666667,
15,2,car,crv,117,1313,388,818,1196,430,0.27251616,20,,2,0.3595317725752508,
16,2,car,crv,247,762,449,740,515,291,0.96550846,20,,2,0.3595317725752508,
17,2,car,crv,124,1305,387,820,1181,433,0.27402008,20,,2,0.36663844199830653,
18,2,car,crv,252,750,447,746,498,299,0.9501165,20,,2,0.36663844199830653,
19,2,car,crv,111,1317,390,812,1206,422,0.27479288,20,,2,0.34991708126036486,
20,2,car,crv,251,753,447,740,502,293,0.9438285,20,,2,0.34991708126036486,
21,2,car,crv,126,1309,390,814,1183,424,0.30222148,20,,2,1.2916666666666667,
22,2,car,crv,249,757,448,740,508,292,0.91383094,20,,2,1.2916666666666667,
23,2,car,crv,111,1317,390,811,1206,421,0.2941505,20,,2,0.3490878938640133,
24,2,car,crv,247,756,446,741,509,295,0.96245986,20,,2,0.3490878938640133,
25,2,car,crv,134,1300,387,818,1166,431,0.35928637,20,,2,1.28,
26,2,car,crv,251,757,447,743,506,296,0.9412378,20,,2,1.28,
27,2,car,crv,126,1312,388,815,1186,427,0.3965622,20,,2,1.24,
28,2,car,crv,252,758,446,743,506,297,0.9420341,20,,2,1.24,
29,2,car,crv,121,1316,389,809,1195,420,0.4096516,20,,2,1.24,
30,2,car,crv,244,761,447,742,517,295,0.9289579,20,,2,1.24,
31,2,car,crv,125,1312,392,805,1187,413,0.30284005,20,,2,1.24,
32,2,car,crv,245,760,447,739,515,292,0.9596912,20,,2,1.24,
33,2,car,crv,131,1307,388,812,1176,424,0.43397242,20,,2,1.2916666666666667,
34,2,car,crv,247,764,447,744,517,297,0.9014591,20,,2,1.2916666666666667,
35,2,car,crv,123,1315,388,811,1192,423,0.4968379,20,,2,1.24,
36,2,car,crv,246,758,446,743,512,297,0.87933147,20,,2,1.24,
37,2,car,crv,118,1312,389,813,1194,424,0.25691053,20,,2,0.35510887772194305,
38,2,car,crv,249,756,447,742,507,295,0.96910256,20,,2,0.35510887772194305,
39,2,car,crv,118,1319,389,813,1201,424,0.4023961,20,,2,1.28,
40,2,car,crv,243,757,448,743,514,295,0.94143236,20,,2,1.28,
41,2,car,crv,119,1322,385,815,1203,430,0.42900166,20,,2,1.24,
42,2,car,crv,246,762,447,741,516,294,0.790523,20,,2,1.24,
43,2,car,crv,119,1319,386,815,1200,429,0.44753623,20,,2,1.28,
44,2,car,crv,248,759,450,741,511,291,0.8263495,20,,2,1.28,
45,2,car,crv,114,1318,387,813,1204,426,0.43434885,20,,2,1.2916666666666667,
46,2,car,crv,246,759,446,744,513,298,0.9186257,20,,2,1.2916666666666667,
47,2,car,crv,119,1325,389,808,1206,419,0.46840343,20,,2,1.24,
48,2,car,crv,244,759,447,741,515,294,0.83414143,20,,2,1.24,
49,2,car,crv,116,1322,388,811,1206,423,0.44209528,20,,2,1.28,
50,2,car,crv,241,764,450,741,523,291,0.8834957,20,,2,1.28,
51,2,car,crv,334,710,446,701,376,255,0.92716336,3,0,2,0.6781914893617021,
52,2,car,crv,336,711,446,700,375,254,0.9036748,3,0,2,0.6773333333333333,
53,2,car,crv,335,709,444,701,374,257,0.9452533,3,0,2,0.6871657754010695,
0,2,car,crv,115,1321,388,815,1206,427,0.3674716,20,,2,1.24,
1,2,car,crv,248,756,446,740,508,294,0.92142504,20,,2,1.24,
2,2,car,crv,109,1315,384,827,1206,443,0.2820505,20,,2,1.24,
3,2,car,crv,249,758,449,736,509,287,0.91024953,20,,2,1.24,
4,2,car,crv,122,1310,388,817,1188,429,0.29904467,20,,2,0.3611111111111111,
5,2,car,crv,250,760,448,741,510,293,0.927252,20,,2,0.3611111111111111,
6,2,car,crv,129,1303,389,814,1174,425,0.27334884,20,,2,1.28,
7,2,car,crv,247,760,448,741,513,293,0.9333165,20,,2,1.28,
8,2,car,crv,122,1311,385,813,1189,428,0.35830083,20,,2,1.24,
9,2,car,crv,246,757,442,746,511,304,0.9668414,20,,2,1.24,
10,2,car,crv,122,1312,391,808,1190,417,0.34383425,20,,2,1.28,
11,2,car,crv,248,755,446,741,507,295,0.90284395,20,,2,1.28,
12,2,car,crv,129,1303,386,819,1174,433,0.2341652,20,,2,0.368824531516184,
13,2,car,crv,252,756,447,744,504,297,0.9354642,20,,2,0.368824531516184,
14,2,car,crv,253,756,446,744,503,298,0.97629297,20,,2,1.24,
15,2,car,crv,128,1307,388,817,1179,429,0.32914877,20,,2,1.2916666666666667,
16,2,car,crv,247,762,447,741,515,294,0.9441378,20,,2,1.2916666666666667,
17,2,car,crv,117,1313,388,818,1196,430,0.27251616,20,,2,0.3595317725752508,
18,2,car,crv,247,762,449,740,515,291,0.96550846,20,,2,0.3595317725752508,
19,2,car,crv,124,1305,387,820,1181,433,0.27402008,20,,2,0.36663844199830653,
20,2,car,crv,252,750,447,746,498,299,0.9501165,20,,2,0.36663844199830653,
21,2,car,crv,111,1317,390,812,1206,422,0.27479288,20,,2,0.34991708126036486,
22,2,car,crv,251,753,447,740,502,293,0.9438285,20,,2,0.34991708126036486,
23,2,car,crv,126,1309,390,814,1183,424,0.30222148,20,,2,1.2916666666666667,
24,2,car,crv,249,757,448,740,508,292,0.91383094,20,,2,1.2916666666666667,
25,2,car,crv,111,1317,390,811,1206,421,0.2941505,20,,2,0.3490878938640133,
26,2,car,crv,247,756,446,741,509,295,0.96245986,20,,2,0.3490878938640133,
27,2,car,crv,134,1300,387,818,1166,431,0.35928637,20,,2,1.28,
28,2,car,crv,251,757,447,743,506,296,0.9412378,20,,2,1.28,
29,2,car,crv,126,1312,388,815,1186,427,0.3965622,20,,2,1.24,
30,2,car,crv,252,758,446,743,506,297,0.9420341,20,,2,1.24,
31,2,car,crv,121,1316,389,809,1195,420,0.4096516,20,,2,1.24,
32,2,car,crv,244,761,447,742,517,295,0.9289579,20,,2,1.24,
33,2,car,crv,125,1312,392,805,1187,413,0.30284005,20,,2,1.24,
34,2,car,crv,245,760,447,739,515,292,0.9596912,20,,2,1.24,
35,2,car,crv,131,1307,388,812,1176,424,0.43397242,20,,2,1.2916666666666667,
36,2,car,crv,247,764,447,744,517,297,0.9014591,20,,2,1.2916666666666667,
37,2,car,crv,123,1315,388,811,1192,423,0.4968379,20,,2,1.24,
38,2,car,crv,246,758,446,743,512,297,0.87933147,20,,2,1.24,
39,2,car,crv,118,1312,389,813,1194,424,0.25691053,20,,2,0.35510887772194305,
40,2,car,crv,249,756,447,742,507,295,0.96910256,20,,2,0.35510887772194305,
41,2,car,crv,118,1319,389,813,1201,424,0.4023961,20,,2,1.28,
42,2,car,crv,243,757,448,743,514,295,0.94143236,20,,2,1.28,
43,2,car,crv,119,1322,385,815,1203,430,0.42900166,20,,2,1.24,
44,2,car,crv,246,762,447,741,516,294,0.790523,20,,2,1.24,
45,2,car,crv,119,1319,386,815,1200,429,0.44753623,20,,2,1.28,
46,2,car,crv,248,759,450,741,511,291,0.8263495,20,,2,1.28,
47,2,car,crv,114,1318,387,813,1204,426,0.43434885,20,,2,1.2916666666666667,
48,2,car,crv,246,759,446,744,513,298,0.9186257,20,,2,1.2916666666666667,
49,2,car,crv,119,1325,389,808,1206,419,0.46840343,20,,2,1.24,
50,2,car,crv,244,759,447,741,515,294,0.83414143,20,,2,1.24,
51,2,car,crv,116,1322,388,811,1206,423,0.44209528,20,,2,1.28,
52,2,car,crv,241,764,450,741,523,291,0.8834957,20,,2,1.28,
53,2,car,crv,334,710,446,701,376,255,0.92716336,3,0,2,0.6781914893617021,
54,2,car,crv,336,711,446,700,375,254,0.9036748,3,0,2,0.6773333333333333,
55,2,car,crv,335,709,444,701,374,257,0.9452533,3,0,2,0.6871657754010695,
0,2,car,crv,122,1311,387,814,1189,427,0.36553156,20,,2,1.2916666666666667,
1,2,car,crv,250,757,444,744,507,300,0.9479286,20,,2,1.2916666666666667,
2,2,car,crv,115,1321,388,815,1206,427,0.3674716,20,,2,1.24,
3,2,car,crv,248,756,446,740,508,294,0.92142504,20,,2,1.24,
4,2,car,crv,109,1315,384,827,1206,443,0.2820505,20,,2,1.24,
5,2,car,crv,249,758,449,736,509,287,0.91024953,20,,2,1.24,
6,2,car,crv,122,1310,388,817,1188,429,0.29904467,20,,2,0.3611111111111111,
7,2,car,crv,250,760,448,741,510,293,0.927252,20,,2,0.3611111111111111,
8,2,car,crv,129,1303,389,814,1174,425,0.27334884,20,,2,1.28,
9,2,car,crv,247,760,448,741,513,293,0.9333165,20,,2,1.28,
10,2,car,crv,122,1311,385,813,1189,428,0.35830083,20,,2,1.24,
11,2,car,crv,246,757,442,746,511,304,0.9668414,20,,2,1.24,
12,2,car,crv,122,1312,391,808,1190,417,0.34383425,20,,2,1.28,
13,2,car,crv,248,755,446,741,507,295,0.90284395,20,,2,1.28,
14,2,car,crv,129,1303,386,819,1174,433,0.2341652,20,,2,0.368824531516184,
15,2,car,crv,252,756,447,744,504,297,0.9354642,20,,2,0.368824531516184,
16,2,car,crv,253,756,446,744,503,298,0.97629297,20,,2,1.24,
17,2,car,crv,128,1307,388,817,1179,429,0.32914877,20,,2,1.2916666666666667,
18,2,car,crv,247,762,447,741,515,294,0.9441378,20,,2,1.2916666666666667,
19,2,car,crv,117,1313,388,818,1196,430,0.27251616,20,,2,0.3595317725752508,
20,2,car,crv,247,762,449,740,515,291,0.96550846,20,,2,0.3595317725752508,
21,2,car,crv,124,1305,387,820,1181,433,0.27402008,20,,2,0.36663844199830653,
22,2,car,crv,252,750,447,746,498,299,0.9501165,20,,2,0.36663844199830653,
23,2,car,crv,111,1317,390,812,1206,422,0.27479288,20,,2,0.34991708126036486,
24,2,car,crv,251,753,447,740,502,293,0.9438285,20,,2,0.34991708126036486,
25,2,car,crv,126,1309,390,814,1183,424,0.30222148,20,,2,1.2916666666666667,
26,2,car,crv,249,757,448,740,508,292,0.91383094,20,,2,1.2916666666666667,
27,2,car,crv,111,1317,390,811,1206,421,0.2941505,20,,2,0.3490878938640133,
28,2,car,crv,247,756,446,741,509,295,0.96245986,20,,2,0.3490878938640133,
29,2,car,crv,134,1300,387,818,1166,431,0.35928637,20,,2,1.28,
30,2,car,crv,251,757,447,743,506,296,0.9412378,20,,2,1.28,
31,2,car,crv,126,1312,388,815,1186,427,0.3965622,20,,2,1.24,
32,2,car,crv,252,758,446,743,506,297,0.9420341,20,,2,1.24,
33,2,car,crv,121,1316,389,809,1195,420,0.4096516,20,,2,1.24,
34,2,car,crv,244,761,447,742,517,295,0.9289579,20,,2,1.24,
35,2,car,crv,125,1312,392,805,1187,413,0.30284005,20,,2,1.24,
36,2,car,crv,245,760,447,739,515,292,0.9596912,20,,2,1.24,
37,2,car,crv,131,1307,388,812,1176,424,0.43397242,20,,2,1.2916666666666667,
38,2,car,crv,247,764,447,744,517,297,0.9014591,20,,2,1.2916666666666667,
39,2,car,crv,123,1315,388,811,1192,423,0.4968379,20,,2,1.24,
40,2,car,crv,246,758,446,743,512,297,0.87933147,20,,2,1.24,
41,2,car,crv,118,1312,389,813,1194,424,0.25691053,20,,2,0.35510887772194305,
42,2,car,crv,249,756,447,742,507,295,0.96910256,20,,2,0.35510887772194305,
43,2,car,crv,118,1319,389,813,1201,424,0.4023961,20,,2,1.28,
44,2,car,crv,243,757,448,743,514,295,0.94143236,20,,2,1.28,
45,2,car,crv,119,1322,385,815,1203,430,0.42900166,20,,2,1.24,
46,2,car,crv,246,762,447,741,516,294,0.790523,20,,2,1.24,
47,2,car,crv,119,1319,386,815,1200,429,0.44753623,20,,2,1.28,
48,2,car,crv,248,759,450,741,511,291,0.8263495,20,,2,1.28,
49,2,car,crv,114,1318,387,813,1204,426,0.43434885,20,,2,1.2916666666666667,
50,2,car,crv,246,759,446,744,513,298,0.9186257,20,,2,1.2916666666666667,
51,2,car,crv,119,1325,389,808,1206,419,0.46840343,20,,2,1.24,
52,2,car,crv,244,759,447,741,515,294,0.83414143,20,,2,1.24,
53,2,car,crv,116,1322,388,811,1206,423,0.44209528,20,,2,1.28,
54,2,car,crv,241,764,450,741,523,291,0.8834957,20,,2,1.28,
55,2,car,crv,334,710,446,701,376,255,0.92716336,3,0,2,0.6781914893617021,
56,2,car,crv,336,711,446,700,375,254,0.9036748,3,0,2,0.6773333333333333,
57,2,car,crv,335,709,444,701,374,257,0.9452533,3,0,2,0.6871657754010695,
0,2,car,crv,117,1313,390,812,1196,422,0.32242462,20,,2,1.2916666666666667,
1,2,car,crv,243,759,447,742,516,295,0.9675998,20,,2,1.2916666666666667,
2,2,car,crv,122,1311,387,814,1189,427,0.36553156,20,,2,1.2916666666666667,
3,2,car,crv,250,757,444,744,507,300,0.9479286,20,,2,1.2916666666666667,
4,2,car,crv,115,1321,388,815,1206,427,0.3674716,20,,2,1.24,
5,2,car,crv,248,756,446,740,508,294,0.92142504,20,,2,1.24,
6,2,car,crv,109,1315,384,827,1206,443,0.2820505,20,,2,1.24,
7,2,car,crv,249,758,449,736,509,287,0.91024953,20,,2,1.24,
8,2,car,crv,122,1310,388,817,1188,429,0.29904467,20,,2,0.3611111111111111,
9,2,car,crv,250,760,448,741,510,293,0.927252,20,,2,0.3611111111111111,
10,2,car,crv,129,1303,389,814,1174,425,0.27334884,20,,2,1.28,
11,2,car,crv,247,760,448,741,513,293,0.9333165,20,,2,1.28,
12,2,car,crv,122,1311,385,813,1189,428,0.35830083,20,,2,1.24,
13,2,car,crv,246,757,442,746,511,304,0.9668414,20,,2,1.24,
14,2,car,crv,122,1312,391,808,1190,417,0.34383425,20,,2,1.28,
15,2,car,crv,248,755,446,741,507,295,0.90284395,20,,2,1.28,
16,2,car,crv,129,1303,386,819,1174,433,0.2341652,20,,2,0.368824531516184,
17,2,car,crv,252,756,447,744,504,297,0.9354642,20,,2,0.368824531516184,
18,2,car,crv,253,756,446,744,503,298,0.97629297,20,,2,1.24,
19,2,car,crv,128,1307,388,817,1179,429,0.32914877,20,,2,1.2916666666666667,
20,2,car,crv,247,762,447,741,515,294,0.9441378,20,,2,1.2916666666666667,
21,2,car,crv,117,1313,388,818,1196,430,0.27251616,20,,2,0.3595317725752508,
22,2,car,crv,247,762,449,740,515,291,0.96550846,20,,2,0.3595317725752508,
23,2,car,crv,124,1305,387,820,1181,433,0.27402008,20,,2,0.36663844199830653,
24,2,car,crv,252,750,447,746,498,299,0.9501165,20,,2,0.36663844199830653,
25,2,car,crv,111,1317,390,812,1206,422,0.27479288,20,,2,0.34991708126036486,
26,2,car,crv,251,753,447,740,502,293,0.9438285,20,,2,0.34991708126036486,
27,2,car,crv,126,1309,390,814,1183,424,0.30222148,20,,2,1.2916666666666667,
28,2,car,crv,249,757,448,740,508,292,0.91383094,20,,2,1.2916666666666667,
29,2,car,crv,111,1317,390,811,1206,421,0.2941505,20,,2,0.3490878938640133,
30,2,car,crv,247,756,446,741,509,295,0.96245986,20,,2,0.3490878938640133,
31,2,car,crv,134,1300,387,818,1166,431,0.35928637,20,,2,1.28,
32,2,car,crv,251,757,447,743,506,296,0.9412378,20,,2,1.28,
33,2,car,crv,126,1312,388,815,1186,427,0.3965622,20,,2,1.24,
34,2,car,crv,252,758,446,743,506,297,0.9420341,20,,2,1.24,
35,2,car,crv,121,1316,389,809,1195,420,0.4096516,20,,2,1.24,
36,2,car,crv,244,761,447,742,517,295,0.9289579,20,,2,1.24,
37,2,car,crv,125,1312,392,805,1187,413,0.30284005,20,,2,1.24,
38,2,car,crv,245,760,447,739,515,292,0.9596912,20,,2,1.24,
39,2,car,crv,131,1307,388,812,1176,424,0.43397242,20,,2,1.2916666666666667,
40,2,car,crv,247,764,447,744,517,297,0.9014591,20,,2,1.2916666666666667,
41,2,car,crv,123,1315,388,811,1192,423,0.4968379,20,,2,1.24,
42,2,car,crv,246,758,446,743,512,297,0.87933147,20,,2,1.24,
43,2,car,crv,118,1312,389,813,1194,424,0.25691053,20,,2,0.35510887772194305,
44,2,car,crv,249,756,447,742,507,295,0.96910256,20,,2,0.35510887772194305,
45,2,car,crv,118,1319,389,813,1201,424,0.4023961,20,,2,1.28,
46,2,car,crv,243,757,448,743,514,295,0.94143236,20,,2,1.28,
47,2,car,crv,119,1322,385,815,1203,430,0.42900166,20,,2,1.24,
48,2,car,crv,246,762,447,741,516,294,0.790523,20,,2,1.24,
49,2,car,crv,119,1319,386,815,1200,429,0.44753623,20,,2,1.28,
50,2,car,crv,248,759,450,741,511,291,0.8263495,20,,2,1.28,
51,2,car,crv,114,1318,387,813,1204,426,0.43434885,20,,2,1.2916666666666667,
52,2,car,crv,246,759,446,744,513,298,0.9186257,20,,2,1.2916666666666667,
53,2,car,crv,119,1325,389,808,1206,419,0.46840343,20,,2,1.24,
54,2,car,crv,244,759,447,741,515,294,0.83414143,20,,2,1.24,
55,2,car,crv,116,1322,388,811,1206,423,0.44209528,20,,2,1.28,
56,2,car,crv,241,764,450,741,523,291,0.8834957,20,,2,1.28,
57,2,car,crv,334,710,446,701,376,255,0.92716336,3,0,2,0.6781914893617021,
58,2,car,crv,336,711,446,700,375,254,0.9036748,3,0,2,0.6773333333333333,
59,2,car,crv,335,709,444,701,374,257,0.9452533,3,0,2,0.6871657754010695,
0,2,car,crv,135,1302,387,821,1167,434,0.35179994,20,,2,1.2916666666666667,
1,2,car,crv,250,760,450,741,510,291,0.8736024,20,,2,1.2916666666666667,
2,2,car,crv,117,1313,390,812,1196,422,0.32242462,20,,2,1.2916666666666667,
3,2,car,crv,243,759,447,742,516,295,0.9675998,20,,2,1.2916666666666667,
4,2,car,crv,122,1311,387,814,1189,427,0.36553156,20,,2,1.2916666666666667,
5,2,car,crv,250,757,444,744,507,300,0.9479286,20,,2,1.2916666666666667,
6,2,car,crv,115,1321,388,815,1206,427,0.3674716,20,,2,1.24,
7,2,car,crv,248,756,446,740,508,294,0.92142504,20,,2,1.24,
8,2,car,crv,109,1315,384,827,1206,443,0.2820505,20,,2,1.24,
9,2,car,crv,249,758,449,736,509,287,0.91024953,20,,2,1.24,
10,2,car,crv,122,1310,388,817,1188,429,0.29904467,20,,2,0.3611111111111111,
11,2,car,crv,250,760,448,741,510,293,0.927252,20,,2,0.3611111111111111,
12,2,car,crv,129,1303,389,814,1174,425,0.27334884,20,,2,1.28,
13,2,car,crv,247,760,448,741,513,293,0.9333165,20,,2,1.28,
14,2,car,crv,122,1311,385,813,1189,428,0.35830083,20,,2,1.24,
15,2,car,crv,246,757,442,746,511,304,0.9668414,20,,2,1.24,
16,2,car,crv,122,1312,391,808,1190,417,0.34383425,20,,2,1.28,
17,2,car,crv,248,755,446,741,507,295,0.90284395,20,,2,1.28,
18,2,car,crv,129,1303,386,819,1174,433,0.2341652,20,,2,0.368824531516184,
19,2,car,crv,252,756,447,744,504,297,0.9354642,20,,2,0.368824531516184,
20,2,car,crv,253,756,446,744,503,298,0.97629297,20,,2,1.24,
21,2,car,crv,128,1307,388,817,1179,429,0.32914877,20,,2,1.2916666666666667,
22,2,car,crv,247,762,447,741,515,294,0.9441378,20,,2,1.2916666666666667,
23,2,car,crv,117,1313,388,818,1196,430,0.27251616,20,,2,0.3595317725752508,
24,2,car,crv,247,762,449,740,515,291,0.96550846,20,,2,0.3595317725752508,
25,2,car,crv,124,1305,387,820,1181,433,0.27402008,20,,2,0.36663844199830653,
26,2,car,crv,252,750,447,746,498,299,0.9501165,20,,2,0.36663844199830653,
27,2,car,crv,111,1317,390,812,1206,422,0.27479288,20,,2,0.34991708126036486,
28,2,car,crv,251,753,447,740,502,293,0.9438285,20,,2,0.34991708126036486,
29,2,car,crv,126,1309,390,814,1183,424,0.30222148,20,,2,1.2916666666666667,
30,2,car,crv,249,757,448,740,508,292,0.91383094,20,,2,1.2916666666666667,
31,2,car,crv,111,1317,390,811,1206,421,0.2941505,20,,2,0.3490878938640133,
32,2,car,crv,247,756,446,741,509,295,0.96245986,20,,2,0.3490878938640133,
33,2,car,crv,134,1300,387,818,1166,431,0.35928637,20,,2,1.28,
34,2,car,crv,251,757,447,743,506,296,0.9412378,20,,2,1.28,
35,2,car,crv,126,1312,388,815,1186,427,0.3965622,20,,2,1.24,
36,2,car,crv,252,758,446,743,506,297,0.9420341,20,,2,1.24,
37,2,car,crv,121,1316,389,809,1195,420,0.4096516,20,,2,1.24,
38,2,car,crv,244,761,447,742,517,295,0.9289579,20,,2,1.24,
39,2,car,crv,125,1312,392,805,1187,413,0.30284005,20,,2,1.24,
40,2,car,crv,245,760,447,739,515,292,0.9596912,20,,2,1.24,
41,2,car,crv,131,1307,388,812,1176,424,0.43397242,20,,2,1.2916666666666667,
42,2,car,crv,247,764,447,744,517,297,0.9014591,20,,2,1.2916666666666667,
43,2,car,crv,123,1315,388,811,1192,423,0.4968379,20,,2,1.24,
44,2,car,crv,246,758,446,743,512,297,0.87933147,20,,2,1.24,
45,2,car,crv,118,1312,389,813,1194,424,0.25691053,20,,2,0.35510887772194305,
46,2,car,crv,249,756,447,742,507,295,0.96910256,20,,2,0.35510887772194305,
47,2,car,crv,118,1319,389,813,1201,424,0.4023961,20,,2,1.28,
48,2,car,crv,243,757,448,743,514,295,0.94143236,20,,2,1.28,
49,2,car,crv,119,1322,385,815,1203,430,0.42900166,20,,2,1.24,
50,2,car,crv,246,762,447,741,516,294,0.790523,20,,2,1.24,
51,2,car,crv,119,1319,386,815,1200,429,0.44753623,20,,2,1.28,
52,2,car,crv,248,759,450,741,511,291,0.8263495,20,,2,1.28,
53,2,car,crv,114,1318,387,813,1204,426,0.43434885,20,,2,1.2916666666666667,
54,2,car,crv,246,759,446,744,513,298,0.9186257,20,,2,1.2916666666666667,
55,2,car,crv,119,1325,389,808,1206,419,0.46840343,20,,2,1.24,
56,2,car,crv,244,759,447,741,515,294,0.83414143,20,,2,1.24,
57,2,car,crv,116,1322,388,811,1206,423,0.44209528,20,,2,1.28,
58,2,car,crv,241,764,450,741,523,291,0.8834957,20,,2,1.28,
59,2,car,crv,334,710,446,701,376,255,0.92716336,3,0,2,0.6781914893617021,
60,2,car,crv,336,711,446,700,375,254,0.9036748,3,0,2,0.6773333333333333,
61,2,car,crv,335,709,444,701,374,257,0.9452533,3,0,2,0.6871657754010695,
0,2,car,crv,121,1308,388,815,1187,427,0.21448645,20,,2,0.35973041280539175,
1,2,car,crv,249,753,445,746,504,301,0.9724925,20,,2,0.35973041280539175,
2,2,car,crv,135,1302,387,821,1167,434,0.35179994,20,,2,1.2916666666666667,
3,2,car,crv,250,760,450,741,510,291,0.8736024,20,,2,1.2916666666666667,
4,2,car,crv,117,1313,390,812,1196,422,0.32242462,20,,2,1.2916666666666667,
5,2,car,crv,243,759,447,742,516,295,0.9675998,20,,2,1.2916666666666667,
6,2,car,crv,122,1311,387,814,1189,427,0.36553156,20,,2,1.2916666666666667,
7,2,car,crv,250,757,444,744,507,300,0.9479286,20,,2,1.2916666666666667,
8,2,car,crv,115,1321,388,815,1206,427,0.3674716,20,,2,1.24,
9,2,car,crv,248,756,446,740,508,294,0.92142504,20,,2,1.24,
10,2,car,crv,109,1315,384,827,1206,443,0.2820505,20,,2,1.24,
11,2,car,crv,249,758,449,736,509,287,0.91024953,20,,2,1.24,
12,2,car,crv,122,1310,388,817,1188,429,0.29904467,20,,2,0.3611111111111111,
13,2,car,crv,250,760,448,741,510,293,0.927252,20,,2,0.3611111111111111,
14,2,car,crv,129,1303,389,814,1174,425,0.27334884,20,,2,1.28,
15,2,car,crv,247,760,448,741,513,293,0.9333165,20,,2,1.28,
16,2,car,crv,122,1311,385,813,1189,428,0.35830083,20,,2,1.24,
17,2,car,crv,246,757,442,746,511,304,0.9668414,20,,2,1.24,
18,2,car,crv,122,1312,391,808,1190,417,0.34383425,20,,2,1.28,
19,2,car,crv,248,755,446,741,507,295,0.90284395,20,,2,1.28,
20,2,car,crv,129,1303,386,819,1174,433,0.2341652,20,,2,0.368824531516184,
21,2,car,crv,252,756,447,744,504,297,0.9354642,20,,2,0.368824531516184,
22,2,car,crv,253,756,446,744,503,298,0.97629297,20,,2,1.24,
23,2,car,crv,128,1307,388,817,1179,429,0.32914877,20,,2,1.2916666666666667,
24,2,car,crv,247,762,447,741,515,294,0.9441378,20,,2,1.2916666666666667,
25,2,car,crv,117,1313,388,818,1196,430,0.27251616,20,,2,0.3595317725752508,
26,2,car,crv,247,762,449,740,515,291,0.96550846,20,,2,0.3595317725752508,
27,2,car,crv,124,1305,387,820,1181,433,0.27402008,20,,2,0.36663844199830653,
28,2,car,crv,252,750,447,746,498,299,0.9501165,20,,2,0.36663844199830653,
29,2,car,crv,111,1317,390,812,1206,422,0.27479288,20,,2,0.34991708126036486,
30,2,car,crv,251,753,447,740,502,293,0.9438285,20,,2,0.34991708126036486,
31,2,car,crv,126,1309,390,814,1183,424,0.30222148,20,,2,1.2916666666666667,
32,2,car,crv,249,757,448,740,508,292,0.91383094,20,,2,1.2916666666666667,
33,2,car,crv,111,1317,390,811,1206,421,0.2941505,20,,2,0.3490878938640133,
34,2,car,crv,247,756,446,741,509,295,0.96245986,20,,2,0.3490878938640133,
35,2,car,crv,134,1300,387,818,1166,431,0.35928637,20,,2,1.28,
36,2,car,crv,251,757,447,743,506,296,0.9412378,20,,2,1.28,
37,2,car,crv,126,1312,388,815,1186,427,0.3965622,20,,2,1.24,
38,2,car,crv,252,758,446,743,506,297,0.9420341,20,,2,1.24,
39,2,car,crv,121,1316,389,809,1195,420,0.4096516,20,,2,1.24,
40,2,car,crv,244,761,447,742,517,295,0.9289579,20,,2,1.24,
41,2,car,crv,125,1312,392,805,1187,413,0.30284005,20,,2,1.24,
42,2,car,crv,245,760,447,739,515,292,0.9596912,20,,2,1.24,
43,2,car,crv,131,1307,388,812,1176,424,0.43397242,20,,2,1.2916666666666667,
44,2,car,crv,247,764,447,744,517,297,0.9014591,20,,2,1.2916666666666667,
45,2,car,crv,123,1315,388,811,1192,423,0.4968379,20,,2,1.24,
46,2,car,crv,246,758,446,743,512,297,0.87933147,20,,2,1.24,
47,2,car,crv,118,1312,389,813,1194,424,0.25691053,20,,2,0.35510887772194305,
48,2,car,crv,249,756,447,742,507,295,0.96910256,20,,2,0.35510887772194305,
49,2,car,crv,118,1319,389,813,1201,424,0.4023961,20,,2,1.28,
50,2,car,crv,243,757,448,743,514,295,0.94143236,20,,2,1.28,
51,2,car,crv,119,1322,385,815,1203,430,0.42900166,20,,2,1.24,
52,2,car,crv,246,762,447,741,516,294,0.790523,20,,2,1.24,
53,2,car,crv,119,1319,386,815,1200,429,0.44753623,20,,2,1.28,
54,2,car,crv,248,759,450,741,511,291,0.8263495,20,,2,1.28,
55,2,car,crv,114,1318,387,813,1204,426,0.43434885,20,,2,1.2916666666666667,
56,2,car,crv,246,759,446,744,513,298,0.9186257,20,,2,1.2916666666666667,
57,2,car,crv,119,1325,389,808,1206,419,0.46840343,20,,2,1.24,
58,2,car,crv,244,759,447,741,515,294,0.83414143,20,,2,1.24,
59,2,car,crv,116,1322,388,811,1206,423,0.44209528,20,,2,1.28,
60,2,car,crv,241,764,450,741,523,291,0.8834957,20,,2,1.28,
61,2,car,crv,334,710,446,701,376,255,0.92716336,3,0,2,0.6781914893617021,
62,2,car,crv,336,711,446,700,375,254,0.9036748,3,0,2,0.6773333333333333,
63,2,car,crv,335,709,444,701,374,257,0.9452533,3,0,2,0.6871657754010695,
0,2,car,crv,119,1317,388,814,1198,426,0.4732625,20,,2,1.24,
1,2,car,crv,245,758,448,742,513,294,0.94409996,20,,2,1.24,
2,2,car,crv,121,1308,388,815,1187,427,0.21448645,20,,2,0.35973041280539175,
3,2,car,crv,249,753,445,746,504,301,0.9724925,20,,2,0.35973041280539175,
4,2,car,crv,135,1302,387,821,1167,434,0.35179994,20,,2,1.2916666666666667,
5,2,car,crv,250,760,450,741,510,291,0.8736024,20,,2,1.2916666666666667,
6,2,car,crv,117,1313,390,812,1196,422,0.32242462,20,,2,1.2916666666666667,
7,2,car,crv,243,759,447,742,516,295,0.9675998,20,,2,1.2916666666666667,
8,2,car,crv,122,1311,387,814,1189,427,0.36553156,20,,2,1.2916666666666667,
9,2,car,crv,250,757,444,744,507,300,0.9479286,20,,2,1.2916666666666667,
10,2,car,crv,115,1321,388,815,1206,427,0.3674716,20,,2,1.24,
11,2,car,crv,248,756,446,740,508,294,0.92142504,20,,2,1.24,
12,2,car,crv,109,1315,384,827,1206,443,0.2820505,20,,2,1.24,
13,2,car,crv,249,758,449,736,509,287,0.91024953,20,,2,1.24,
14,2,car,crv,122,1310,388,817,1188,429,0.29904467,20,,2,0.3611111111111111,
15,2,car,crv,250,760,448,741,510,293,0.927252,20,,2,0.3611111111111111,
16,2,car,crv,129,1303,389,814,1174,425,0.27334884,20,,2,1.28,
17,2,car,crv,247,760,448,741,513,293,0.9333165,20,,2,1.28,
18,2,car,crv,122,1311,385,813,1189,428,0.35830083,20,,2,1.24,
19,2,car,crv,246,757,442,746,511,304,0.9668414,20,,2,1.24,
20,2,car,crv,122,1312,391,808,1190,417,0.34383425,20,,2,1.28,
21,2,car,crv,248,755,446,741,507,295,0.90284395,20,,2,1.28,
22,2,car,crv,129,1303,386,819,1174,433,0.2341652,20,,2,0.368824531516184,
23,2,car,crv,252,756,447,744,504,297,0.9354642,20,,2,0.368824531516184,
24,2,car,crv,253,756,446,744,503,298,0.97629297,20,,2,1.24,
25,2,car,crv,128,1307,388,817,1179,429,0.32914877,20,,2,1.2916666666666667,
26,2,car,crv,247,762,447,741,515,294,0.9441378,20,,2,1.2916666666666667,
27,2,car,crv,117,1313,388,818,1196,430,0.27251616,20,,2,0.3595317725752508,
28,2,car,crv,247,762,449,740,515,291,0.96550846,20,,2,0.3595317725752508,
29,2,car,crv,124,1305,387,820,1181,433,0.27402008,20,,2,0.36663844199830653,
30,2,car,crv,252,750,447,746,498,299,0.9501165,20,,2,0.36663844199830653,
31,2,car,crv,111,1317,390,812,1206,422,0.27479288,20,,2,0.34991708126036486,
32,2,car,crv,251,753,447,740,502,293,0.9438285,20,,2,0.34991708126036486,
33,2,car,crv,126,1309,390,814,1183,424,0.30222148,20,,2,1.2916666666666667,
34,2,car,crv,249,757,448,740,508,292,0.91383094,20,,2,1.2916666666666667,
35,2,car,crv,111,1317,390,811,1206,421,0.2941505,20,,2,0.3490878938640133,
36,2,car,crv,247,756,446,741,509,295,0.96245986,20,,2,0.3490878938640133,
37,2,car,crv,134,1300,387,818,1166,431,0.35928637,20,,2,1.28,
38,2,car,crv,251,757,447,743,506,296,0.9412378,20,,2,1.28,
39,2,car,crv,126,1312,388,815,1186,427,0.3965622,20,,2,1.24,
40,2,car,crv,252,758,446,743,506,297,0.9420341,20,,2,1.24,
41,2,car,crv,121,1316,389,809,1195,420,0.4096516,20,,2,1.24,
42,2,car,crv,244,761,447,742,517,295,0.9289579,20,,2,1.24,
43,2,car,crv,125,1312,392,805,1187,413,0.30284005,20,,2,1.24,
44,2,car,crv,245,760,447,739,515,292,0.9596912,20,,2,1.24,
45,2,car,crv,131,1307,388,812,1176,424,0.43397242,20,,2,1.2916666666666667,
46,2,car,crv,247,764,447,744,517,297,0.9014591,20,,2,1.2916666666666667,
47,2,car,crv,123,1315,388,811,1192,423,0.4968379,20,,2,1.24,
48,2,car,crv,246,758,446,743,512,297,0.87933147,20,,2,1.24,
49,2,car,crv,118,1312,389,813,1194,424,0.25691053,20,,2,0.35510887772194305,
50,2,car,crv,249,756,447,742,507,295,0.96910256,20,,2,0.35510887772194305,
51,2,car,crv,118,1319,389,813,1201,424,0.4023961,20,,2,1.28,
52,2,car,crv,243,757,448,743,514,295,0.94143236,20,,2,1.28,
53,2,car,crv,119,1322,385,815,1203,430,0.42900166,20,,2,1.24,
54,2,car,crv,246,762,447,741,516,294,0.790523,20,,2,1.24,
55,2,car,crv,119,1319,386,815,1200,429,0.44753623,20,,2,1.28,
56,2,car,crv,248,759,450,741,511,291,0.8263495,20,,2,1.28,
57,2,car,crv,114,1318,387,813,1204,426,0.43434885,20,,2,1.2916666666666667,
58,2,car,crv,246,759,446,744,513,298,0.9186257,20,,2,1.2916666666666667,
59,2,car,crv,119,1325,389,808,1206,419,0.46840343,20,,2,1.24,
60,2,car,crv,244,759,447,741,515,294,0.83414143,20,,2,1.24,
61,2,car,crv,116,1322,388,811,1206,423,0.44209528,20,,2,1.28,
62,2,car,crv,241,764,450,741,523,291,0.8834957,20,,2,1.28,
63,2,car,crv,334,710,446,701,376,255,0.92716336,3,0,2,0.6781914893617021,
64,2,car,crv,336,711,446,700,375,254,0.9036748,3,0,2,0.6773333333333333,
65,2,car,crv,335,709,444,701,374,257,0.9452533,3,0,2,0.6871657754010695,
0,2,car,crv,121,1308,387,817,1187,430,0.21458383,20,,2,0.36225779275484415,
1,2,car,crv,250,754,447,740,504,293,0.9610552,20,,2,0.36225779275484415,
2,2,car,crv,119,1317,388,814,1198,426,0.4732625,20,,2,1.24,
3,2,car,crv,245,758,448,742,513,294,0.94409996,20,,2,1.24,
4,2,car,crv,121,1308,388,815,1187,427,0.21448645,20,,2,0.35973041280539175,
5,2,car,crv,249,753,445,746,504,301,0.9724925,20,,2,0.35973041280539175,
6,2,car,crv,135,1302,387,821,1167,434,0.35179994,20,,2,1.2916666666666667,
7,2,car,crv,250,760,450,741,510,291,0.8736024,20,,2,1.2916666666666667,
8,2,car,crv,117,1313,390,812,1196,422,0.32242462,20,,2,1.2916666666666667,
9,2,car,crv,243,759,447,742,516,295,0.9675998,20,,2,1.2916666666666667,
10,2,car,crv,122,1311,387,814,1189,427,0.36553156,20,,2,1.2916666666666667,
11,2,car,crv,250,757,444,744,507,300,0.9479286,20,,2,1.2916666666666667,
12,2,car,crv,115,1321,388,815,1206,427,0.3674716,20,,2,1.24,
13,2,car,crv,248,756,446,740,508,294,0.92142504,20,,2,1.24,
14,2,car,crv,109,1315,384,827,1206,443,0.2820505,20,,2,1.24,
15,2,car,crv,249,758,449,736,509,287,0.91024953,20,,2,1.24,
16,2,car,crv,122,1310,388,817,1188,429,0.29904467,20,,2,0.3611111111111111,
17,2,car,crv,250,760,448,741,510,293,0.927252,20,,2,0.3611111111111111,
18,2,car,crv,129,1303,389,814,1174,425,0.27334884,20,,2,1.28,
19,2,car,crv,247,760,448,741,513,293,0.9333165,20,,2,1.28,
20,2,car,crv,122,1311,385,813,1189,428,0.35830083,20,,2,1.24,
21,2,car,crv,246,757,442,746,511,304,0.9668414,20,,2,1.24,
22,2,car,crv,122,1312,391,808,1190,417,0.34383425,20,,2,1.28,
23,2,car,crv,248,755,446,741,507,295,0.90284395,20,,2,1.28,
24,2,car,crv,129,1303,386,819,1174,433,0.2341652,20,,2,0.368824531516184,
25,2,car,crv,252,756,447,744,504,297,0.9354642,20,,2,0.368824531516184,
26,2,car,crv,253,756,446,744,503,298,0.97629297,20,,2,1.24,
27,2,car,crv,128,1307,388,817,1179,429,0.32914877,20,,2,1.2916666666666667,
28,2,car,crv,247,762,447,741,515,294,0.9441378,20,,2,1.2916666666666667,
29,2,car,crv,117,1313,388,818,1196,430,0.27251616,20,,2,0.3595317725752508,
30,2,car,crv,247,762,449,740,515,291,0.96550846,20,,2,0.3595317725752508,
31,2,car,crv,124,1305,387,820,1181,433,0.27402008,20,,2,0.36663844199830653,
32,2,car,crv,252,750,447,746,498,299,0.9501165,20,,2,0.36663844199830653,
33,2,car,crv,111,1317,390,812,1206,422,0.27479288,20,,2,0.34991708126036486,
34,2,car,crv,251,753,447,740,502,293,0.9438285,20,,2,0.34991708126036486,
35,2,car,crv,126,1309,390,814,1183,424,0.30222148,20,,2,1.2916666666666667,
36,2,car,crv,249,757,448,740,508,292,0.91383094,20,,2,1.2916666666666667,
37,2,car,crv,111,1317,390,811,1206,421,0.2941505,20,,2,0.3490878938640133,
38,2,car,crv,247,756,446,741,509,295,0.96245986,20,,2,0.3490878938640133,
39,2,car,crv,134,1300,387,818,1166,431,0.35928637,20,,2,1.28,
40,2,car,crv,251,757,447,743,506,296,0.9412378,20,,2,1.28,
41,2,car,crv,126,1312,388,815,1186,427,0.3965622,20,,2,1.24,
42,2,car,crv,252,758,446,743,506,297,0.9420341,20,,2,1.24,
43,2,car,crv,121,1316,389,809,1195,420,0.4096516,20,,2,1.24,
44,2,car,crv,244,761,447,742,517,295,0.9289579,20,,2,1.24,
45,2,car,crv,125,1312,392,805,1187,413,0.30284005,20,,2,1.24,
46,2,car,crv,245,760,447,739,515,292,0.9596912,20,,2,1.24,
47,2,car,crv,131,1307,388,812,1176,424,0.43397242,20,,2,1.2916666666666667,
48,2,car,crv,247,764,447,744,517,297,0.9014591,20,,2,1.2916666666666667,
49,2,car,crv,123,1315,388,811,1192,423,0.4968379,20,,2,1.24,
50,2,car,crv,246,758,446,743,512,297,0.87933147,20,,2,1.24,
51,2,car,crv,118,1312,389,813,1194,424,0.25691053,20,,2,0.35510887772194305,
52,2,car,crv,249,756,447,742,507,295,0.96910256,20,,2,0.35510887772194305,
53,2,car,crv,118,1319,389,813,1201,424,0.4023961,20,,2,1.28,
54,2,car,crv,243,757,448,743,514,295,0.94143236,20,,2,1.28,
55,2,car,crv,119,1322,385,815,1203,430,0.42900166,20,,2,1.24,
56,2,car,crv,246,762,447,741,516,294,0.790523,20,,2,1.24,
57,2,car,crv,119,1319,386,815,1200,429,0.44753623,20,,2,1.28,
58,2,car,crv,248,759,450,741,511,291,0.8263495,20,,2,1.28,
59,2,car,crv,114,1318,387,813,1204,426,0.43434885,20,,2,1.2916666666666667,
60,2,car,crv,246,759,446,744,513,298,0.9186257,20,,2,1.2916666666666667,
61,2,car,crv,119,1325,389,808,1206,419,0.46840343,20,,2,1.24,
62,2,car,crv,244,759,447,741,515,294,0.83414143,20,,2,1.24,
63,2,car,crv,116,1322,388,811,1206,423,0.44209528,20,,2,1.28,
64,2,car,crv,241,764,450,741,523,291,0.8834957,20,,2,1.28,
65,2,car,crv,334,710,446,701,376,255,0.92716336,3,0,2,0.6781914893617021,
66,2,car,crv,336,711,446,700,375,254,0.9036748,3,0,2,0.6773333333333333,
67,2,car,crv,335,709,444,701,374,257,0.9452533,3,0,2,0.6871657754010695,
0,2,car,crv,253,754,447,737,501,290,0.94723046,20,,2,1.24,
1,2,car,crv,121,1308,387,817,1187,430,0.21458383,20,,2,0.36225779275484415,
2,2,car,crv,250,754,447,740,504,293,0.9610552,20,,2,0.36225779275484415,
3,2,car,crv,119,1317,388,814,1198,426,0.4732625,20,,2,1.24,
4,2,car,crv,245,758,448,742,513,294,0.94409996,20,,2,1.24,
5,2,car,crv,121,1308,388,815,1187,427,0.21448645,20,,2,0.35973041280539175,
6,2,car,crv,249,753,445,746,504,301,0.9724925,20,,2,0.35973041280539175,
7,2,car,crv,135,1302,387,821,1167,434,0.35179994,20,,2,1.2916666666666667,
8,2,car,crv,250,760,450,741,510,291,0.8736024,20,,2,1.2916666666666667,
9,2,car,crv,117,1313,390,812,1196,422,0.32242462,20,,2,1.2916666666666667,
10,2,car,crv,243,759,447,742,516,295,0.9675998,20,,2,1.2916666666666667,
11,2,car,crv,122,1311,387,814,1189,427,0.36553156,20,,2,1.2916666666666667,
12,2,car,crv,250,757,444,744,507,300,0.9479286,20,,2,1.2916666666666667,
13,2,car,crv,115,1321,388,815,1206,427,0.3674716,20,,2,1.24,
14,2,car,crv,248,756,446,740,508,294,0.92142504,20,,2,1.24,
15,2,car,crv,109,1315,384,827,1206,443,0.2820505,20,,2,1.24,
16,2,car,crv,249,758,449,736,509,287,0.91024953,20,,2,1.24,
17,2,car,crv,122,1310,388,817,1188,429,0.29904467,20,,2,0.3611111111111111,
18,2,car,crv,250,760,448,741,510,293,0.927252,20,,2,0.3611111111111111,
19,2,car,crv,129,1303,389,814,1174,425,0.27334884,20,,2,1.28,
20,2,car,crv,247,760,448,741,513,293,0.9333165,20,,2,1.28,
21,2,car,crv,122,1311,385,813,1189,428,0.35830083,20,,2,1.24,
22,2,car,crv,246,757,442,746,511,304,0.9668414,20,,2,1.24,
23,2,car,crv,122,1312,391,808,1190,417,0.34383425,20,,2,1.28,
24,2,car,crv,248,755,446,741,507,295,0.90284395,20,,2,1.28,
25,2,car,crv,129,1303,386,819,1174,433,0.2341652,20,,2,0.368824531516184,
26,2,car,crv,252,756,447,744,504,297,0.9354642,20,,2,0.368824531516184,
27,2,car,crv,253,756,446,744,503,298,0.97629297,20,,2,1.24,
28,2,car,crv,128,1307,388,817,1179,429,0.32914877,20,,2,1.2916666666666667,
29,2,car,crv,247,762,447,741,515,294,0.9441378,20,,2,1.2916666666666667,
30,2,car,crv,117,1313,388,818,1196,430,0.27251616,20,,2,0.3595317725752508,
31,2,car,crv,247,762,449,740,515,291,0.96550846,20,,2,0.3595317725752508,
32,2,car,crv,124,1305,387,820,1181,433,0.27402008,20,,2,0.36663844199830653,
33,2,car,crv,252,750,447,746,498,299,0.9501165,20,,2,0.36663844199830653,
34,2,car,crv,111,1317,390,812,1206,422,0.27479288,20,,2,0.34991708126036486,
35,2,car,crv,251,753,447,740,502,293,0.9438285,20,,2,0.34991708126036486,
36,2,car,crv,126,1309,390,814,1183,424,0.30222148,20,,2,1.2916666666666667,
37,2,car,crv,249,757,448,740,508,292,0.91383094,20,,2,1.2916666666666667,
38,2,car,crv,111,1317,390,811,1206,421,0.2941505,20,,2,0.3490878938640133,
39,2,car,crv,247,756,446,741,509,295,0.96245986,20,,2,0.3490878938640133,
40,2,car,crv,134,1300,387,818,1166,431,0.35928637,20,,2,1.28,
41,2,car,crv,251,757,447,743,506,296,0.9412378,20,,2,1.28,
42,2,car,crv,126,1312,388,815,1186,427,0.3965622,20,,2,1.24,
43,2,car,crv,252,758,446,743,506,297,0.9420341,20,,2,1.24,
44,2,car,crv,121,1316,389,809,1195,420,0.4096516,20,,2,1.24,
45,2,car,crv,244,761,447,742,517,295,0.9289579,20,,2,1.24,
46,2,car,crv,125,1312,392,805,1187,413,0.30284005,20,,2,1.24,
47,2,car,crv,245,760,447,739,515,292,0.9596912,20,,2,1.24,
48,2,car,crv,131,1307,388,812,1176,424,0.43397242,20,,2,1.2916666666666667,
49,2,car,crv,247,764,447,744,517,297,0.9014591,20,,2,1.2916666666666667,
50,2,car,crv,123,1315,388,811,1192,423,0.4968379,20,,2,1.24,
51,2,car,crv,246,758,446,743,512,297,0.87933147,20,,2,1.24,
52,2,car,crv,118,1312,389,813,1194,424,0.25691053,20,,2,0.35510887772194305,
53,2,car,crv,249,756,447,742,507,295,0.96910256,20,,2,0.35510887772194305,
54,2,car,crv,118,1319,389,813,1201,424,0.4023961,20,,2,1.28,
55,2,car,crv,243,757,448,743,514,295,0.94143236,20,,2,1.28,
56,2,car,crv,119,1322,385,815,1203,430,0.42900166,20,,2,1.24,
57,2,car,crv,246,762,447,741,516,294,0.790523,20,,2,1.24,
58,2,car,crv,119,1319,386,815,1200,429,0.44753623,20,,2,1.28,
59,2,car,crv,248,759,450,741,511,291,0.8263495,20,,2,1.28,
60,2,car,crv,114,1318,387,813,1204,426,0.43434885,20,,2,1.2916666666666667,
61,2,car,crv,246,759,446,744,513,298,0.9186257,20,,2,1.2916666666666667,
62,2,car,crv,119,1325,389,808,1206,419,0.46840343,20,,2,1.24,
63,2,car,crv,244,759,447,741,515,294,0.83414143,20,,2,1.24,
64,2,car,crv,116,1322,388,811,1206,423,0.44209528,20,,2,1.28,
65,2,car,crv,241,764,450,741,523,291,0.8834957,20,,2,1.28,
66,2,car,crv,334,710,446,701,376,255,0.92716336,3,0,2,0.6781914893617021,
67,2,car,crv,336,711,446,700,375,254,0.9036748,3,0,2,0.6773333333333333,
68,2,car,crv,335,709,444,701,374,257,0.9452533,3,0,2,0.6871657754010695,
0,2,car,crv,123,1309,388,814,1186,426,0.2760011,20,,2,1.24,
1,2,car,crv,249,758,446,740,509,294,0.950518,20,,2,1.24,
2,2,car,crv,253,754,447,737,501,290,0.94723046,20,,2,1.24,
3,2,car,crv,121,1308,387,817,1187,430,0.21458383,20,,2,0.36225779275484415,
4,2,car,crv,250,754,447,740,504,293,0.9610552,20,,2,0.36225779275484415,
5,2,car,crv,119,1317,388,814,1198,426,0.4732625,20,,2,1.24,
6,2,car,crv,245,758,448,742,513,294,0.94409996,20,,2,1.24,
7,2,car,crv,121,1308,388,815,1187,427,0.21448645,20,,2,0.35973041280539175,
8,2,car,crv,249,753,445,746,504,301,0.9724925,20,,2,0.35973041280539175,
9,2,car,crv,135,1302,387,821,1167,434,0.35179994,20,,2,1.2916666666666667,
10,2,car,crv,250,760,450,741,510,291,0.8736024,20,,2,1.2916666666666667,
11,2,car,crv,117,1313,390,812,1196,422,0.32242462,20,,2,1.2916666666666667,
12,2,car,crv,243,759,447,742,516,295,0.9675998,20,,2,1.2916666666666667,
13,2,car,crv,122,1311,387,814,1189,427,0.36553156,20,,2,1.2916666666666667,
14,2,car,crv,250,757,444,744,507,300,0.9479286,20,,2,1.2916666666666667,
15,2,car,crv,115,1321,388,815,1206,427,0.3674716,20,,2,1.24,
16,2,car,crv,248,756,446,740,508,294,0.92142504,20,,2,1.24,
17,2,car,crv,109,1315,384,827,1206,443,0.2820505,20,,2,1.24,
18,2,car,crv,249,758,449,736,509,287,0.91024953,20,,2,1.24,
19,2,car,crv,122,1310,388,817,1188,429,0.29904467,20,,2,0.3611111111111111,
20,2,car,crv,250,760,448,741,510,293,0.927252,20,,2,0.3611111111111111,
21,2,car,crv,129,1303,389,814,1174,425,0.27334884,20,,2,1.28,
22,2,car,crv,247,760,448,741,513,293,0.9333165,20,,2,1.28,
23,2,car,crv,122,1311,385,813,1189,428,0.35830083,20,,2,1.24,
24,2,car,crv,246,757,442,746,511,304,0.9668414,20,,2,1.24,
25,2,car,crv,122,1312,391,808,1190,417,0.34383425,20,,2,1.28,
26,2,car,crv,248,755,446,741,507,295,0.90284395,20,,2,1.28,
27,2,car,crv,129,1303,386,819,1174,433,0.2341652,20,,2,0.368824531516184,
28,2,car,crv,252,756,447,744,504,297,0.9354642,20,,2,0.368824531516184,
29,2,car,crv,253,756,446,744,503,298,0.97629297,20,,2,1.24,
30,2,car,crv,128,1307,388,817,1179,429,0.32914877,20,,2,1.2916666666666667,
31,2,car,crv,247,762,447,741,515,294,0.9441378,20,,2,1.2916666666666667,
32,2,car,crv,117,1313,388,818,1196,430,0.27251616,20,,2,0.3595317725752508,
33,2,car,crv,247,762,449,740,515,291,0.96550846,20,,2,0.3595317725752508,
34,2,car,crv,124,1305,387,820,1181,433,0.27402008,20,,2,0.36663844199830653,
35,2,car,crv,252,750,447,746,498,299,0.9501165,20,,2,0.36663844199830653,
36,2,car,crv,111,1317,390,812,1206,422,0.27479288,20,,2,0.34991708126036486,
37,2,car,crv,251,753,447,740,502,293,0.9438285,20,,2,0.34991708126036486,
38,2,car,crv,126,1309,390,814,1183,424,0.30222148,20,,2,1.2916666666666667,
39,2,car,crv,249,757,448,740,508,292,0.91383094,20,,2,1.2916666666666667,
40,2,car,crv,111,1317,390,811,1206,421,0.2941505,20,,2,0.3490878938640133,
41,2,car,crv,247,756,446,741,509,295,0.96245986,20,,2,0.3490878938640133,
42,2,car,crv,134,1300,387,818,1166,431,0.35928637,20,,2,1.28,
43,2,car,crv,251,757,447,743,506,296,0.9412378,20,,2,1.28,
44,2,car,crv,126,1312,388,815,1186,427,0.3965622,20,,2,1.24,
45,2,car,crv,252,758,446,743,506,297,0.9420341,20,,2,1.24,
46,2,car,crv,121,1316,389,809,1195,420,0.4096516,20,,2,1.24,
47,2,car,crv,244,761,447,742,517,295,0.9289579,20,,2,1.24,
48,2,car,crv,125,1312,392,805,1187,413,0.30284005,20,,2,1.24,
49,2,car,crv,245,760,447,739,515,292,0.9596912,20,,2,1.24,
50,2,car,crv,131,1307,388,812,1176,424,0.43397242,20,,2,1.2916666666666667,
51,2,car,crv,247,764,447,744,517,297,0.9014591,20,,2,1.2916666666666667,
52,2,car,crv,123,1315,388,811,1192,423,0.4968379,20,,2,1.24,
53,2,car,crv,246,758,446,743,512,297,0.87933147,20,,2,1.24,
54,2,car,crv,118,1312,389,813,1194,424,0.25691053,20,,2,0.35510887772194305,
55,2,car,crv,249,756,447,742,507,295,0.96910256,20,,2,0.35510887772194305,
56,2,car,crv,118,1319,389,813,1201,424,0.4023961,20,,2,1.28,
57,2,car,crv,243,757,448,743,514,295,0.94143236,20,,2,1.28,
58,2,car,crv,119,1322,385,815,1203,430,0.42900166,20,,2,1.24,
59,2,car,crv,246,762,447,741,516,294,0.790523,20,,2,1.24,
60,2,car,crv,119,1319,386,815,1200,429,0.44753623,20,,2,1.28,
61,2,car,crv,248,759,450,741,511,291,0.8263495,20,,2,1.28,
62,2,car,crv,114,1318,387,813,1204,426,0.43434885,20,,2,1.2916666666666667,
63,2,car,crv,246,759,446,744,513,298,0.9186257,20,,2,1.2916666666666667,
64,2,car,crv,119,1325,389,808,1206,419,0.46840343,20,,2,1.24,
65,2,car,crv,244,759,447,741,515,294,0.83414143,20,,2,1.24,
66,2,car,crv,116,1322,388,811,1206,423,0.44209528,20,,2,1.28,
67,2,car,crv,241,764,450,741,523,291,0.8834957,20,,2,1.28,
68,2,car,crv,334,710,446,701,376,255,0.92716336,3,0,2,0.6781914893617021,
69,2,car,crv,336,711,446,700,375,254,0.9036748,3,0,2,0.6773333333333333,
70,2,car,crv,335,709,444,701,374,257,0.9452533,3,0,2,0.6871657754010695,
0,2,car,crv,113,1313,388,814,1200,426,0.2754978,20,,2,1.24,
1,2,car,crv,244,756,445,743,512,298,0.96916515,20,,2,1.24,
2,2,car,crv,123,1309,388,814,1186,426,0.2760011,20,,2,1.24,
3,2,car,crv,249,758,446,740,509,294,0.950518,20,,2,1.24,
4,2,car,crv,253,754,447,737,501,290,0.94723046,20,,2,1.24,
5,2,car,crv,121,1308,387,817,1187,430,0.21458383,20,,2,0.36225779275484415,
6,2,car,crv,250,754,447,740,504,293,0.9610552,20,,2,0.36225779275484415,
7,2,car,crv,119,1317,388,814,1198,426,0.4732625,20,,2,1.24,
8,2,car,crv,245,758,448,742,513,294,0.94409996,20,,2,1.24,
9,2,car,crv,121,1308,388,815,1187,427,0.21448645,20,,2,0.35973041280539175,
10,2,car,crv,249,753,445,746,504,301,0.9724925,20,,2,0.35973041280539175,
11,2,car,crv,135,1302,387,821,1167,434,0.35179994,20,,2,1.2916666666666667,
12,2,car,crv,250,760,450,741,510,291,0.8736024,20,,2,1.2916666666666667,
13,2,car,crv,117,1313,390,812,1196,422,0.32242462,20,,2,1.2916666666666667,
14,2,car,crv,243,759,447,742,516,295,0.9675998,20,,2,1.2916666666666667,
15,2,car,crv,122,1311,387,814,1189,427,0.36553156,20,,2,1.2916666666666667,
16,2,car,crv,250,757,444,744,507,300,0.9479286,20,,2,1.2916666666666667,
17,2,car,crv,115,1321,388,815,1206,427,0.3674716,20,,2,1.24,
18,2,car,crv,248,756,446,740,508,294,0.92142504,20,,2,1.24,
19,2,car,crv,109,1315,384,827,1206,443,0.2820505,20,,2,1.24,
20,2,car,crv,249,758,449,736,509,287,0.91024953,20,,2,1.24,
21,2,car,crv,122,1310,388,817,1188,429,0.29904467,20,,2,0.3611111111111111,
22,2,car,crv,250,760,448,741,510,293,0.927252,20,,2,0.3611111111111111,
23,2,car,crv,129,1303,389,814,1174,425,0.27334884,20,,2,1.28,
24,2,car,crv,247,760,448,741,513,293,0.9333165,20,,2,1.28,
25,2,car,crv,122,1311,385,813,1189,428,0.35830083,20,,2,1.24,
26,2,car,crv,246,757,442,746,511,304,0.9668414,20,,2,1.24,
27,2,car,crv,122,1312,391,808,1190,417,0.34383425,20,,2,1.28,
28,2,car,crv,248,755,446,741,507,295,0.90284395,20,,2,1.28,
29,2,car,crv,129,1303,386,819,1174,433,0.2341652,20,,2,0.368824531516184,
30,2,car,crv,252,756,447,744,504,297,0.9354642,20,,2,0.368824531516184,
31,2,car,crv,253,756,446,744,503,298,0.97629297,20,,2,1.24,
32,2,car,crv,128,1307,388,817,1179,429,0.32914877,20,,2,1.2916666666666667,
33,2,car,crv,247,762,447,741,515,294,0.9441378,20,,2,1.2916666666666667,
34,2,car,crv,117,1313,388,818,1196,430,0.27251616,20,,2,0.3595317725752508,
35,2,car,crv,247,762,449,740,515,291,0.96550846,20,,2,0.3595317725752508,
36,2,car,crv,124,1305,387,820,1181,433,0.27402008,20,,2,0.36663844199830653,
37,2,car,crv,252,750,447,746,498,299,0.9501165,20,,2,0.36663844199830653,
38,2,car,crv,111,1317,390,812,1206,422,0.27479288,20,,2,0.34991708126036486,
39,2,car,crv,251,753,447,740,502,293,0.9438285,20,,2,0.34991708126036486,
40,2,car,crv,126,1309,390,814,1183,424,0.30222148,20,,2,1.2916666666666667,
41,2,car,crv,249,757,448,740,508,292,0.91383094,20,,2,1.2916666666666667,
42,2,car,crv,111,1317,390,811,1206,421,0.2941505,20,,2,0.3490878938640133,
43,2,car,crv,247,756,446,741,509,295,0.96245986,20,,2,0.3490878938640133,
44,2,car,crv,134,1300,387,818,1166,431,0.35928637,20,,2,1.28,
45,2,car,crv,251,757,447,743,506,296,0.9412378,20,,2,1.28,
46,2,car,crv,126,1312,388,815,1186,427,0.3965622,20,,2,1.24,
47,2,car,crv,252,758,446,743,506,297,0.9420341,20,,2,1.24,
48,2,car,crv,121,1316,389,809,1195,420,0.4096516,20,,2,1.24,
49,2,car,crv,244,761,447,742,517,295,0.9289579,20,,2,1.24,
50,2,car,crv,125,1312,392,805,1187,413,0.30284005,20,,2,1.24,
51,2,car,crv,245,760,447,739,515,292,0.9596912,20,,2,1.24,
52,2,car,crv,131,1307,388,812,1176,424,0.43397242,20,,2,1.2916666666666667,
53,2,car,crv,247,764,447,744,517,297,0.9014591,20,,2,1.2916666666666667,
54,2,car,crv,123,1315,388,811,1192,423,0.4968379,20,,2,1.24,
55,2,car,crv,246,758,446,743,512,297,0.87933147,20,,2,1.24,
56,2,car,crv,118,1312,389,813,1194,424,0.25691053,20,,2,0.35510887772194305,
57,2,car,crv,249,756,447,742,507,295,0.96910256,20,,2,0.35510887772194305,
58,2,car,crv,118,1319,389,813,1201,424,0.4023961,20,,2,1.28,
59,2,car,crv,243,757,448,743,514,295,0.94143236,20,,2,1.28,
60,2,car,crv,119,1322,385,815,1203,430,0.42900166,20,,2,1.24,
61,2,car,crv,246,762,447,741,516,294,0.790523,20,,2,1.24,
62,2,car,crv,119,1319,386,815,1200,429,0.44753623,20,,2,1.28,
63,2,car,crv,248,759,450,741,511,291,0.8263495,20,,2,1.28,
64,2,car,crv,114,1318,387,813,1204,426,0.43434885,20,,2,1.2916666666666667,
65,2,car,crv,246,759,446,744,513,298,0.9186257,20,,2,1.2916666666666667,
66,2,car,crv,119,1325,389,808,1206,419,0.46840343,20,,2,1.24,
67,2,car,crv,244,759,447,741,515,294,0.83414143,20,,2,1.24,
68,2,car,crv,116,1322,388,811,1206,423,0.44209528,20,,2,1.28,
69,2,car,crv,241,764,450,741,523,291,0.8834957,20,,2,1.28,
70,2,car,crv,334,710,446,701,376,255,0.92716336,3,0,2,0.6781914893617021,
71,2,car,crv,336,711,446,700,375,254,0.9036748,3,0,2,0.6773333333333333,
72,2,car,crv,335,709,444,701,374,257,0.9452533,3,0,2,0.6871657754010695,
0,2,car,crv,250,754,444,740,504,296,0.96969557,20,,2,1.24,
1,2,car,crv,113,1313,388,814,1200,426,0.2754978,20,,2,1.24,
2,2,car,crv,244,756,445,743,512,298,0.96916515,20,,2,1.24,
3,2,car,crv,123,1309,388,814,1186,426,0.2760011,20,,2,1.24,
4,2,car,crv,249,758,446,740,509,294,0.950518,20,,2,1.24,
5,2,car,crv,253,754,447,737,501,290,0.94723046,20,,2,1.24,
6,2,car,crv,121,1308,387,817,1187,430,0.21458383,20,,2,0.36225779275484415,
7,2,car,crv,250,754,447,740,504,293,0.9610552,20,,2,0.36225779275484415,
8,2,car,crv,119,1317,388,814,1198,426,0.4732625,20,,2,1.24,
9,2,car,crv,245,758,448,742,513,294,0.94409996,20,,2,1.24,
10,2,car,crv,121,1308,388,815,1187,427,0.21448645,20,,2,0.35973041280539175,
11,2,car,crv,249,753,445,746,504,301,0.9724925,20,,2,0.35973041280539175,
12,2,car,crv,135,1302,387,821,1167,434,0.35179994,20,,2,1.2916666666666667,
13,2,car,crv,250,760,450,741,510,291,0.8736024,20,,2,1.2916666666666667,
14,2,car,crv,117,1313,390,812,1196,422,0.32242462,20,,2,1.2916666666666667,
15,2,car,crv,243,759,447,742,516,295,0.9675998,20,,2,1.2916666666666667,
16,2,car,crv,122,1311,387,814,1189,427,0.36553156,20,,2,1.2916666666666667,
17,2,car,crv,250,757,444,744,507,300,0.9479286,20,,2,1.2916666666666667,
18,2,car,crv,115,1321,388,815,1206,427,0.3674716,20,,2,1.24,
19,2,car,crv,248,756,446,740,508,294,0.92142504,20,,2,1.24,
20,2,car,crv,109,1315,384,827,1206,443,0.2820505,20,,2,1.24,
21,2,car,crv,249,758,449,736,509,287,0.91024953,20,,2,1.24,
22,2,car,crv,122,1310,388,817,1188,429,0.29904467,20,,2,0.3611111111111111,
23,2,car,crv,250,760,448,741,510,293,0.927252,20,,2,0.3611111111111111,
24,2,car,crv,129,1303,389,814,1174,425,0.27334884,20,,2,1.28,
25,2,car,crv,247,760,448,741,513,293,0.9333165,20,,2,1.28,
26,2,car,crv,122,1311,385,813,1189,428,0.35830083,20,,2,1.24,
27,2,car,crv,246,757,442,746,511,304,0.9668414,20,,2,1.24,
28,2,car,crv,122,1312,391,808,1190,417,0.34383425,20,,2,1.28,
29,2,car,crv,248,755,446,741,507,295,0.90284395,20,,2,1.28,
30,2,car,crv,129,1303,386,819,1174,433,0.2341652,20,,2,0.368824531516184,
31,2,car,crv,252,756,447,744,504,297,0.9354642,20,,2,0.368824531516184,
32,2,car,crv,253,756,446,744,503,298,0.97629297,20,,2,1.24,
33,2,car,crv,128,1307,388,817,1179,429,0.32914877,20,,2,1.2916666666666667,
34,2,car,crv,247,762,447,741,515,294,0.9441378,20,,2,1.2916666666666667,
35,2,car,crv,117,1313,388,818,1196,430,0.27251616,20,,2,0.3595317725752508,
36,2,car,crv,247,762,449,740,515,291,0.96550846,20,,2,0.3595317725752508,
37,2,car,crv,124,1305,387,820,1181,433,0.27402008,20,,2,0.36663844199830653,
38,2,car,crv,252,750,447,746,498,299,0.9501165,20,,2,0.36663844199830653,
39,2,car,crv,111,1317,390,812,1206,422,0.27479288,20,,2,0.34991708126036486,
40,2,car,crv,251,753,447,740,502,293,0.9438285,20,,2,0.34991708126036486,
41,2,car,crv,126,1309,390,814,1183,424,0.30222148,20,,2,1.2916666666666667,
42,2,car,crv,249,757,448,740,508,292,0.91383094,20,,2,1.2916666666666667,
43,2,car,crv,111,1317,390,811,1206,421,0.2941505,20,,2,0.3490878938640133,
44,2,car,crv,247,756,446,741,509,295,0.96245986,20,,2,0.3490878938640133,
45,2,car,crv,134,1300,387,818,1166,431,0.35928637,20,,2,1.28,
46,2,car,crv,251,757,447,743,506,296,0.9412378,20,,2,1.28,
47,2,car,crv,126,1312,388,815,1186,427,0.3965622,20,,2,1.24,
48,2,car,crv,252,758,446,743,506,297,0.9420341,20,,2,1.24,
49,2,car,crv,121,1316,389,809,1195,420,0.4096516,20,,2,1.24,
50,2,car,crv,244,761,447,742,517,295,0.9289579,20,,2,1.24,
51,2,car,crv,125,1312,392,805,1187,413,0.30284005,20,,2,1.24,
52,2,car,crv,245,760,447,739,515,292,0.9596912,20,,2,1.24,
53,2,car,crv,131,1307,388,812,1176,424,0.43397242,20,,2,1.2916666666666667,
54,2,car,crv,247,764,447,744,517,297,0.9014591,20,,2,1.2916666666666667,
55,2,car,crv,123,1315,388,811,1192,423,0.4968379,20,,2,1.24,
56,2,car,crv,246,758,446,743,512,297,0.87933147,20,,2,1.24,
57,2,car,crv,118,1312,389,813,1194,424,0.25691053,20,,2,0.35510887772194305,
58,2,car,crv,249,756,447,742,507,295,0.96910256,20,,2,0.35510887772194305,
59,2,car,crv,118,1319,389,813,1201,424,0.4023961,20,,2,1.28,
60,2,car,crv,243,757,448,743,514,295,0.94143236,20,,2,1.28,
61,2,car,crv,119,1322,385,815,1203,430,0.42900166,20,,2,1.24,
62,2,car,crv,246,762,447,741,516,294,0.790523,20,,2,1.24,
63,2,car,crv,119,1319,386,815,1200,429,0.44753623,20,,2,1.28,
64,2,car,crv,248,759,450,741,511,291,0.8263495,20,,2,1.28,
65,2,car,crv,114,1318,387,813,1204,426,0.43434885,20,,2,1.2916666666666667,
66,2,car,crv,246,759,446,744,513,298,0.9186257,20,,2,1.2916666666666667,
67,2,car,crv,119,1325,389,808,1206,419,0.46840343,20,,2,1.24,
68,2,car,crv,244,759,447,741,515,294,0.83414143,20,,2,1.24,
69,2,car,crv,116,1322,388,811,1206,423,0.44209528,20,,2,1.28,
70,2,car,crv,241,764,450,741,523,291,0.8834957,20,,2,1.28,
71,2,car,crv,334,710,446,701,376,255,0.92716336,3,0,2,0.6781914893617021,
72,2,car,crv,336,711,446,700,375,254,0.9036748,3,0,2,0.6773333333333333,
73,2,car,crv,335,709,444,701,374,257,0.9452533,3,0,2,0.6871657754010695,
0,2,car,crv,125,1310,389,811,1185,422,0.32076746,20,,2,0.3561181434599156,
1,2,car,crv,250,758,446,739,508,293,0.9462212,20,,2,0.3561181434599156,
2,2,car,crv,250,754,444,740,504,296,0.96969557,20,,2,1.24,
3,2,car,crv,113,1313,388,814,1200,426,0.2754978,20,,2,1.24,
4,2,car,crv,244,756,445,743,512,298,0.96916515,20,,2,1.24,
5,2,car,crv,123,1309,388,814,1186,426,0.2760011,20,,2,1.24,
6,2,car,crv,249,758,446,740,509,294,0.950518,20,,2,1.24,
7,2,car,crv,253,754,447,737,501,290,0.94723046,20,,2,1.24,
8,2,car,crv,121,1308,387,817,1187,430,0.21458383,20,,2,0.36225779275484415,
9,2,car,crv,250,754,447,740,504,293,0.9610552,20,,2,0.36225779275484415,
10,2,car,crv,119,1317,388,814,1198,426,0.4732625,20,,2,1.24,
11,2,car,crv,245,758,448,742,513,294,0.94409996,20,,2,1.24,
12,2,car,crv,121,1308,388,815,1187,427,0.21448645,20,,2,0.35973041280539175,
13,2,car,crv,249,753,445,746,504,301,0.9724925,20,,2,0.35973041280539175,
14,2,car,crv,135,1302,387,821,1167,434,0.35179994,20,,2,1.2916666666666667,
15,2,car,crv,250,760,450,741,510,291,0.8736024,20,,2,1.2916666666666667,
16,2,car,crv,117,1313,390,812,1196,422,0.32242462,20,,2,1.2916666666666667,
17,2,car,crv,243,759,447,742,516,295,0.9675998,20,,2,1.2916666666666667,
18,2,car,crv,122,1311,387,814,1189,427,0.36553156,20,,2,1.2916666666666667,
19,2,car,crv,250,757,444,744,507,300,0.9479286,20,,2,1.2916666666666667,
20,2,car,crv,115,1321,388,815,1206,427,0.3674716,20,,2,1.24,
21,2,car,crv,248,756,446,740,508,294,0.92142504,20,,2,1.24,
22,2,car,crv,109,1315,384,827,1206,443,0.2820505,20,,2,1.24,
23,2,car,crv,249,758,449,736,509,287,0.91024953,20,,2,1.24,
24,2,car,crv,122,1310,388,817,1188,429,0.29904467,20,,2,0.3611111111111111,
25,2,car,crv,250,760,448,741,510,293,0.927252,20,,2,0.3611111111111111,
26,2,car,crv,129,1303,389,814,1174,425,0.27334884,20,,2,1.28,
27,2,car,crv,247,760,448,741,513,293,0.9333165,20,,2,1.28,
28,2,car,crv,122,1311,385,813,1189,428,0.35830083,20,,2,1.24,
29,2,car,crv,246,757,442,746,511,304,0.9668414,20,,2,1.24,
30,2,car,crv,122,1312,391,808,1190,417,0.34383425,20,,2,1.28,
31,2,car,crv,248,755,446,741,507,295,0.90284395,20,,2,1.28,
32,2,car,crv,129,1303,386,819,1174,433,0.2341652,20,,2,0.368824531516184,
33,2,car,crv,252,756,447,744,504,297,0.9354642,20,,2,0.368824531516184,
34,2,car,crv,253,756,446,744,503,298,0.97629297,20,,2,1.24,
35,2,car,crv,128,1307,388,817,1179,429,0.32914877,20,,2,1.2916666666666667,
36,2,car,crv,247,762,447,741,515,294,0.9441378,20,,2,1.2916666666666667,
37,2,car,crv,117,1313,388,818,1196,430,0.27251616,20,,2,0.3595317725752508,
38,2,car,crv,247,762,449,740,515,291,0.96550846,20,,2,0.3595317725752508,
39,2,car,crv,124,1305,387,820,1181,433,0.27402008,20,,2,0.36663844199830653,
40,2,car,crv,252,750,447,746,498,299,0.9501165,20,,2,0.36663844199830653,
41,2,car,crv,111,1317,390,812,1206,422,0.27479288,20,,2,0.34991708126036486,
42,2,car,crv,251,753,447,740,502,293,0.9438285,20,,2,0.34991708126036486,
43,2,car,crv,126,1309,390,814,1183,424,0.30222148,20,,2,1.2916666666666667,
44,2,car,crv,249,757,448,740,508,292,0.91383094,20,,2,1.2916666666666667,
45,2,car,crv,111,1317,390,811,1206,421,0.2941505,20,,2,0.3490878938640133,
46,2,car,crv,247,756,446,741,509,295,0.96245986,20,,2,0.3490878938640133,
47,2,car,crv,134,1300,387,818,1166,431,0.35928637,20,,2,1.28,
48,2,car,crv,251,757,447,743,506,296,0.9412378,20,,2,1.28,
49,2,car,crv,126,1312,388,815,1186,427,0.3965622,20,,2,1.24,
50,2,car,crv,252,758,446,743,506,297,0.9420341,20,,2,1.24,
51,2,car,crv,121,1316,389,809,1195,420,0.4096516,20,,2,1.24,
52,2,car,crv,244,761,447,742,517,295,0.9289579,20,,2,1.24,
53,2,car,crv,125,1312,392,805,1187,413,0.30284005,20,,2,1.24,
54,2,car,crv,245,760,447,739,515,292,0.9596912,20,,2,1.24,
55,2,car,crv,131,1307,388,812,1176,424,0.43397242,20,,2,1.2916666666666667,
56,2,car,crv,247,764,447,744,517,297,0.9014591,20,,2,1.2916666666666667,
57,2,car,crv,123,1315,388,811,1192,423,0.4968379,20,,2,1.24,
58,2,car,crv,246,758,446,743,512,297,0.87933147,20,,2,1.24,
59,2,car,crv,118,1312,389,813,1194,424,0.25691053,20,,2,0.35510887772194305,
60,2,car,crv,249,756,447,742,507,295,0.96910256,20,,2,0.35510887772194305,
61,2,car,crv,118,1319,389,813,1201,424,0.4023961,20,,2,1.28,
62,2,car,crv,243,757,448,743,514,295,0.94143236,20,,2,1.28,
63,2,car,crv,119,1322,385,815,1203,430,0.42900166,20,,2,1.24,
64,2,car,crv,246,762,447,741,516,294,0.790523,20,,2,1.24,
65,2,car,crv,119,1319,386,815,1200,429,0.44753623,20,,2,1.28,
66,2,car,crv,248,759,450,741,511,291,0.8263495,20,,2,1.28,
67,2,car,crv,114,1318,387,813,1204,426,0.43434885,20,,2,1.2916666666666667,
68,2,car,crv,246,759,446,744,513,298,0.9186257,20,,2,1.2916666666666667,
69,2,car,crv,119,1325,389,808,1206,419,0.46840343,20,,2,1.24,
70,2,car,crv,244,759,447,741,515,294,0.83414143,20,,2,1.24,
71,2,car,crv,116,1322,388,811,1206,423,0.44209528,20,,2,1.28,
72,2,car,crv,241,764,450,741,523,291,0.8834957,20,,2,1.28,
73,2,car,crv,334,710,446,701,376,255,0.92716336,3,0,2,0.6781914893617021,
74,2,car,crv,336,711,446,700,375,254,0.9036748,3,0,2,0.6773333333333333,
75,2,car,crv,335,709,444,701,374,257,0.9452533,3,0,2,0.6871657754010695,
0,2,car,crv,118,1316,385,817,1198,432,0.46192503,20,,2,1.24,
1,2,car,crv,242,760,449,744,518,295,0.9251644,20,,2,1.24,
2,2,car,crv,125,1310,389,811,1185,422,0.32076746,20,,2,0.3561181434599156,
3,2,car,crv,250,758,446,739,508,293,0.9462212,20,,2,0.3561181434599156,
4,2,car,crv,250,754,444,740,504,296,0.96969557,20,,2,1.24,
5,2,car,crv,113,1313,388,814,1200,426,0.2754978,20,,2,1.24,
6,2,car,crv,244,756,445,743,512,298,0.96916515,20,,2,1.24,
7,2,car,crv,123,1309,388,814,1186,426,0.2760011,20,,2,1.24,
8,2,car,crv,249,758,446,740,509,294,0.950518,20,,2,1.24,
9,2,car,crv,253,754,447,737,501,290,0.94723046,20,,2,1.24,
10,2,car,crv,121,1308,387,817,1187,430,0.21458383,20,,2,0.36225779275484415,
11,2,car,crv,250,754,447,740,504,293,0.9610552,20,,2,0.36225779275484415,
12,2,car,crv,119,1317,388,814,1198,426,0.4732625,20,,2,1.24,
13,2,car,crv,245,758,448,742,513,294,0.94409996,20,,2,1.24,
14,2,car,crv,121,1308,388,815,1187,427,0.21448645,20,,2,0.35973041280539175,
15,2,car,crv,249,753,445,746,504,301,0.9724925,20,,2,0.35973041280539175,
16,2,car,crv,135,1302,387,821,1167,434,0.35179994,20,,2,1.2916666666666667,
17,2,car,crv,250,760,450,741,510,291,0.8736024,20,,2,1.2916666666666667,
18,2,car,crv,117,1313,390,812,1196,422,0.32242462,20,,2,1.2916666666666667,
19,2,car,crv,243,759,447,742,516,295,0.9675998,20,,2,1.2916666666666667,
20,2,car,crv,122,1311,387,814,1189,427,0.36553156,20,,2,1.2916666666666667,
21,2,car,crv,250,757,444,744,507,300,0.9479286,20,,2,1.2916666666666667,
22,2,car,crv,115,1321,388,815,1206,427,0.3674716,20,,2,1.24,
23,2,car,crv,248,756,446,740,508,294,0.92142504,20,,2,1.24,
24,2,car,crv,109,1315,384,827,1206,443,0.2820505,20,,2,1.24,
25,2,car,crv,249,758,449,736,509,287,0.91024953,20,,2,1.24,
26,2,car,crv,122,1310,388,817,1188,429,0.29904467,20,,2,0.3611111111111111,
27,2,car,crv,250,760,448,741,510,293,0.927252,20,,2,0.3611111111111111,
28,2,car,crv,129,1303,389,814,1174,425,0.27334884,20,,2,1.28,
29,2,car,crv,247,760,448,741,513,293,0.9333165,20,,2,1.28,
30,2,car,crv,122,1311,385,813,1189,428,0.35830083,20,,2,1.24,
31,2,car,crv,246,757,442,746,511,304,0.9668414,20,,2,1.24,
32,2,car,crv,122,1312,391,808,1190,417,0.34383425,20,,2,1.28,
33,2,car,crv,248,755,446,741,507,295,0.90284395,20,,2,1.28,
34,2,car,crv,129,1303,386,819,1174,433,0.2341652,20,,2,0.368824531516184,
35,2,car,crv,252,756,447,744,504,297,0.9354642,20,,2,0.368824531516184,
36,2,car,crv,253,756,446,744,503,298,0.97629297,20,,2,1.24,
37,2,car,crv,128,1307,388,817,1179,429,0.32914877,20,,2,1.2916666666666667,
38,2,car,crv,247,762,447,741,515,294,0.9441378,20,,2,1.2916666666666667,
39,2,car,crv,117,1313,388,818,1196,430,0.27251616,20,,2,0.3595317725752508,
40,2,car,crv,247,762,449,740,515,291,0.96550846,20,,2,0.3595317725752508,
41,2,car,crv,124,1305,387,820,1181,433,0.27402008,20,,2,0.36663844199830653,
42,2,car,crv,252,750,447,746,498,299,0.9501165,20,,2,0.36663844199830653,
43,2,car,crv,111,1317,390,812,1206,422,0.27479288,20,,2,0.34991708126036486,
44,2,car,crv,251,753,447,740,502,293,0.9438285,20,,2,0.34991708126036486,
45,2,car,crv,126,1309,390,814,1183,424,0.30222148,20,,2,1.2916666666666667,
46,2,car,crv,249,757,448,740,508,292,0.91383094,20,,2,1.2916666666666667,
47,2,car,crv,111,1317,390,811,1206,421,0.2941505,20,,2,0.3490878938640133,
48,2,car,crv,247,756,446,741,509,295,0.96245986,20,,2,0.3490878938640133,
49,2,car,crv,134,1300,387,818,1166,431,0.35928637,20,,2,1.28,
50,2,car,crv,251,757,447,743,506,296,0.9412378,20,,2,1.28,
51,2,car,crv,126,1312,388,815,1186,427,0.3965622,20,,2,1.24,
52,2,car,crv,252,758,446,743,506,297,0.9420341,20,,2,1.24,
53,2,car,crv,121,1316,389,809,1195,420,0.4096516,20,,2,1.24,
54,2,car,crv,244,761,447,742,517,295,0.9289579,20,,2,1.24,
55,2,car,crv,125,1312,392,805,1187,413,0.30284005,20,,2,1.24,
56,2,car,crv,245,760,447,739,515,292,0.9596912,20,,2,1.24,
57,2,car,crv,131,1307,388,812,1176,424,0.43397242,20,,2,1.2916666666666667,
58,2,car,crv,247,764,447,744,517,297,0.9014591,20,,2,1.2916666666666667,
59,2,car,crv,123,1315,388,811,1192,423,0.4968379,20,,2,1.24,
60,2,car,crv,246,758,446,743,512,297,0.87933147,20,,2,1.24,
61,2,car,crv,118,1312,389,813,1194,424,0.25691053,20,,2,0.35510887772194305,
62,2,car,crv,249,756,447,742,507,295,0.96910256,20,,2,0.35510887772194305,
63,2,car,crv,118,1319,389,813,1201,424,0.4023961,20,,2,1.28,
64,2,car,crv,243,757,448,743,514,295,0.94143236,20,,2,1.28,
65,2,car,crv,119,1322,385,815,1203,430,0.42900166,20,,2,1.24,
66,2,car,crv,246,762,447,741,516,294,0.790523,20,,2,1.24,
67,2,car,crv,119,1319,386,815,1200,429,0.44753623,20,,2,1.28,
68,2,car,crv,248,759,450,741,511,291,0.8263495,20,,2,1.28,
69,2,car,crv,114,1318,387,813,1204,426,0.43434885,20,,2,1.2916666666666667,
70,2,car,crv,246,759,446,744,513,298,0.9186257,20,,2,1.2916666666666667,
71,2,car,crv,119,1325,389,808,1206,419,0.46840343,20,,2,1.24,
72,2,car,crv,244,759,447,741,515,294,0.83414143,20,,2,1.24,
73,2,car,crv,116,1322,388,811,1206,423,0.44209528,20,,2,1.28,
74,2,car,crv,241,764,450,741,523,291,0.8834957,20,,2,1.28,
75,2,car,crv,334,710,446,701,376,255,0.92716336,3,0,2,0.6781914893617021,
76,2,car,crv,336,711,446,700,375,254,0.9036748,3,0,2,0.6773333333333333,
77,2,car,crv,335,709,444,701,374,257,0.9452533,3,0,2,0.6871657754010695,
0,2,car,crv,126,1307,387,813,1181,426,0.3400013,20,,2,1.24,
1,2,car,crv,250,757,446,745,507,299,0.93553233,20,,2,1.24,
2,2,car,crv,118,1316,385,817,1198,432,0.46192503,20,,2,1.24,
3,2,car,crv,242,760,449,744,518,295,0.9251644,20,,2,1.24,
4,2,car,crv,125,1310,389,811,1185,422,0.32076746,20,,2,0.3561181434599156,
5,2,car,crv,250,758,446,739,508,293,0.9462212,20,,2,0.3561181434599156,
6,2,car,crv,250,754,444,740,504,296,0.96969557,20,,2,1.24,
7,2,car,crv,113,1313,388,814,1200,426,0.2754978,20,,2,1.24,
8,2,car,crv,244,756,445,743,512,298,0.96916515,20,,2,1.24,
9,2,car,crv,123,1309,388,814,1186,426,0.2760011,20,,2,1.24,
10,2,car,crv,249,758,446,740,509,294,0.950518,20,,2,1.24,
11,2,car,crv,253,754,447,737,501,290,0.94723046,20,,2,1.24,
12,2,car,crv,121,1308,387,817,1187,430,0.21458383,20,,2,0.36225779275484415,
13,2,car,crv,250,754,447,740,504,293,0.9610552,20,,2,0.36225779275484415,
14,2,car,crv,119,1317,388,814,1198,426,0.4732625,20,,2,1.24,
15,2,car,crv,245,758,448,742,513,294,0.94409996,20,,2,1.24,
16,2,car,crv,121,1308,388,815,1187,427,0.21448645,20,,2,0.35973041280539175,
17,2,car,crv,249,753,445,746,504,301,0.9724925,20,,2,0.35973041280539175,
18,2,car,crv,135,1302,387,821,1167,434,0.35179994,20,,2,1.2916666666666667,
19,2,car,crv,250,760,450,741,510,291,0.8736024,20,,2,1.2916666666666667,
20,2,car,crv,117,1313,390,812,1196,422,0.32242462,20,,2,1.2916666666666667,
21,2,car,crv,243,759,447,742,516,295,0.9675998,20,,2,1.2916666666666667,
22,2,car,crv,122,1311,387,814,1189,427,0.36553156,20,,2,1.2916666666666667,
23,2,car,crv,250,757,444,744,507,300,0.9479286,20,,2,1.2916666666666667,
24,2,car,crv,115,1321,388,815,1206,427,0.3674716,20,,2,1.24,
25,2,car,crv,248,756,446,740,508,294,0.92142504,20,,2,1.24,
26,2,car,crv,109,1315,384,827,1206,443,0.2820505,20,,2,1.24,
27,2,car,crv,249,758,449,736,509,287,0.91024953,20,,2,1.24,
28,2,car,crv,122,1310,388,817,1188,429,0.29904467,20,,2,0.3611111111111111,
29,2,car,crv,250,760,448,741,510,293,0.927252,20,,2,0.3611111111111111,
30,2,car,crv,129,1303,389,814,1174,425,0.27334884,20,,2,1.28,
31,2,car,crv,247,760,448,741,513,293,0.9333165,20,,2,1.28,
32,2,car,crv,122,1311,385,813,1189,428,0.35830083,20,,2,1.24,
33,2,car,crv,246,757,442,746,511,304,0.9668414,20,,2,1.24,
34,2,car,crv,122,1312,391,808,1190,417,0.34383425,20,,2,1.28,
35,2,car,crv,248,755,446,741,507,295,0.90284395,20,,2,1.28,
36,2,car,crv,129,1303,386,819,1174,433,0.2341652,20,,2,0.368824531516184,
37,2,car,crv,252,756,447,744,504,297,0.9354642,20,,2,0.368824531516184,
38,2,car,crv,253,756,446,744,503,298,0.97629297,20,,2,1.24,
39,2,car,crv,128,1307,388,817,1179,429,0.32914877,20,,2,1.2916666666666667,
40,2,car,crv,247,762,447,741,515,294,0.9441378,20,,2,1.2916666666666667,
41,2,car,crv,117,1313,388,818,1196,430,0.27251616,20,,2,0.3595317725752508,
42,2,car,crv,247,762,449,740,515,291,0.96550846,20,,2,0.3595317725752508,
43,2,car,crv,124,1305,387,820,1181,433,0.27402008,20,,2,0.36663844199830653,
44,2,car,crv,252,750,447,746,498,299,0.9501165,20,,2,0.36663844199830653,
45,2,car,crv,111,1317,390,812,1206,422,0.27479288,20,,2,0.34991708126036486,
46,2,car,crv,251,753,447,740,502,293,0.9438285,20,,2,0.34991708126036486,
47,2,car,crv,126,1309,390,814,1183,424,0.30222148,20,,2,1.2916666666666667,
48,2,car,crv,249,757,448,740,508,292,0.91383094,20,,2,1.2916666666666667,
49,2,car,crv,111,1317,390,811,1206,421,0.2941505,20,,2,0.3490878938640133,
50,2,car,crv,247,756,446,741,509,295,0.96245986,20,,2,0.3490878938640133,
51,2,car,crv,134,1300,387,818,1166,431,0.35928637,20,,2,1.28,
52,2,car,crv,251,757,447,743,506,296,0.9412378,20,,2,1.28,
53,2,car,crv,126,1312,388,815,1186,427,0.3965622,20,,2,1.24,
54,2,car,crv,252,758,446,743,506,297,0.9420341,20,,2,1.24,
55,2,car,crv,121,1316,389,809,1195,420,0.4096516,20,,2,1.24,
56,2,car,crv,244,761,447,742,517,295,0.9289579,20,,2,1.24,
57,2,car,crv,125,1312,392,805,1187,413,0.30284005,20,,2,1.24,
58,2,car,crv,245,760,447,739,515,292,0.9596912,20,,2,1.24,
59,2,car,crv,131,1307,388,812,1176,424,0.43397242,20,,2,1.2916666666666667,
60,2,car,crv,247,764,447,744,517,297,0.9014591,20,,2,1.2916666666666667,
61,2,car,crv,123,1315,388,811,1192,423,0.4968379,20,,2,1.24,
62,2,car,crv,246,758,446,743,512,297,0.87933147,20,,2,1.24,
63,2,car,crv,118,1312,389,813,1194,424,0.25691053,20,,2,0.35510887772194305,
64,2,car,crv,249,756,447,742,507,295,0.96910256,20,,2,0.35510887772194305,
65,2,car,crv,118,1319,389,813,1201,424,0.4023961,20,,2,1.28,
66,2,car,crv,243,757,448,743,514,295,0.94143236,20,,2,1.28,
67,2,car,crv,119,1322,385,815,1203,430,0.42900166,20,,2,1.24,
68,2,car,crv,246,762,447,741,516,294,0.790523,20,,2,1.24,
69,2,car,crv,119,1319,386,815,1200,429,0.44753623,20,,2,1.28,
70,2,car,crv,248,759,450,741,511,291,0.8263495,20,,2,1.28,
71,2,car,crv,114,1318,387,813,1204,426,0.43434885,20,,2,1.2916666666666667,
72,2,car,crv,246,759,446,744,513,298,0.9186257,20,,2,1.2916666666666667,
73,2,car,crv,119,1325,389,808,1206,419,0.46840343,20,,2,1.24,
74,2,car,crv,244,759,447,741,515,294,0.83414143,20,,2,1.24,
75,2,car,crv,116,1322,388,811,1206,423,0.44209528,20,,2,1.28,
76,2,car,crv,241,764,450,741,523,291,0.8834957,20,,2,1.28,
77,2,car,crv,334,710,446,701,376,255,0.92716336,3,0,2,0.6781914893617021,
78,2,car,crv,336,711,446,700,375,254,0.9036748,3,0,2,0.6773333333333333,
79,2,car,crv,335,709,444,701,374,257,0.9452533,3,0,2,0.6871657754010695,
0,2,car,crv,117,1316,390,813,1199,423,0.30318785,20,,2,0.35279399499582986,
1,2,car,crv,239,759,447,740,520,293,0.956478,20,,2,0.35279399499582986,
2,2,car,crv,126,1307,387,813,1181,426,0.3400013,20,,2,1.24,
3,2,car,crv,250,757,446,745,507,299,0.93553233,20,,2,1.24,
4,2,car,crv,118,1316,385,817,1198,432,0.46192503,20,,2,1.24,
5,2,car,crv,242,760,449,744,518,295,0.9251644,20,,2,1.24,
6,2,car,crv,125,1310,389,811,1185,422,0.32076746,20,,2,0.3561181434599156,
7,2,car,crv,250,758,446,739,508,293,0.9462212,20,,2,0.3561181434599156,
8,2,car,crv,250,754,444,740,504,296,0.96969557,20,,2,1.24,
9,2,car,crv,113,1313,388,814,1200,426,0.2754978,20,,2,1.24,
10,2,car,crv,244,756,445,743,512,298,0.96916515,20,,2,1.24,
11,2,car,crv,123,1309,388,814,1186,426,0.2760011,20,,2,1.24,
12,2,car,crv,249,758,446,740,509,294,0.950518,20,,2,1.24,
13,2,car,crv,253,754,447,737,501,290,0.94723046,20,,2,1.24,
14,2,car,crv,121,1308,387,817,1187,430,0.21458383,20,,2,0.36225779275484415,
15,2,car,crv,250,754,447,740,504,293,0.9610552,20,,2,0.36225779275484415,
16,2,car,crv,119,1317,388,814,1198,426,0.4732625,20,,2,1.24,
17,2,car,crv,245,758,448,742,513,294,0.94409996,20,,2,1.24,
18,2,car,crv,121,1308,388,815,1187,427,0.21448645,20,,2,0.35973041280539175,
19,2,car,crv,249,753,445,746,504,301,0.9724925,20,,2,0.35973041280539175,
20,2,car,crv,135,1302,387,821,1167,434,0.35179994,20,,2,1.2916666666666667,
21,2,car,crv,250,760,450,741,510,291,0.8736024,20,,2,1.2916666666666667,
22,2,car,crv,117,1313,390,812,1196,422,0.32242462,20,,2,1.2916666666666667,
23,2,car,crv,243,759,447,742,516,295,0.9675998,20,,2,1.2916666666666667,
24,2,car,crv,122,1311,387,814,1189,427,0.36553156,20,,2,1.2916666666666667,
25,2,car,crv,250,757,444,744,507,300,0.9479286,20,,2,1.2916666666666667,
26,2,car,crv,115,1321,388,815,1206,427,0.3674716,20,,2,1.24,
27,2,car,crv,248,756,446,740,508,294,0.92142504,20,,2,1.24,
28,2,car,crv,109,1315,384,827,1206,443,0.2820505,20,,2,1.24,
29,2,car,crv,249,758,449,736,509,287,0.91024953,20,,2,1.24,
30,2,car,crv,122,1310,388,817,1188,429,0.29904467,20,,2,0.3611111111111111,
31,2,car,crv,250,760,448,741,510,293,0.927252,20,,2,0.3611111111111111,
32,2,car,crv,129,1303,389,814,1174,425,0.27334884,20,,2,1.28,
33,2,car,crv,247,760,448,741,513,293,0.9333165,20,,2,1.28,
34,2,car,crv,122,1311,385,813,1189,428,0.35830083,20,,2,1.24,
35,2,car,crv,246,757,442,746,511,304,0.9668414,20,,2,1.24,
36,2,car,crv,122,1312,391,808,1190,417,0.34383425,20,,2,1.28,
37,2,car,crv,248,755,446,741,507,295,0.90284395,20,,2,1.28,
38,2,car,crv,129,1303,386,819,1174,433,0.2341652,20,,2,0.368824531516184,
39,2,car,crv,252,756,447,744,504,297,0.9354642,20,,2,0.368824531516184,
40,2,car,crv,253,756,446,744,503,298,0.97629297,20,,2,1.24,
41,2,car,crv,128,1307,388,817,1179,429,0.32914877,20,,2,1.2916666666666667,
42,2,car,crv,247,762,447,741,515,294,0.9441378,20,,2,1.2916666666666667,
43,2,car,crv,117,1313,388,818,1196,430,0.27251616,20,,2,0.3595317725752508,
44,2,car,crv,247,762,449,740,515,291,0.96550846,20,,2,0.3595317725752508,
45,2,car,crv,124,1305,387,820,1181,433,0.27402008,20,,2,0.36663844199830653,
46,2,car,crv,252,750,447,746,498,299,0.9501165,20,,2,0.36663844199830653,
47,2,car,crv,111,1317,390,812,1206,422,0.27479288,20,,2,0.34991708126036486,
48,2,car,crv,251,753,447,740,502,293,0.9438285,20,,2,0.34991708126036486,
49,2,car,crv,126,1309,390,814,1183,424,0.30222148,20,,2,1.2916666666666667,
50,2,car,crv,249,757,448,740,508,292,0.91383094,20,,2,1.2916666666666667,
51,2,car,crv,111,1317,390,811,1206,421,0.2941505,20,,2,0.3490878938640133,
52,2,car,crv,247,756,446,741,509,295,0.96245986,20,,2,0.3490878938640133,
53,2,car,crv,134,1300,387,818,1166,431,0.35928637,20,,2,1.28,
54,2,car,crv,251,757,447,743,506,296,0.9412378,20,,2,1.28,
55,2,car,crv,126,1312,388,815,1186,427,0.3965622,20,,2,1.24,
56,2,car,crv,252,758,446,743,506,297,0.9420341,20,,2,1.24,
57,2,car,crv,121,1316,389,809,1195,420,0.4096516,20,,2,1.24,
58,2,car,crv,244,761,447,742,517,295,0.9289579,20,,2,1.24,
59,2,car,crv,125,1312,392,805,1187,413,0.30284005,20,,2,1.24,
60,2,car,crv,245,760,447,739,515,292,0.9596912,20,,2,1.24,
61,2,car,crv,131,1307,388,812,1176,424,0.43397242,20,,2,1.2916666666666667,
62,2,car,crv,247,764,447,744,517,297,0.9014591,20,,2,1.2916666666666667,
63,2,car,crv,123,1315,388,811,1192,423,0.4968379,20,,2,1.24,
64,2,car,crv,246,758,446,743,512,297,0.87933147,20,,2,1.24,
65,2,car,crv,118,1312,389,813,1194,424,0.25691053,20,,2,0.35510887772194305,
66,2,car,crv,249,756,447,742,507,295,0.96910256,20,,2,0.35510887772194305,
67,2,car,crv,118,1319,389,813,1201,424,0.4023961,20,,2,1.28,
68,2,car,crv,243,757,448,743,514,295,0.94143236,20,,2,1.28,
69,2,car,crv,119,1322,385,815,1203,430,0.42900166,20,,2,1.24,
70,2,car,crv,246,762,447,741,516,294,0.790523,20,,2,1.24,
71,2,car,crv,119,1319,386,815,1200,429,0.44753623,20,,2,1.28,
72,2,car,crv,248,759,450,741,511,291,0.8263495,20,,2,1.28,
73,2,car,crv,114,1318,387,813,1204,426,0.43434885,20,,2,1.2916666666666667,
74,2,car,crv,246,759,446,744,513,298,0.9186257,20,,2,1.2916666666666667,
75,2,car,crv,119,1325,389,808,1206,419,0.46840343,20,,2,1.24,
76,2,car,crv,244,759,447,741,515,294,0.83414143,20,,2,1.24,
77,2,car,crv,116,1322,388,811,1206,423,0.44209528,20,,2,1.28,
78,2,car,crv,241,764,450,741,523,291,0.8834957,20,,2,1.28,
79,2,car,crv,334,710,446,701,376,255,0.92716336,3,0,2,0.6781914893617021,
80,2,car,crv,336,711,446,700,375,254,0.9036748,3,0,2,0.6773333333333333,
81,2,car,crv,335,709,444,701,374,257,0.9452533,3,0,2,0.6871657754010695,
0,2,car,crv,250,753,445,746,503,301,0.97777426,20,,2,1.24,
1,2,car,crv,117,1316,390,813,1199,423,0.30318785,20,,2,0.35279399499582986,
2,2,car,crv,239,759,447,740,520,293,0.956478,20,,2,0.35279399499582986,
3,2,car,crv,126,1307,387,813,1181,426,0.3400013,20,,2,1.24,
4,2,car,crv,250,757,446,745,507,299,0.93553233,20,,2,1.24,
5,2,car,crv,118,1316,385,817,1198,432,0.46192503,20,,2,1.24,
6,2,car,crv,242,760,449,744,518,295,0.9251644,20,,2,1.24,
7,2,car,crv,125,1310,389,811,1185,422,0.32076746,20,,2,0.3561181434599156,
8,2,car,crv,250,758,446,739,508,293,0.9462212,20,,2,0.3561181434599156,
9,2,car,crv,250,754,444,740,504,296,0.96969557,20,,2,1.24,
10,2,car,crv,113,1313,388,814,1200,426,0.2754978,20,,2,1.24,
11,2,car,crv,244,756,445,743,512,298,0.96916515,20,,2,1.24,
12,2,car,crv,123,1309,388,814,1186,426,0.2760011,20,,2,1.24,
13,2,car,crv,249,758,446,740,509,294,0.950518,20,,2,1.24,
14,2,car,crv,253,754,447,737,501,290,0.94723046,20,,2,1.24,
15,2,car,crv,121,1308,387,817,1187,430,0.21458383,20,,2,0.36225779275484415,
16,2,car,crv,250,754,447,740,504,293,0.9610552,20,,2,0.36225779275484415,
17,2,car,crv,119,1317,388,814,1198,426,0.4732625,20,,2,1.24,
18,2,car,crv,245,758,448,742,513,294,0.94409996,20,,2,1.24,
19,2,car,crv,121,1308,388,815,1187,427,0.21448645,20,,2,0.35973041280539175,
20,2,car,crv,249,753,445,746,504,301,0.9724925,20,,2,0.35973041280539175,
21,2,car,crv,135,1302,387,821,1167,434,0.35179994,20,,2,1.2916666666666667,
22,2,car,crv,250,760,450,741,510,291,0.8736024,20,,2,1.2916666666666667,
23,2,car,crv,117,1313,390,812,1196,422,0.32242462,20,,2,1.2916666666666667,
24,2,car,crv,243,759,447,742,516,295,0.9675998,20,,2,1.2916666666666667,
25,2,car,crv,122,1311,387,814,1189,427,0.36553156,20,,2,1.2916666666666667,
26,2,car,crv,250,757,444,744,507,300,0.9479286,20,,2,1.2916666666666667,
27,2,car,crv,115,1321,388,815,1206,427,0.3674716,20,,2,1.24,
28,2,car,crv,248,756,446,740,508,294,0.92142504,20,,2,1.24,
29,2,car,crv,109,1315,384,827,1206,443,0.2820505,20,,2,1.24,
30,2,car,crv,249,758,449,736,509,287,0.91024953,20,,2,1.24,
31,2,car,crv,122,1310,388,817,1188,429,0.29904467,20,,2,0.3611111111111111,
32,2,car,crv,250,760,448,741,510,293,0.927252,20,,2,0.3611111111111111,
33,2,car,crv,129,1303,389,814,1174,425,0.27334884,20,,2,1.28,
34,2,car,crv,247,760,448,741,513,293,0.9333165,20,,2,1.28,
35,2,car,crv,122,1311,385,813,1189,428,0.35830083,20,,2,1.24,
36,2,car,crv,246,757,442,746,511,304,0.9668414,20,,2,1.24,
37,2,car,crv,122,1312,391,808,1190,417,0.34383425,20,,2,1.28,
38,2,car,crv,248,755,446,741,507,295,0.90284395,20,,2,1.28,
39,2,car,crv,129,1303,386,819,1174,433,0.2341652,20,,2,0.368824531516184,
40,2,car,crv,252,756,447,744,504,297,0.9354642,20,,2,0.368824531516184,
41,2,car,crv,253,756,446,744,503,298,0.97629297,20,,2,1.24,
42,2,car,crv,128,1307,388,817,1179,429,0.32914877,20,,2,1.2916666666666667,
43,2,car,crv,247,762,447,741,515,294,0.9441378,20,,2,1.2916666666666667,
44,2,car,crv,117,1313,388,818,1196,430,0.27251616,20,,2,0.3595317725752508,
45,2,car,crv,247,762,449,740,515,291,0.96550846,20,,2,0.3595317725752508,
46,2,car,crv,124,1305,387,820,1181,433,0.27402008,20,,2,0.36663844199830653,
47,2,car,crv,252,750,447,746,498,299,0.9501165,20,,2,0.36663844199830653,
48,2,car,crv,111,1317,390,812,1206,422,0.27479288,20,,2,0.34991708126036486,
49,2,car,crv,251,753,447,740,502,293,0.9438285,20,,2,0.34991708126036486,
50,2,car,crv,126,1309,390,814,1183,424,0.30222148,20,,2,1.2916666666666667,
51,2,car,crv,249,757,448,740,508,292,0.91383094,20,,2,1.2916666666666667,
52,2,car,crv,111,1317,390,811,1206,421,0.2941505,20,,2,0.3490878938640133,
53,2,car,crv,247,756,446,741,509,295,0.96245986,20,,2,0.3490878938640133,
54,2,car,crv,134,1300,387,818,1166,431,0.35928637,20,,2,1.28,
55,2,car,crv,251,757,447,743,506,296,0.9412378,20,,2,1.28,
56,2,car,crv,126,1312,388,815,1186,427,0.3965622,20,,2,1.24,
57,2,car,crv,252,758,446,743,506,297,0.9420341,20,,2,1.24,
58,2,car,crv,121,1316,389,809,1195,420,0.4096516,20,,2,1.24,
59,2,car,crv,244,761,447,742,517,295,0.9289579,20,,2,1.24,
60,2,car,crv,125,1312,392,805,1187,413,0.30284005,20,,2,1.24,
61,2,car,crv,245,760,447,739,515,292,0.9596912,20,,2,1.24,
62,2,car,crv,131,1307,388,812,1176,424,0.43397242,20,,2,1.2916666666666667,
63,2,car,crv,247,764,447,744,517,297,0.9014591,20,,2,1.2916666666666667,
64,2,car,crv,123,1315,388,811,1192,423,0.4968379,20,,2,1.24,
65,2,car,crv,246,758,446,743,512,297,0.87933147,20,,2,1.24,
66,2,car,crv,118,1312,389,813,1194,424,0.25691053,20,,2,0.35510887772194305,
67,2,car,crv,249,756,447,742,507,295,0.96910256,20,,2,0.35510887772194305,
68,2,car,crv,118,1319,389,813,1201,424,0.4023961,20,,2,1.28,
69,2,car,crv,243,757,448,743,514,295,0.94143236,20,,2,1.28,
70,2,car,crv,119,1322,385,815,1203,430,0.42900166,20,,2,1.24,
71,2,car,crv,246,762,447,741,516,294,0.790523,20,,2,1.24,
72,2,car,crv,119,1319,386,815,1200,429,0.44753623,20,,2,1.28,
73,2,car,crv,248,759,450,741,511,291,0.8263495,20,,2,1.28,
74,2,car,crv,114,1318,387,813,1204,426,0.43434885,20,,2,1.2916666666666667,
75,2,car,crv,246,759,446,744,513,298,0.9186257,20,,2,1.2916666666666667,
76,2,car,crv,119,1325,389,808,1206,419,0.46840343,20,,2,1.24,
77,2,car,crv,244,759,447,741,515,294,0.83414143,20,,2,1.24,
78,2,car,crv,116,1322,388,811,1206,423,0.44209528,20,,2,1.28,
79,2,car,crv,241,764,450,741,523,291,0.8834957,20,,2,1.28,
80,2,car,crv,334,710,446,701,376,255,0.92716336,3,0,2,0.6781914893617021,
81,2,car,crv,336,711,446,700,375,254,0.9036748,3,0,2,0.6773333333333333,
82,2,car,crv,335,709,444,701,374,257,0.9452533,3,0,2,0.6871657754010695,
0,2,car,crv,116,1312,386,813,1196,427,0.26130736,20,,2,0.35702341137123744,
1,2,car,crv,249,755,445,740,506,295,0.95275867,20,,2,0.35702341137123744,
2,2,car,crv,250,753,445,746,503,301,0.97777426,20,,2,1.24,
3,2,car,crv,117,1316,390,813,1199,423,0.30318785,20,,2,0.35279399499582986,
4,2,car,crv,239,759,447,740,520,293,0.956478,20,,2,0.35279399499582986,
5,2,car,crv,126,1307,387,813,1181,426,0.3400013,20,,2,1.24,
6,2,car,crv,250,757,446,745,507,299,0.93553233,20,,2,1.24,
7,2,car,crv,118,1316,385,817,1198,432,0.46192503,20,,2,1.24,
8,2,car,crv,242,760,449,744,518,295,0.9251644,20,,2,1.24,
9,2,car,crv,125,1310,389,811,1185,422,0.32076746,20,,2,0.3561181434599156,
10,2,car,crv,250,758,446,739,508,293,0.9462212,20,,2,0.3561181434599156,
11,2,car,crv,250,754,444,740,504,296,0.96969557,20,,2,1.24,
12,2,car,crv,113,1313,388,814,1200,426,0.2754978,20,,2,1.24,
13,2,car,crv,244,756,445,743,512,298,0.96916515,20,,2,1.24,
14,2,car,crv,123,1309,388,814,1186,426,0.2760011,20,,2,1.24,
15,2,car,crv,249,758,446,740,509,294,0.950518,20,,2,1.24,
16,2,car,crv,253,754,447,737,501,290,0.94723046,20,,2,1.24,
17,2,car,crv,121,1308,387,817,1187,430,0.21458383,20,,2,0.36225779275484415,
18,2,car,crv,250,754,447,740,504,293,0.9610552,20,,2,0.36225779275484415,
19,2,car,crv,119,1317,388,814,1198,426,0.4732625,20,,2,1.24,
20,2,car,crv,245,758,448,742,513,294,0.94409996,20,,2,1.24,
21,2,car,crv,121,1308,388,815,1187,427,0.21448645,20,,2,0.35973041280539175,
22,2,car,crv,249,753,445,746,504,301,0.9724925,20,,2,0.35973041280539175,
23,2,car,crv,135,1302,387,821,1167,434,0.35179994,20,,2,1.2916666666666667,
24,2,car,crv,250,760,450,741,510,291,0.8736024,20,,2,1.2916666666666667,
25,2,car,crv,117,1313,390,812,1196,422,0.32242462,20,,2,1.2916666666666667,
26,2,car,crv,243,759,447,742,516,295,0.9675998,20,,2,1.2916666666666667,
27,2,car,crv,122,1311,387,814,1189,427,0.36553156,20,,2,1.2916666666666667,
28,2,car,crv,250,757,444,744,507,300,0.9479286,20,,2,1.2916666666666667,
29,2,car,crv,115,1321,388,815,1206,427,0.3674716,20,,2,1.24,
30,2,car,crv,248,756,446,740,508,294,0.92142504,20,,2,1.24,
31,2,car,crv,109,1315,384,827,1206,443,0.2820505,20,,2,1.24,
32,2,car,crv,249,758,449,736,509,287,0.91024953,20,,2,1.24,
33,2,car,crv,122,1310,388,817,1188,429,0.29904467,20,,2,0.3611111111111111,
34,2,car,crv,250,760,448,741,510,293,0.927252,20,,2,0.3611111111111111,
35,2,car,crv,129,1303,389,814,1174,425,0.27334884,20,,2,1.28,
36,2,car,crv,247,760,448,741,513,293,0.9333165,20,,2,1.28,
37,2,car,crv,122,1311,385,813,1189,428,0.35830083,20,,2,1.24,
38,2,car,crv,246,757,442,746,511,304,0.9668414,20,,2,1.24,
39,2,car,crv,122,1312,391,808,1190,417,0.34383425,20,,2,1.28,
40,2,car,crv,248,755,446,741,507,295,0.90284395,20,,2,1.28,
41,2,car,crv,129,1303,386,819,1174,433,0.2341652,20,,2,0.368824531516184,
42,2,car,crv,252,756,447,744,504,297,0.9354642,20,,2,0.368824531516184,
43,2,car,crv,253,756,446,744,503,298,0.97629297,20,,2,1.24,
44,2,car,crv,128,1307,388,817,1179,429,0.32914877,20,,2,1.2916666666666667,
45,2,car,crv,247,762,447,741,515,294,0.9441378,20,,2,1.2916666666666667,
46,2,car,crv,117,1313,388,818,1196,430,0.27251616,20,,2,0.3595317725752508,
47,2,car,crv,247,762,449,740,515,291,0.96550846,20,,2,0.3595317725752508,
48,2,car,crv,124,1305,387,820,1181,433,0.27402008,20,,2,0.36663844199830653,
49,2,car,crv,252,750,447,746,498,299,0.9501165,20,,2,0.36663844199830653,
50,2,car,crv,111,1317,390,812,1206,422,0.27479288,20,,2,0.34991708126036486,
51,2,car,crv,251,753,447,740,502,293,0.9438285,20,,2,0.34991708126036486,
52,2,car,crv,126,1309,390,814,1183,424,0.30222148,20,,2,1.2916666666666667,
53,2,car,crv,249,757,448,740,508,292,0.91383094,20,,2,1.2916666666666667,
54,2,car,crv,111,1317,390,811,1206,421,0.2941505,20,,2,0.3490878938640133,
55,2,car,crv,247,756,446,741,509,295,0.96245986,20,,2,0.3490878938640133,
56,2,car,crv,134,1300,387,818,1166,431,0.35928637,20,,2,1.28,
57,2,car,crv,251,757,447,743,506,296,0.9412378,20,,2,1.28,
58,2,car,crv,126,1312,388,815,1186,427,0.3965622,20,,2,1.24,
59,2,car,crv,252,758,446,743,506,297,0.9420341,20,,2,1.24,
60,2,car,crv,121,1316,389,809,1195,420,0.4096516,20,,2,1.24,
61,2,car,crv,244,761,447,742,517,295,0.9289579,20,,2,1.24,
62,2,car,crv,125,1312,392,805,1187,413,0.30284005,20,,2,1.24,
63,2,car,crv,245,760,447,739,515,292,0.9596912,20,,2,1.24,
64,2,car,crv,131,1307,388,812,1176,424,0.43397242,20,,2,1.2916666666666667,
65,2,car,crv,247,764,447,744,517,297,0.9014591,20,,2,1.2916666666666667,
66,2,car,crv,123,1315,388,811,1192,423,0.4968379,20,,2,1.24,
67,2,car,crv,246,758,446,743,512,297,0.87933147,20,,2,1.24,
68,2,car,crv,118,1312,389,813,1194,424,0.25691053,20,,2,0.35510887772194305,
69,2,car,crv,249,756,447,742,507,295,0.96910256,20,,2,0.35510887772194305,
70,2,car,crv,118,1319,389,813,1201,424,0.4023961,20,,2,1.28,
71,2,car,crv,243,757,448,743,514,295,0.94143236,20,,2,1.28,
72,2,car,crv,119,1322,385,815,1203,430,0.42900166,20,,2,1.24,
73,2,car,crv,246,762,447,741,516,294,0.790523,20,,2,1.24,
74,2,car,crv,119,1319,386,815,1200,429,0.44753623,20,,2,1.28,
75,2,car,crv,248,759,450,741,511,291,0.8263495,20,,2,1.28,
76,2,car,crv,114,1318,387,813,1204,426,0.43434885,20,,2,1.2916666666666667,
77,2,car,crv,246,759,446,744,513,298,0.9186257,20,,2,1.2916666666666667,
78,2,car,crv,119,1325,389,808,1206,419,0.46840343,20,,2,1.24,
79,2,car,crv,244,759,447,741,515,294,0.83414143,20,,2,1.24,
80,2,car,crv,116,1322,388,811,1206,423,0.44209528,20,,2,1.28,
81,2,car,crv,241,764,450,741,523,291,0.8834957,20,,2,1.28,
82,2,car,crv,334,710,446,701,376,255,0.92716336,3,0,2,0.6781914893617021,
83,2,car,crv,336,711,446,700,375,254,0.9036748,3,0,2,0.6773333333333333,
84,2,car,crv,335,709,444,701,374,257,0.9452533,3,0,2,0.6871657754010695,
0,2,car,crv,113,1317,388,815,1204,427,0.36209753,20,,2,1.24,
1,2,car,crv,247,755,446,738,508,292,0.93217456,20,,2,1.24,
2,2,car,crv,116,1312,386,813,1196,427,0.26130736,20,,2,0.35702341137123744,
3,2,car,crv,249,755,445,740,506,295,0.95275867,20,,2,0.35702341137123744,
4,2,car,crv,250,753,445,746,503,301,0.97777426,20,,2,1.24,
5,2,car,crv,117,1316,390,813,1199,423,0.30318785,20,,2,0.35279399499582986,
6,2,car,crv,239,759,447,740,520,293,0.956478,20,,2,0.35279399499582986,
7,2,car,crv,126,1307,387,813,1181,426,0.3400013,20,,2,1.24,
8,2,car,crv,250,757,446,745,507,299,0.93553233,20,,2,1.24,
9,2,car,crv,118,1316,385,817,1198,432,0.46192503,20,,2,1.24,
10,2,car,crv,242,760,449,744,518,295,0.9251644,20,,2,1.24,
11,2,car,crv,125,1310,389,811,1185,422,0.32076746,20,,2,0.3561181434599156,
12,2,car,crv,250,758,446,739,508,293,0.9462212,20,,2,0.3561181434599156,
13,2,car,crv,250,754,444,740,504,296,0.96969557,20,,2,1.24,
14,2,car,crv,113,1313,388,814,1200,426,0.2754978,20,,2,1.24,
15,2,car,crv,244,756,445,743,512,298,0.96916515,20,,2,1.24,
16,2,car,crv,123,1309,388,814,1186,426,0.2760011,20,,2,1.24,
17,2,car,crv,249,758,446,740,509,294,0.950518,20,,2,1.24,
18,2,car,crv,253,754,447,737,501,290,0.94723046,20,,2,1.24,
19,2,car,crv,121,1308,387,817,1187,430,0.21458383,20,,2,0.36225779275484415,
20,2,car,crv,250,754,447,740,504,293,0.9610552,20,,2,0.36225779275484415,
21,2,car,crv,119,1317,388,814,1198,426,0.4732625,20,,2,1.24,
22,2,car,crv,245,758,448,742,513,294,0.94409996,20,,2,1.24,
23,2,car,crv,121,1308,388,815,1187,427,0.21448645,20,,2,0.35973041280539175,
24,2,car,crv,249,753,445,746,504,301,0.9724925,20,,2,0.35973041280539175,
25,2,car,crv,135,1302,387,821,1167,434,0.35179994,20,,2,1.2916666666666667,
26,2,car,crv,250,760,450,741,510,291,0.8736024,20,,2,1.2916666666666667,
27,2,car,crv,117,1313,390,812,1196,422,0.32242462,20,,2,1.2916666666666667,
28,2,car,crv,243,759,447,742,516,295,0.9675998,20,,2,1.2916666666666667,
29,2,car,crv,122,1311,387,814,1189,427,0.36553156,20,,2,1.2916666666666667,
30,2,car,crv,250,757,444,744,507,300,0.9479286,20,,2,1.2916666666666667,
31,2,car,crv,115,1321,388,815,1206,427,0.3674716,20,,2,1.24,
32,2,car,crv,248,756,446,740,508,294,0.92142504,20,,2,1.24,
33,2,car,crv,109,1315,384,827,1206,443,0.2820505,20,,2,1.24,
34,2,car,crv,249,758,449,736,509,287,0.91024953,20,,2,1.24,
35,2,car,crv,122,1310,388,817,1188,429,0.29904467,20,,2,0.3611111111111111,
36,2,car,crv,250,760,448,741,510,293,0.927252,20,,2,0.3611111111111111,
37,2,car,crv,129,1303,389,814,1174,425,0.27334884,20,,2,1.28,
38,2,car,crv,247,760,448,741,513,293,0.9333165,20,,2,1.28,
39,2,car,crv,122,1311,385,813,1189,428,0.35830083,20,,2,1.24,
40,2,car,crv,246,757,442,746,511,304,0.9668414,20,,2,1.24,
41,2,car,crv,122,1312,391,808,1190,417,0.34383425,20,,2,1.28,
42,2,car,crv,248,755,446,741,507,295,0.90284395,20,,2,1.28,
43,2,car,crv,129,1303,386,819,1174,433,0.2341652,20,,2,0.368824531516184,
44,2,car,crv,252,756,447,744,504,297,0.9354642,20,,2,0.368824531516184,
45,2,car,crv,253,756,446,744,503,298,0.97629297,20,,2,1.24,
46,2,car,crv,128,1307,388,817,1179,429,0.32914877,20,,2,1.2916666666666667,
47,2,car,crv,247,762,447,741,515,294,0.9441378,20,,2,1.2916666666666667,
48,2,car,crv,117,1313,388,818,1196,430,0.27251616,20,,2,0.3595317725752508,
49,2,car,crv,247,762,449,740,515,291,0.96550846,20,,2,0.3595317725752508,
50,2,car,crv,124,1305,387,820,1181,433,0.27402008,20,,2,0.36663844199830653,
51,2,car,crv,252,750,447,746,498,299,0.9501165,20,,2,0.36663844199830653,
52,2,car,crv,111,1317,390,812,1206,422,0.27479288,20,,2,0.34991708126036486,
53,2,car,crv,251,753,447,740,502,293,0.9438285,20,,2,0.34991708126036486,
54,2,car,crv,126,1309,390,814,1183,424,0.30222148,20,,2,1.2916666666666667,
55,2,car,crv,249,757,448,740,508,292,0.91383094,20,,2,1.2916666666666667,
56,2,car,crv,111,1317,390,811,1206,421,0.2941505,20,,2,0.3490878938640133,
57,2,car,crv,247,756,446,741,509,295,0.96245986,20,,2,0.3490878938640133,
58,2,car,crv,134,1300,387,818,1166,431,0.35928637,20,,2,1.28,
59,2,car,crv,251,757,447,743,506,296,0.9412378,20,,2,1.28,
60,2,car,crv,126,1312,388,815,1186,427,0.3965622,20,,2,1.24,
61,2,car,crv,252,758,446,743,506,297,0.9420341,20,,2,1.24,
62,2,car,crv,121,1316,389,809,1195,420,0.4096516,20,,2,1.24,
63,2,car,crv,244,761,447,742,517,295,0.9289579,20,,2,1.24,
64,2,car,crv,125,1312,392,805,1187,413,0.30284005,20,,2,1.24,
65,2,car,crv,245,760,447,739,515,292,0.9596912,20,,2,1.24,
66,2,car,crv,131,1307,388,812,1176,424,0.43397242,20,,2,1.2916666666666667,
67,2,car,crv,247,764,447,744,517,297,0.9014591,20,,2,1.2916666666666667,
68,2,car,crv,123,1315,388,811,1192,423,0.4968379,20,,2,1.24,
69,2,car,crv,246,758,446,743,512,297,0.87933147,20,,2,1.24,
70,2,car,crv,118,1312,389,813,1194,424,0.25691053,20,,2,0.35510887772194305,
71,2,car,crv,249,756,447,742,507,295,0.96910256,20,,2,0.35510887772194305,
72,2,car,crv,118,1319,389,813,1201,424,0.4023961,20,,2,1.28,
73,2,car,crv,243,757,448,743,514,295,0.94143236,20,,2,1.28,
74,2,car,crv,119,1322,385,815,1203,430,0.42900166,20,,2,1.24,
75,2,car,crv,246,762,447,741,516,294,0.790523,20,,2,1.24,
76,2,car,crv,119,1319,386,815,1200,429,0.44753623,20,,2,1.28,
77,2,car,crv,248,759,450,741,511,291,0.8263495,20,,2,1.28,
78,2,car,crv,114,1318,387,813,1204,426,0.43434885,20,,2,1.2916666666666667,
79,2,car,crv,246,759,446,744,513,298,0.9186257,20,,2,1.2916666666666667,
80,2,car,crv,119,1325,389,808,1206,419,0.46840343,20,,2,1.24,
81,2,car,crv,244,759,447,741,515,294,0.83414143,20,,2,1.24,
82,2,car,crv,116,1322,388,811,1206,423,0.44209528,20,,2,1.28,
83,2,car,crv,241,764,450,741,523,291,0.8834957,20,,2,1.28,
84,2,car,crv,334,710,446,701,376,255,0.92716336,3,0,2,0.6781914893617021,
85,2,car,crv,336,711,446,700,375,254,0.9036748,3,0,2,0.6773333333333333,
86,2,car,crv,335,709,444,701,374,257,0.9452533,3,0,2,0.6871657754010695,
0,2,car,crv,126,1306,387,819,1180,432,0.24266188,20,,2,0.36610169491525424,
1,2,car,crv,247,754,449,740,507,291,0.94762105,20,,2,0.36610169491525424,
2,2,car,crv,113,1317,388,815,1204,427,0.36209753,20,,2,1.24,
3,2,car,crv,247,755,446,738,508,292,0.93217456,20,,2,1.24,
4,2,car,crv,116,1312,386,813,1196,427,0.26130736,20,,2,0.35702341137123744,
5,2,car,crv,249,755,445,740,506,295,0.95275867,20,,2,0.35702341137123744,
6,2,car,crv,250,753,445,746,503,301,0.97777426,20,,2,1.24,
7,2,car,crv,117,1316,390,813,1199,423,0.30318785,20,,2,0.35279399499582986,
8,2,car,crv,239,759,447,740,520,293,0.956478,20,,2,0.35279399499582986,
9,2,car,crv,126,1307,387,813,1181,426,0.3400013,20,,2,1.24,
10,2,car,crv,250,757,446,745,507,299,0.93553233,20,,2,1.24,
11,2,car,crv,118,1316,385,817,1198,432,0.46192503,20,,2,1.24,
12,2,car,crv,242,760,449,744,518,295,0.9251644,20,,2,1.24,
13,2,car,crv,125,1310,389,811,1185,422,0.32076746,20,,2,0.3561181434599156,
14,2,car,crv,250,758,446,739,508,293,0.9462212,20,,2,0.3561181434599156,
15,2,car,crv,250,754,444,740,504,296,0.96969557,20,,2,1.24,
16,2,car,crv,113,1313,388,814,1200,426,0.2754978,20,,2,1.24,
17,2,car,crv,244,756,445,743,512,298,0.96916515,20,,2,1.24,
18,2,car,crv,123,1309,388,814,1186,426,0.2760011,20,,2,1.24,
19,2,car,crv,249,758,446,740,509,294,0.950518,20,,2,1.24,
20,2,car,crv,253,754,447,737,501,290,0.94723046,20,,2,1.24,
21,2,car,crv,121,1308,387,817,1187,430,0.21458383,20,,2,0.36225779275484415,
22,2,car,crv,250,754,447,740,504,293,0.9610552,20,,2,0.36225779275484415,
23,2,car,crv,119,1317,388,814,1198,426,0.4732625,20,,2,1.24,
24,2,car,crv,245,758,448,742,513,294,0.94409996,20,,2,1.24,
25,2,car,crv,121,1308,388,815,1187,427,0.21448645,20,,2,0.35973041280539175,
26,2,car,crv,249,753,445,746,504,301,0.9724925,20,,2,0.35973041280539175,
27,2,car,crv,135,1302,387,821,1167,434,0.35179994,20,,2,1.2916666666666667,
28,2,car,crv,250,760,450,741,510,291,0.8736024,20,,2,1.2916666666666667,
29,2,car,crv,117,1313,390,812,1196,422,0.32242462,20,,2,1.2916666666666667,
30,2,car,crv,243,759,447,742,516,295,0.9675998,20,,2,1.2916666666666667,
31,2,car,crv,122,1311,387,814,1189,427,0.36553156,20,,2,1.2916666666666667,
32,2,car,crv,250,757,444,744,507,300,0.9479286,20,,2,1.2916666666666667,
33,2,car,crv,115,1321,388,815,1206,427,0.3674716,20,,2,1.24,
34,2,car,crv,248,756,446,740,508,294,0.92142504,20,,2,1.24,
35,2,car,crv,109,1315,384,827,1206,443,0.2820505,20,,2,1.24,
36,2,car,crv,249,758,449,736,509,287,0.91024953,20,,2,1.24,
37,2,car,crv,122,1310,388,817,1188,429,0.29904467,20,,2,0.3611111111111111,
38,2,car,crv,250,760,448,741,510,293,0.927252,20,,2,0.3611111111111111,
39,2,car,crv,129,1303,389,814,1174,425,0.27334884,20,,2,1.28,
40,2,car,crv,247,760,448,741,513,293,0.9333165,20,,2,1.28,
41,2,car,crv,122,1311,385,813,1189,428,0.35830083,20,,2,1.24,
42,2,car,crv,246,757,442,746,511,304,0.9668414,20,,2,1.24,
43,2,car,crv,122,1312,391,808,1190,417,0.34383425,20,,2,1.28,
44,2,car,crv,248,755,446,741,507,295,0.90284395,20,,2,1.28,
45,2,car,crv,129,1303,386,819,1174,433,0.2341652,20,,2,0.368824531516184,
46,2,car,crv,252,756,447,744,504,297,0.9354642,20,,2,0.368824531516184,
47,2,car,crv,253,756,446,744,503,298,0.97629297,20,,2,1.24,
48,2,car,crv,128,1307,388,817,1179,429,0.32914877,20,,2,1.2916666666666667,
49,2,car,crv,247,762,447,741,515,294,0.9441378,20,,2,1.2916666666666667,
50,2,car,crv,117,1313,388,818,1196,430,0.27251616,20,,2,0.3595317725752508,
51,2,car,crv,247,762,449,740,515,291,0.96550846,20,,2,0.3595317725752508,
52,2,car,crv,124,1305,387,820,1181,433,0.27402008,20,,2,0.36663844199830653,
53,2,car,crv,252,750,447,746,498,299,0.9501165,20,,2,0.36663844199830653,
54,2,car,crv,111,1317,390,812,1206,422,0.27479288,20,,2,0.34991708126036486,
55,2,car,crv,251,753,447,740,502,293,0.9438285,20,,2,0.34991708126036486,
56,2,car,crv,126,1309,390,814,1183,424,0.30222148,20,,2,1.2916666666666667,
57,2,car,crv,249,757,448,740,508,292,0.91383094,20,,2,1.2916666666666667,
58,2,car,crv,111,1317,390,811,1206,421,0.2941505,20,,2,0.3490878938640133,
59,2,car,crv,247,756,446,741,509,295,0.96245986,20,,2,0.3490878938640133,
60,2,car,crv,134,1300,387,818,1166,431,0.35928637,20,,2,1.28,
61,2,car,crv,251,757,447,743,506,296,0.9412378,20,,2,1.28,
62,2,car,crv,126,1312,388,815,1186,427,0.3965622,20,,2,1.24,
63,2,car,crv,252,758,446,743,506,297,0.9420341,20,,2,1.24,
64,2,car,crv,121,1316,389,809,1195,420,0.4096516,20,,2,1.24,
65,2,car,crv,244,761,447,742,517,295,0.9289579,20,,2,1.24,
66,2,car,crv,125,1312,392,805,1187,413,0.30284005,20,,2,1.24,
67,2,car,crv,245,760,447,739,515,292,0.9596912,20,,2,1.24,
68,2,car,crv,131,1307,388,812,1176,424,0.43397242,20,,2,1.2916666666666667,
69,2,car,crv,247,764,447,744,517,297,0.9014591,20,,2,1.2916666666666667,
70,2,car,crv,123,1315,388,811,1192,423,0.4968379,20,,2,1.24,
71,2,car,crv,246,758,446,743,512,297,0.87933147,20,,2,1.24,
72,2,car,crv,118,1312,389,813,1194,424,0.25691053,20,,2,0.35510887772194305,
73,2,car,crv,249,756,447,742,507,295,0.96910256,20,,2,0.35510887772194305,
74,2,car,crv,118,1319,389,813,1201,424,0.4023961,20,,2,1.28,
75,2,car,crv,243,757,448,743,514,295,0.94143236,20,,2,1.28,
76,2,car,crv,119,1322,385,815,1203,430,0.42900166,20,,2,1.24,
77,2,car,crv,246,762,447,741,516,294,0.790523,20,,2,1.24,
78,2,car,crv,119,1319,386,815,1200,429,0.44753623,20,,2,1.28,
79,2,car,crv,248,759,450,741,511,291,0.8263495,20,,2,1.28,
80,2,car,crv,114,1318,387,813,1204,426,0.43434885,20,,2,1.2916666666666667,
81,2,car,crv,246,759,446,744,513,298,0.9186257,20,,2,1.2916666666666667,
82,2,car,crv,119,1325,389,808,1206,419,0.46840343,20,,2,1.24,
83,2,car,crv,244,759,447,741,515,294,0.83414143,20,,2,1.24,
84,2,car,crv,116,1322,388,811,1206,423,0.44209528,20,,2,1.28,
85,2,car,crv,241,764,450,741,523,291,0.8834957,20,,2,1.28,
86,2,car,crv,334,710,446,701,376,255,0.92716336,3,0,2,0.6781914893617021,
87,2,car,crv,336,711,446,700,375,254,0.9036748,3,0,2,0.6773333333333333,
88,2,car,crv,335,709,444,701,374,257,0.9452533,3,0,2,0.6871657754010695,
0,2,car,crv,127,1306,389,820,1179,431,0.37050778,20,,2,1.24,
1,2,car,crv,252,758,449,742,506,293,0.9203835,20,,2,1.24,
2,2,car,crv,126,1306,387,819,1180,432,0.24266188,20,,2,0.36610169491525424,
3,2,car,crv,247,754,449,740,507,291,0.94762105,20,,2,0.36610169491525424,
4,2,car,crv,113,1317,388,815,1204,427,0.36209753,20,,2,1.24,
5,2,car,crv,247,755,446,738,508,292,0.93217456,20,,2,1.24,
6,2,car,crv,116,1312,386,813,1196,427,0.26130736,20,,2,0.35702341137123744,
7,2,car,crv,249,755,445,740,506,295,0.95275867,20,,2,0.35702341137123744,
8,2,car,crv,250,753,445,746,503,301,0.97777426,20,,2,1.24,
9,2,car,crv,117,1316,390,813,1199,423,0.30318785,20,,2,0.35279399499582986,
10,2,car,crv,239,759,447,740,520,293,0.956478,20,,2,0.35279399499582986,
11,2,car,crv,126,1307,387,813,1181,426,0.3400013,20,,2,1.24,
12,2,car,crv,250,757,446,745,507,299,0.93553233,20,,2,1.24,
13,2,car,crv,118,1316,385,817,1198,432,0.46192503,20,,2,1.24,
14,2,car,crv,242,760,449,744,518,295,0.9251644,20,,2,1.24,
15,2,car,crv,125,1310,389,811,1185,422,0.32076746,20,,2,0.3561181434599156,
16,2,car,crv,250,758,446,739,508,293,0.9462212,20,,2,0.3561181434599156,
17,2,car,crv,250,754,444,740,504,296,0.96969557,20,,2,1.24,
18,2,car,crv,113,1313,388,814,1200,426,0.2754978,20,,2,1.24,
19,2,car,crv,244,756,445,743,512,298,0.96916515,20,,2,1.24,
20,2,car,crv,123,1309,388,814,1186,426,0.2760011,20,,2,1.24,
21,2,car,crv,249,758,446,740,509,294,0.950518,20,,2,1.24,
22,2,car,crv,253,754,447,737,501,290,0.94723046,20,,2,1.24,
23,2,car,crv,121,1308,387,817,1187,430,0.21458383,20,,2,0.36225779275484415,
24,2,car,crv,250,754,447,740,504,293,0.9610552,20,,2,0.36225779275484415,
25,2,car,crv,119,1317,388,814,1198,426,0.4732625,20,,2,1.24,
26,2,car,crv,245,758,448,742,513,294,0.94409996,20,,2,1.24,
27,2,car,crv,121,1308,388,815,1187,427,0.21448645,20,,2,0.35973041280539175,
28,2,car,crv,249,753,445,746,504,301,0.9724925,20,,2,0.35973041280539175,
29,2,car,crv,135,1302,387,821,1167,434,0.35179994,20,,2,1.2916666666666667,
30,2,car,crv,250,760,450,741,510,291,0.8736024,20,,2,1.2916666666666667,
31,2,car,crv,117,1313,390,812,1196,422,0.32242462,20,,2,1.2916666666666667,
32,2,car,crv,243,759,447,742,516,295,0.9675998,20,,2,1.2916666666666667,
33,2,car,crv,122,1311,387,814,1189,427,0.36553156,20,,2,1.2916666666666667,
34,2,car,crv,250,757,444,744,507,300,0.9479286,20,,2,1.2916666666666667,
35,2,car,crv,115,1321,388,815,1206,427,0.3674716,20,,2,1.24,
36,2,car,crv,248,756,446,740,508,294,0.92142504,20,,2,1.24,
37,2,car,crv,109,1315,384,827,1206,443,0.2820505,20,,2,1.24,
38,2,car,crv,249,758,449,736,509,287,0.91024953,20,,2,1.24,
39,2,car,crv,122,1310,388,817,1188,429,0.29904467,20,,2,0.3611111111111111,
40,2,car,crv,250,760,448,741,510,293,0.927252,20,,2,0.3611111111111111,
41,2,car,crv,129,1303,389,814,1174,425,0.27334884,20,,2,1.28,
42,2,car,crv,247,760,448,741,513,293,0.9333165,20,,2,1.28,
43,2,car,crv,122,1311,385,813,1189,428,0.35830083,20,,2,1.24,
44,2,car,crv,246,757,442,746,511,304,0.9668414,20,,2,1.24,
45,2,car,crv,122,1312,391,808,1190,417,0.34383425,20,,2,1.28,
46,2,car,crv,248,755,446,741,507,295,0.90284395,20,,2,1.28,
47,2,car,crv,129,1303,386,819,1174,433,0.2341652,20,,2,0.368824531516184,
48,2,car,crv,252,756,447,744,504,297,0.9354642,20,,2,0.368824531516184,
49,2,car,crv,253,756,446,744,503,298,0.97629297,20,,2,1.24,
50,2,car,crv,128,1307,388,817,1179,429,0.32914877,20,,2,1.2916666666666667,
51,2,car,crv,247,762,447,741,515,294,0.9441378,20,,2,1.2916666666666667,
52,2,car,crv,117,1313,388,818,1196,430,0.27251616,20,,2,0.3595317725752508,
53,2,car,crv,247,762,449,740,515,291,0.96550846,20,,2,0.3595317725752508,
54,2,car,crv,124,1305,387,820,1181,433,0.27402008,20,,2,0.36663844199830653,
55,2,car,crv,252,750,447,746,498,299,0.9501165,20,,2,0.36663844199830653,
56,2,car,crv,111,1317,390,812,1206,422,0.27479288,20,,2,0.34991708126036486,
57,2,car,crv,251,753,447,740,502,293,0.9438285,20,,2,0.34991708126036486,
58,2,car,crv,126,1309,390,814,1183,424,0.30222148,20,,2,1.2916666666666667,
59,2,car,crv,249,757,448,740,508,292,0.91383094,20,,2,1.2916666666666667,
60,2,car,crv,111,1317,390,811,1206,421,0.2941505,20,,2,0.3490878938640133,
61,2,car,crv,247,756,446,741,509,295,0.96245986,20,,2,0.3490878938640133,
62,2,car,crv,134,1300,387,818,1166,431,0.35928637,20,,2,1.28,
63,2,car,crv,251,757,447,743,506,296,0.9412378,20,,2,1.28,
64,2,car,crv,126,1312,388,815,1186,427,0.3965622,20,,2,1.24,
65,2,car,crv,252,758,446,743,506,297,0.9420341,20,,2,1.24,
66,2,car,crv,121,1316,389,809,1195,420,0.4096516,20,,2,1.24,
67,2,car,crv,244,761,447,742,517,295,0.9289579,20,,2,1.24,
68,2,car,crv,125,1312,392,805,1187,413,0.30284005,20,,2,1.24,
69,2,car,crv,245,760,447,739,515,292,0.9596912,20,,2,1.24,
70,2,car,crv,131,1307,388,812,1176,424,0.43397242,20,,2,1.2916666666666667,
71,2,car,crv,247,764,447,744,517,297,0.9014591,20,,2,1.2916666666666667,
72,2,car,crv,123,1315,388,811,1192,423,0.4968379,20,,2,1.24,
73,2,car,crv,246,758,446,743,512,297,0.87933147,20,,2,1.24,
74,2,car,crv,118,1312,389,813,1194,424,0.25691053,20,,2,0.35510887772194305,
75,2,car,crv,249,756,447,742,507,295,0.96910256,20,,2,0.35510887772194305,
76,2,car,crv,118,1319,389,813,1201,424,0.4023961,20,,2,1.28,
77,2,car,crv,243,757,448,743,514,295,0.94143236,20,,2,1.28,
78,2,car,crv,119,1322,385,815,1203,430,0.42900166,20,,2,1.24,
79,2,car,crv,246,762,447,741,516,294,0.790523,20,,2,1.24,
80,2,car,crv,119,1319,386,815,1200,429,0.44753623,20,,2,1.28,
81,2,car,crv,248,759,450,741,511,291,0.8263495,20,,2,1.28,
82,2,car,crv,114,1318,387,813,1204,426,0.43434885,20,,2,1.2916666666666667,
83,2,car,crv,246,759,446,744,513,298,0.9186257,20,,2,1.2916666666666667,
84,2,car,crv,119,1325,389,808,1206,419,0.46840343,20,,2,1.24,
85,2,car,crv,244,759,447,741,515,294,0.83414143,20,,2,1.24,
86,2,car,crv,116,1322,388,811,1206,423,0.44209528,20,,2,1.28,
87,2,car,crv,241,764,450,741,523,291,0.8834957,20,,2,1.28,
88,2,car,crv,334,710,446,701,376,255,0.92716336,3,0,2,0.6781914893617021,
89,2,car,crv,336,711,446,700,375,254,0.9036748,3,0,2,0.6773333333333333,
90,2,car,crv,335,709,444,701,374,257,0.9452533,3,0,2,0.6871657754010695,
0,2,car,crv,119,1307,387,816,1188,429,0.28644451,20,,2,0.3611111111111111,
1,2,car,crv,248,759,443,747,511,304,0.9593547,20,,2,0.3611111111111111,
2,2,car,crv,127,1306,389,820,1179,431,0.37050778,20,,2,1.24,
3,2,car,crv,252,758,449,742,506,293,0.9203835,20,,2,1.24,
4,2,car,crv,126,1306,387,819,1180,432,0.24266188,20,,2,0.36610169491525424,
5,2,car,crv,247,754,449,740,507,291,0.94762105,20,,2,0.36610169491525424,
6,2,car,crv,113,1317,388,815,1204,427,0.36209753,20,,2,1.24,
7,2,car,crv,247,755,446,738,508,292,0.93217456,20,,2,1.24,
8,2,car,crv,116,1312,386,813,1196,427,0.26130736,20,,2,0.35702341137123744,
9,2,car,crv,249,755,445,740,506,295,0.95275867,20,,2,0.35702341137123744,
10,2,car,crv,250,753,445,746,503,301,0.97777426,20,,2,1.24,
11,2,car,crv,117,1316,390,813,1199,423,0.30318785,20,,2,0.35279399499582986,
12,2,car,crv,239,759,447,740,520,293,0.956478,20,,2,0.35279399499582986,
13,2,car,crv,126,1307,387,813,1181,426,0.3400013,20,,2,1.24,
14,2,car,crv,250,757,446,745,507,299,0.93553233,20,,2,1.24,
15,2,car,crv,118,1316,385,817,1198,432,0.46192503,20,,2,1.24,
16,2,car,crv,242,760,449,744,518,295,0.9251644,20,,2,1.24,
17,2,car,crv,125,1310,389,811,1185,422,0.32076746,20,,2,0.3561181434599156,
18,2,car,crv,250,758,446,739,508,293,0.9462212,20,,2,0.3561181434599156,
19,2,car,crv,250,754,444,740,504,296,0.96969557,20,,2,1.24,
20,2,car,crv,113,1313,388,814,1200,426,0.2754978,20,,2,1.24,
21,2,car,crv,244,756,445,743,512,298,0.96916515,20,,2,1.24,
22,2,car,crv,123,1309,388,814,1186,426,0.2760011,20,,2,1.24,
23,2,car,crv,249,758,446,740,509,294,0.950518,20,,2,1.24,
24,2,car,crv,253,754,447,737,501,290,0.94723046,20,,2,1.24,
25,2,car,crv,121,1308,387,817,1187,430,0.21458383,20,,2,0.36225779275484415,
26,2,car,crv,250,754,447,740,504,293,0.9610552,20,,2,0.36225779275484415,
27,2,car,crv,119,1317,388,814,1198,426,0.4732625,20,,2,1.24,
28,2,car,crv,245,758,448,742,513,294,0.94409996,20,,2,1.24,
29,2,car,crv,121,1308,388,815,1187,427,0.21448645,20,,2,0.35973041280539175,
30,2,car,crv,249,753,445,746,504,301,0.9724925,20,,2,0.35973041280539175,
31,2,car,crv,135,1302,387,821,1167,434,0.35179994,20,,2,1.2916666666666667,
32,2,car,crv,250,760,450,741,510,291,0.8736024,20,,2,1.2916666666666667,
33,2,car,crv,117,1313,390,812,1196,422,0.32242462,20,,2,1.2916666666666667,
34,2,car,crv,243,759,447,742,516,295,0.9675998,20,,2,1.2916666666666667,
35,2,car,crv,122,1311,387,814,1189,427,0.36553156,20,,2,1.2916666666666667,
36,2,car,crv,250,757,444,744,507,300,0.9479286,20,,2,1.2916666666666667,
37,2,car,crv,115,1321,388,815,1206,427,0.3674716,20,,2,1.24,
38,2,car,crv,248,756,446,740,508,294,0.92142504,20,,2,1.24,
39,2,car,crv,109,1315,384,827,1206,443,0.2820505,20,,2,1.24,
40,2,car,crv,249,758,449,736,509,287,0.91024953,20,,2,1.24,
41,2,car,crv,122,1310,388,817,1188,429,0.29904467,20,,2,0.3611111111111111,
42,2,car,crv,250,760,448,741,510,293,0.927252,20,,2,0.3611111111111111,
43,2,car,crv,129,1303,389,814,1174,425,0.27334884,20,,2,1.28,
44,2,car,crv,247,760,448,741,513,293,0.9333165,20,,2,1.28,
45,2,car,crv,122,1311,385,813,1189,428,0.35830083,20,,2,1.24,
46,2,car,crv,246,757,442,746,511,304,0.9668414,20,,2,1.24,
47,2,car,crv,122,1312,391,808,1190,417,0.34383425,20,,2,1.28,
48,2,car,crv,248,755,446,741,507,295,0.90284395,20,,2,1.28,
49,2,car,crv,129,1303,386,819,1174,433,0.2341652,20,,2,0.368824531516184,
50,2,car,crv,252,756,447,744,504,297,0.9354642,20,,2,0.368824531516184,
51,2,car,crv,253,756,446,744,503,298,0.97629297,20,,2,1.24,
52,2,car,crv,128,1307,388,817,1179,429,0.32914877,20,,2,1.2916666666666667,
53,2,car,crv,247,762,447,741,515,294,0.9441378,20,,2,1.2916666666666667,
54,2,car,crv,117,1313,388,818,1196,430,0.27251616,20,,2,0.3595317725752508,
55,2,car,crv,247,762,449,740,515,291,0.96550846,20,,2,0.3595317725752508,
56,2,car,crv,124,1305,387,820,1181,433,0.27402008,20,,2,0.36663844199830653,
57,2,car,crv,252,750,447,746,498,299,0.9501165,20,,2,0.36663844199830653,
58,2,car,crv,111,1317,390,812,1206,422,0.27479288,20,,2,0.34991708126036486,
59,2,car,crv,251,753,447,740,502,293,0.9438285,20,,2,0.34991708126036486,
60,2,car,crv,126,1309,390,814,1183,424,0.30222148,20,,2,1.2916666666666667,
61,2,car,crv,249,757,448,740,508,292,0.91383094,20,,2,1.2916666666666667,
62,2,car,crv,111,1317,390,811,1206,421,0.2941505,20,,2,0.3490878938640133,
63,2,car,crv,247,756,446,741,509,295,0.96245986,20,,2,0.3490878938640133,
64,2,car,crv,134,1300,387,818,1166,431,0.35928637,20,,2,1.28,
65,2,car,crv,251,757,447,743,506,296,0.9412378,20,,2,1.28,
66,2,car,crv,126,1312,388,815,1186,427,0.3965622,20,,2,1.24,
67,2,car,crv,252,758,446,743,506,297,0.9420341,20,,2,1.24,
68,2,car,crv,121,1316,389,809,1195,420,0.4096516,20,,2,1.24,
69,2,car,crv,244,761,447,742,517,295,0.9289579,20,,2,1.24,
70,2,car,crv,125,1312,392,805,1187,413,0.30284005,20,,2,1.24,
71,2,car,crv,245,760,447,739,515,292,0.9596912,20,,2,1.24,
72,2,car,crv,131,1307,388,812,1176,424,0.43397242,20,,2,1.2916666666666667,
73,2,car,crv,247,764,447,744,517,297,0.9014591,20,,2,1.2916666666666667,
74,2,car,crv,123,1315,388,811,1192,423,0.4968379,20,,2,1.24,
75,2,car,crv,246,758,446,743,512,297,0.87933147,20,,2,1.24,
76,2,car,crv,118,1312,389,813,1194,424,0.25691053,20,,2,0.35510887772194305,
77,2,car,crv,249,756,447,742,507,295,0.96910256,20,,2,0.35510887772194305,
78,2,car,crv,118,1319,389,813,1201,424,0.4023961,20,,2,1.28,
79,2,car,crv,243,757,448,743,514,295,0.94143236,20,,2,1.28,
80,2,car,crv,119,1322,385,815,1203,430,0.42900166,20,,2,1.24,
81,2,car,crv,246,762,447,741,516,294,0.790523,20,,2,1.24,
82,2,car,crv,119,1319,386,815,1200,429,0.44753623,20,,2,1.28,
83,2,car,crv,248,759,450,741,511,291,0.8263495,20,,2,1.28,
84,2,car,crv,114,1318,387,813,1204,426,0.43434885,20,,2,1.2916666666666667,
85,2,car,crv,246,759,446,744,513,298,0.9186257,20,,2,1.2916666666666667,
86,2,car,crv,119,1325,389,808,1206,419,0.46840343,20,,2,1.24,
87,2,car,crv,244,759,447,741,515,294,0.83414143,20,,2,1.24,
88,2,car,crv,116,1322,388,811,1206,423,0.44209528,20,,2,1.28,
89,2,car,crv,241,764,450,741,523,291,0.8834957,20,,2,1.28,
90,2,car,crv,334,710,446,701,376,255,0.92716336,3,0,2,0.6781914893617021,
91,2,car,crv,336,711,446,700,375,254,0.9036748,3,0,2,0.6773333333333333,
92,2,car,crv,335,709,444,701,374,257,0.9452533,3,0,2,0.6871657754010695,
0,2,car,crv,127,1302,386,816,1175,430,0.37110242,20,,2,1.28,
1,2,car,crv,246,757,444,747,511,303,0.96607155,20,,2,1.28,
2,2,car,crv,119,1307,387,816,1188,429,0.28644451,20,,2,0.3611111111111111,
3,2,car,crv,248,759,443,747,511,304,0.9593547,20,,2,0.3611111111111111,
4,2,car,crv,127,1306,389,820,1179,431,0.37050778,20,,2,1.24,
5,2,car,crv,252,758,449,742,506,293,0.9203835,20,,2,1.24,
6,2,car,crv,126,1306,387,819,1180,432,0.24266188,20,,2,0.36610169491525424,
7,2,car,crv,247,754,449,740,507,291,0.94762105,20,,2,0.36610169491525424,
8,2,car,crv,113,1317,388,815,1204,427,0.36209753,20,,2,1.24,
9,2,car,crv,247,755,446,738,508,292,0.93217456,20,,2,1.24,
10,2,car,crv,116,1312,386,813,1196,427,0.26130736,20,,2,0.35702341137123744,
11,2,car,crv,249,755,445,740,506,295,0.95275867,20,,2,0.35702341137123744,
12,2,car,crv,250,753,445,746,503,301,0.97777426,20,,2,1.24,
13,2,car,crv,117,1316,390,813,1199,423,0.30318785,20,,2,0.35279399499582986,
14,2,car,crv,239,759,447,740,520,293,0.956478,20,,2,0.35279399499582986,
15,2,car,crv,126,1307,387,813,1181,426,0.3400013,20,,2,1.24,
16,2,car,crv,250,757,446,745,507,299,0.93553233,20,,2,1.24,
17,2,car,crv,118,1316,385,817,1198,432,0.46192503,20,,2,1.24,
18,2,car,crv,242,760,449,744,518,295,0.9251644,20,,2,1.24,
19,2,car,crv,125,1310,389,811,1185,422,0.32076746,20,,2,0.3561181434599156,
20,2,car,crv,250,758,446,739,508,293,0.9462212,20,,2,0.3561181434599156,
21,2,car,crv,250,754,444,740,504,296,0.96969557,20,,2,1.24,
22,2,car,crv,113,1313,388,814,1200,426,0.2754978,20,,2,1.24,
23,2,car,crv,244,756,445,743,512,298,0.96916515,20,,2,1.24,
24,2,car,crv,123,1309,388,814,1186,426,0.2760011,20,,2,1.24,
25,2,car,crv,249,758,446,740,509,294,0.950518,20,,2,1.24,
26,2,car,crv,253,754,447,737,501,290,0.94723046,20,,2,1.24,
27,2,car,crv,121,1308,387,817,1187,430,0.21458383,20,,2,0.36225779275484415,
28,2,car,crv,250,754,447,740,504,293,0.9610552,20,,2,0.36225779275484415,
29,2,car,crv,119,1317,388,814,1198,426,0.4732625,20,,2,1.24,
30,2,car,crv,245,758,448,742,513,294,0.94409996,20,,2,1.24,
31,2,car,crv,121,1308,388,815,1187,427,0.21448645,20,,2,0.35973041280539175,
32,2,car,crv,249,753,445,746,504,301,0.9724925,20,,2,0.35973041280539175,
33,2,car,crv,135,1302,387,821,1167,434,0.35179994,20,,2,1.2916666666666667,
34,2,car,crv,250,760,450,741,510,291,0.8736024,20,,2,1.2916666666666667,
35,2,car,crv,117,1313,390,812,1196,422,0.32242462,20,,2,1.2916666666666667,
36,2,car,crv,243,759,447,742,516,295,0.9675998,20,,2,1.2916666666666667,
37,2,car,crv,122,1311,387,814,1189,427,0.36553156,20,,2,1.2916666666666667,
38,2,car,crv,250,757,444,744,507,300,0.9479286,20,,2,1.2916666666666667,
39,2,car,crv,115,1321,388,815,1206,427,0.3674716,20,,2,1.24,
40,2,car,crv,248,756,446,740,508,294,0.92142504,20,,2,1.24,
41,2,car,crv,109,1315,384,827,1206,443,0.2820505,20,,2,1.24,
42,2,car,crv,249,758,449,736,509,287,0.91024953,20,,2,1.24,
43,2,car,crv,122,1310,388,817,1188,429,0.29904467,20,,2,0.3611111111111111,
44,2,car,crv,250,760,448,741,510,293,0.927252,20,,2,0.3611111111111111,
45,2,car,crv,129,1303,389,814,1174,425,0.27334884,20,,2,1.28,
46,2,car,crv,247,760,448,741,513,293,0.9333165,20,,2,1.28,
47,2,car,crv,122,1311,385,813,1189,428,0.35830083,20,,2,1.24,
48,2,car,crv,246,757,442,746,511,304,0.9668414,20,,2,1.24,
49,2,car,crv,122,1312,391,808,1190,417,0.34383425,20,,2,1.28,
50,2,car,crv,248,755,446,741,507,295,0.90284395,20,,2,1.28,
51,2,car,crv,129,1303,386,819,1174,433,0.2341652,20,,2,0.368824531516184,
52,2,car,crv,252,756,447,744,504,297,0.9354642,20,,2,0.368824531516184,
53,2,car,crv,253,756,446,744,503,298,0.97629297,20,,2,1.24,
54,2,car,crv,128,1307,388,817,1179,429,0.32914877,20,,2,1.2916666666666667,
55,2,car,crv,247,762,447,741,515,294,0.9441378,20,,2,1.2916666666666667,
56,2,car,crv,117,1313,388,818,1196,430,0.27251616,20,,2,0.3595317725752508,
57,2,car,crv,247,762,449,740,515,291,0.96550846,20,,2,0.3595317725752508,
58,2,car,crv,124,1305,387,820,1181,433,0.27402008,20,,2,0.36663844199830653,
59,2,car,crv,252,750,447,746,498,299,0.9501165,20,,2,0.36663844199830653,
60,2,car,crv,111,1317,390,812,1206,422,0.27479288,20,,2,0.34991708126036486,
61,2,car,crv,251,753,447,740,502,293,0.9438285,20,,2,0.34991708126036486,
62,2,car,crv,126,1309,390,814,1183,424,0.30222148,20,,2,1.2916666666666667,
63,2,car,crv,249,757,448,740,508,292,0.91383094,20,,2,1.2916666666666667,
64,2,car,crv,111,1317,390,811,1206,421,0.2941505,20,,2,0.3490878938640133,
65,2,car,crv,247,756,446,741,509,295,0.96245986,20,,2,0.3490878938640133,
66,2,car,crv,134,1300,387,818,1166,431,0.35928637,20,,2,1.28,
67,2,car,crv,251,757,447,743,506,296,0.9412378,20,,2,1.28,
68,2,car,crv,126,1312,388,815,1186,427,0.3965622,20,,2,1.24,
69,2,car,crv,252,758,446,743,506,297,0.9420341,20,,2,1.24,
70,2,car,crv,121,1316,389,809,1195,420,0.4096516,20,,2,1.24,
71,2,car,crv,244,761,447,742,517,295,0.9289579,20,,2,1.24,
72,2,car,crv,125,1312,392,805,1187,413,0.30284005,20,,2,1.24,
73,2,car,crv,245,760,447,739,515,292,0.9596912,20,,2,1.24,
74,2,car,crv,131,1307,388,812,1176,424,0.43397242,20,,2,1.2916666666666667,
75,2,car,crv,247,764,447,744,517,297,0.9014591,20,,2,1.2916666666666667,
76,2,car,crv,123,1315,388,811,1192,423,0.4968379,20,,2,1.24,
77,2,car,crv,246,758,446,743,512,297,0.87933147,20,,2,1.24,
78,2,car,crv,118,1312,389,813,1194,424,0.25691053,20,,2,0.35510887772194305,
79,2,car,crv,249,756,447,742,507,295,0.96910256,20,,2,0.35510887772194305,
80,2,car,crv,118,1319,389,813,1201,424,0.4023961,20,,2,1.28,
81,2,car,crv,243,757,448,743,514,295,0.94143236,20,,2,1.28,
82,2,car,crv,119,1322,385,815,1203,430,0.42900166,20,,2,1.24,
83,2,car,crv,246,762,447,741,516,294,0.790523,20,,2,1.24,
84,2,car,crv,119,1319,386,815,1200,429,0.44753623,20,,2,1.28,
85,2,car,crv,248,759,450,741,511,291,0.8263495,20,,2,1.28,
86,2,car,crv,114,1318,387,813,1204,426,0.43434885,20,,2,1.2916666666666667,
87,2,car,crv,246,759,446,744,513,298,0.9186257,20,,2,1.2916666666666667,
88,2,car,crv,119,1325,389,808,1206,419,0.46840343,20,,2,1.24,
89,2,car,crv,244,759,447,741,515,294,0.83414143,20,,2,1.24,
90,2,car,crv,116,1322,388,811,1206,423,0.44209528,20,,2,1.28,
91,2,car,crv,241,764,450,741,523,291,0.8834957,20,,2,1.28,
92,2,car,crv,334,710,446,701,376,255,0.92716336,3,0,2,0.6781914893617021,
93,2,car,crv,336,711,446,700,375,254,0.9036748,3,0,2,0.6773333333333333,
94,2,car,crv,335,709,444,701,374,257,0.9452533,3,0,2,0.6871657754010695,
0,2,car,crv,127,1307,391,814,1180,423,0.278648,20,,2,0.35847457627118645,
1,2,car,crv,250,755,447,744,505,297,0.95984495,20,,2,0.35847457627118645,
2,2,car,crv,127,1302,386,816,1175,430,0.37110242,20,,2,1.28,
3,2,car,crv,246,757,444,747,511,303,0.96607155,20,,2,1.28,
4,2,car,crv,119,1307,387,816,1188,429,0.28644451,20,,2,0.3611111111111111,
5,2,car,crv,248,759,443,747,511,304,0.9593547,20,,2,0.3611111111111111,
6,2,car,crv,127,1306,389,820,1179,431,0.37050778,20,,2,1.24,
7,2,car,crv,252,758,449,742,506,293,0.9203835,20,,2,1.24,
8,2,car,crv,126,1306,387,819,1180,432,0.24266188,20,,2,0.36610169491525424,
9,2,car,crv,247,754,449,740,507,291,0.94762105,20,,2,0.36610169491525424,
10,2,car,crv,113,1317,388,815,1204,427,0.36209753,20,,2,1.24,
11,2,car,crv,247,755,446,738,508,292,0.93217456,20,,2,1.24,
12,2,car,crv,116,1312,386,813,1196,427,0.26130736,20,,2,0.35702341137123744,
13,2,car,crv,249,755,445,740,506,295,0.95275867,20,,2,0.35702341137123744,
14,2,car,crv,250,753,445,746,503,301,0.97777426,20,,2,1.24,
15,2,car,crv,117,1316,390,813,1199,423,0.30318785,20,,2,0.35279399499582986,
16,2,car,crv,239,759,447,740,520,293,0.956478,20,,2,0.35279399499582986,
17,2,car,crv,126,1307,387,813,1181,426,0.3400013,20,,2,1.24,
18,2,car,crv,250,757,446,745,507,299,0.93553233,20,,2,1.24,
19,2,car,crv,118,1316,385,817,1198,432,0.46192503,20,,2,1.24,
20,2,car,crv,242,760,449,744,518,295,0.9251644,20,,2,1.24,
21,2,car,crv,125,1310,389,811,1185,422,0.32076746,20,,2,0.3561181434599156,
22,2,car,crv,250,758,446,739,508,293,0.9462212,20,,2,0.3561181434599156,
23,2,car,crv,250,754,444,740,504,296,0.96969557,20,,2,1.24,
24,2,car,crv,113,1313,388,814,1200,426,0.2754978,20,,2,1.24,
25,2,car,crv,244,756,445,743,512,298,0.96916515,20,,2,1.24,
26,2,car,crv,123,1309,388,814,1186,426,0.2760011,20,,2,1.24,
27,2,car,crv,249,758,446,740,509,294,0.950518,20,,2,1.24,
28,2,car,crv,253,754,447,737,501,290,0.94723046,20,,2,1.24,
29,2,car,crv,121,1308,387,817,1187,430,0.21458383,20,,2,0.36225779275484415,
30,2,car,crv,250,754,447,740,504,293,0.9610552,20,,2,0.36225779275484415,
31,2,car,crv,119,1317,388,814,1198,426,0.4732625,20,,2,1.24,
32,2,car,crv,245,758,448,742,513,294,0.94409996,20,,2,1.24,
33,2,car,crv,121,1308,388,815,1187,427,0.21448645,20,,2,0.35973041280539175,
34,2,car,crv,249,753,445,746,504,301,0.9724925,20,,2,0.35973041280539175,
35,2,car,crv,135,1302,387,821,1167,434,0.35179994,20,,2,1.2916666666666667,
36,2,car,crv,250,760,450,741,510,291,0.8736024,20,,2,1.2916666666666667,
37,2,car,crv,117,1313,390,812,1196,422,0.32242462,20,,2,1.2916666666666667,
38,2,car,crv,243,759,447,742,516,295,0.9675998,20,,2,1.2916666666666667,
39,2,car,crv,122,1311,387,814,1189,427,0.36553156,20,,2,1.2916666666666667,
40,2,car,crv,250,757,444,744,507,300,0.9479286,20,,2,1.2916666666666667,
41,2,car,crv,115,1321,388,815,1206,427,0.3674716,20,,2,1.24,
42,2,car,crv,248,756,446,740,508,294,0.92142504,20,,2,1.24,
43,2,car,crv,109,1315,384,827,1206,443,0.2820505,20,,2,1.24,
44,2,car,crv,249,758,449,736,509,287,0.91024953,20,,2,1.24,
45,2,car,crv,122,1310,388,817,1188,429,0.29904467,20,,2,0.3611111111111111,
46,2,car,crv,250,760,448,741,510,293,0.927252,20,,2,0.3611111111111111,
47,2,car,crv,129,1303,389,814,1174,425,0.27334884,20,,2,1.28,
48,2,car,crv,247,760,448,741,513,293,0.9333165,20,,2,1.28,
49,2,car,crv,122,1311,385,813,1189,428,0.35830083,20,,2,1.24,
50,2,car,crv,246,757,442,746,511,304,0.9668414,20,,2,1.24,
51,2,car,crv,122,1312,391,808,1190,417,0.34383425,20,,2,1.28,
52,2,car,crv,248,755,446,741,507,295,0.90284395,20,,2,1.28,
53,2,car,crv,129,1303,386,819,1174,433,0.2341652,20,,2,0.368824531516184,
54,2,car,crv,252,756,447,744,504,297,0.9354642,20,,2,0.368824531516184,
55,2,car,crv,253,756,446,744,503,298,0.97629297,20,,2,1.24,
56,2,car,crv,128,1307,388,817,1179,429,0.32914877,20,,2,1.2916666666666667,
57,2,car,crv,247,762,447,741,515,294,0.9441378,20,,2,1.2916666666666667,
58,2,car,crv,117,1313,388,818,1196,430,0.27251616,20,,2,0.3595317725752508,
59,2,car,crv,247,762,449,740,515,291,0.96550846,20,,2,0.3595317725752508,
60,2,car,crv,124,1305,387,820,1181,433,0.27402008,20,,2,0.36663844199830653,
61,2,car,crv,252,750,447,746,498,299,0.9501165,20,,2,0.36663844199830653,
62,2,car,crv,111,1317,390,812,1206,422,0.27479288,20,,2,0.34991708126036486,
63,2,car,crv,251,753,447,740,502,293,0.9438285,20,,2,0.34991708126036486,
64,2,car,crv,126,1309,390,814,1183,424,0.30222148,20,,2,1.2916666666666667,
65,2,car,crv,249,757,448,740,508,292,0.91383094,20,,2,1.2916666666666667,
66,2,car,crv,111,1317,390,811,1206,421,0.2941505,20,,2,0.3490878938640133,
67,2,car,crv,247,756,446,741,509,295,0.96245986,20,,2,0.3490878938640133,
68,2,car,crv,134,1300,387,818,1166,431,0.35928637,20,,2,1.28,
69,2,car,crv,251,757,447,743,506,296,0.9412378,20,,2,1.28,
70,2,car,crv,126,1312,388,815,1186,427,0.3965622,20,,2,1.24,
71,2,car,crv,252,758,446,743,506,297,0.9420341,20,,2,1.24,
72,2,car,crv,121,1316,389,809,1195,420,0.4096516,20,,2,1.24,
73,2,car,crv,244,761,447,742,517,295,0.9289579,20,,2,1.24,
74,2,car,crv,125,1312,392,805,1187,413,0.30284005,20,,2,1.24,
75,2,car,crv,245,760,447,739,515,292,0.9596912,20,,2,1.24,
76,2,car,crv,131,1307,388,812,1176,424,0.43397242,20,,2,1.2916666666666667,
77,2,car,crv,247,764,447,744,517,297,0.9014591,20,,2,1.2916666666666667,
78,2,car,crv,123,1315,388,811,1192,423,0.4968379,20,,2,1.24,
79,2,car,crv,246,758,446,743,512,297,0.87933147,20,,2,1.24,
80,2,car,crv,118,1312,389,813,1194,424,0.25691053,20,,2,0.35510887772194305,
81,2,car,crv,249,756,447,742,507,295,0.96910256,20,,2,0.35510887772194305,
82,2,car,crv,118,1319,389,813,1201,424,0.4023961,20,,2,1.28,
83,2,car,crv,243,757,448,743,514,295,0.94143236,20,,2,1.28,
84,2,car,crv,119,1322,385,815,1203,430,0.42900166,20,,2,1.24,
85,2,car,crv,246,762,447,741,516,294,0.790523,20,,2,1.24,
86,2,car,crv,119,1319,386,815,1200,429,0.44753623,20,,2,1.28,
87,2,car,crv,248,759,450,741,511,291,0.8263495,20,,2,1.28,
88,2,car,crv,114,1318,387,813,1204,426,0.43434885,20,,2,1.2916666666666667,
89,2,car,crv,246,759,446,744,513,298,0.9186257,20,,2,1.2916666666666667,
90,2,car,crv,119,1325,389,808,1206,419,0.46840343,20,,2,1.24,
91,2,car,crv,244,759,447,741,515,294,0.83414143,20,,2,1.24,
92,2,car,crv,116,1322,388,811,1206,423,0.44209528,20,,2,1.28,
93,2,car,crv,241,764,450,741,523,291,0.8834957,20,,2,1.28,
94,2,car,crv,334,710,446,701,376,255,0.92716336,3,0,2,0.6781914893617021,
95,2,car,crv,336,711,446,700,375,254,0.9036748,3,0,2,0.6773333333333333,
96,2,car,crv,335,709,444,701,374,257,0.9452533,3,0,2,0.6871657754010695,
0,2,car,crv,114,1320,387,815,1206,428,0.30274954,20,,2,1.24,
1,2,car,crv,248,753,446,740,505,294,0.8954264,20,,2,1.24,
2,2,car,crv,127,1307,391,814,1180,423,0.278648,20,,2,0.35847457627118645,
3,2,car,crv,250,755,447,744,505,297,0.95984495,20,,2,0.35847457627118645,
4,2,car,crv,127,1302,386,816,1175,430,0.37110242,20,,2,1.28,
5,2,car,crv,246,757,444,747,511,303,0.96607155,20,,2,1.28,
6,2,car,crv,119,1307,387,816,1188,429,0.28644451,20,,2,0.3611111111111111,
7,2,car,crv,248,759,443,747,511,304,0.9593547,20,,2,0.3611111111111111,
8,2,car,crv,127,1306,389,820,1179,431,0.37050778,20,,2,1.24,
9,2,car,crv,252,758,449,742,506,293,0.9203835,20,,2,1.24,
10,2,car,crv,126,1306,387,819,1180,432,0.24266188,20,,2,0.36610169491525424,
11,2,car,crv,247,754,449,740,507,291,0.94762105,20,,2,0.36610169491525424,
12,2,car,crv,113,1317,388,815,1204,427,0.36209753,20,,2,1.24,
13,2,car,crv,247,755,446,738,508,292,0.93217456,20,,2,1.24,
14,2,car,crv,116,1312,386,813,1196,427,0.26130736,20,,2,0.35702341137123744,
15,2,car,crv,249,755,445,740,506,295,0.95275867,20,,2,0.35702341137123744,
16,2,car,crv,250,753,445,746,503,301,0.97777426,20,,2,1.24,
17,2,car,crv,117,1316,390,813,1199,423,0.30318785,20,,2,0.35279399499582986,
18,2,car,crv,239,759,447,740,520,293,0.956478,20,,2,0.35279399499582986,
19,2,car,crv,126,1307,387,813,1181,426,0.3400013,20,,2,1.24,
20,2,car,crv,250,757,446,745,507,299,0.93553233,20,,2,1.24,
21,2,car,crv,118,1316,385,817,1198,432,0.46192503,20,,2,1.24,
22,2,car,crv,242,760,449,744,518,295,0.9251644,20,,2,1.24,
23,2,car,crv,125,1310,389,811,1185,422,0.32076746,20,,2,0.3561181434599156,
24,2,car,crv,250,758,446,739,508,293,0.9462212,20,,2,0.3561181434599156,
25,2,car,crv,250,754,444,740,504,296,0.96969557,20,,2,1.24,
26,2,car,crv,113,1313,388,814,1200,426,0.2754978,20,,2,1.24,
27,2,car,crv,244,756,445,743,512,298,0.96916515,20,,2,1.24,
28,2,car,crv,123,1309,388,814,1186,426,0.2760011,20,,2,1.24,
29,2,car,crv,249,758,446,740,509,294,0.950518,20,,2,1.24,
30,2,car,crv,253,754,447,737,501,290,0.94723046,20,,2,1.24,
31,2,car,crv,121,1308,387,817,1187,430,0.21458383,20,,2,0.36225779275484415,
32,2,car,crv,250,754,447,740,504,293,0.9610552,20,,2,0.36225779275484415,
33,2,car,crv,119,1317,388,814,1198,426,0.4732625,20,,2,1.24,
34,2,car,crv,245,758,448,742,513,294,0.94409996,20,,2,1.24,
35,2,car,crv,121,1308,388,815,1187,427,0.21448645,20,,2,0.35973041280539175,
36,2,car,crv,249,753,445,746,504,301,0.9724925,20,,2,0.35973041280539175,
37,2,car,crv,135,1302,387,821,1167,434,0.35179994,20,,2,1.2916666666666667,
38,2,car,crv,250,760,450,741,510,291,0.8736024,20,,2,1.2916666666666667,
39,2,car,crv,117,1313,390,812,1196,422,0.32242462,20,,2,1.2916666666666667,
40,2,car,crv,243,759,447,742,516,295,0.9675998,20,,2,1.2916666666666667,
41,2,car,crv,122,1311,387,814,1189,427,0.36553156,20,,2,1.2916666666666667,
42,2,car,crv,250,757,444,744,507,300,0.9479286,20,,2,1.2916666666666667,
43,2,car,crv,115,1321,388,815,1206,427,0.3674716,20,,2,1.24,
44,2,car,crv,248,756,446,740,508,294,0.92142504,20,,2,1.24,
45,2,car,crv,109,1315,384,827,1206,443,0.2820505,20,,2,1.24,
46,2,car,crv,249,758,449,736,509,287,0.91024953,20,,2,1.24,
47,2,car,crv,122,1310,388,817,1188,429,0.29904467,20,,2,0.3611111111111111,
48,2,car,crv,250,760,448,741,510,293,0.927252,20,,2,0.3611111111111111,
49,2,car,crv,129,1303,389,814,1174,425,0.27334884,20,,2,1.28,
50,2,car,crv,247,760,448,741,513,293,0.9333165,20,,2,1.28,
51,2,car,crv,122,1311,385,813,1189,428,0.35830083,20,,2,1.24,
52,2,car,crv,246,757,442,746,511,304,0.9668414,20,,2,1.24,
53,2,car,crv,122,1312,391,808,1190,417,0.34383425,20,,2,1.28,
54,2,car,crv,248,755,446,741,507,295,0.90284395,20,,2,1.28,
55,2,car,crv,129,1303,386,819,1174,433,0.2341652,20,,2,0.368824531516184,
56,2,car,crv,252,756,447,744,504,297,0.9354642,20,,2,0.368824531516184,
57,2,car,crv,253,756,446,744,503,298,0.97629297,20,,2,1.24,
58,2,car,crv,128,1307,388,817,1179,429,0.32914877,20,,2,1.2916666666666667,
59,2,car,crv,247,762,447,741,515,294,0.9441378,20,,2,1.2916666666666667,
60,2,car,crv,117,1313,388,818,1196,430,0.27251616,20,,2,0.3595317725752508,
61,2,car,crv,247,762,449,740,515,291,0.96550846,20,,2,0.3595317725752508,
62,2,car,crv,124,1305,387,820,1181,433,0.27402008,20,,2,0.36663844199830653,
63,2,car,crv,252,750,447,746,498,299,0.9501165,20,,2,0.36663844199830653,
64,2,car,crv,111,1317,390,812,1206,422,0.27479288,20,,2,0.34991708126036486,
65,2,car,crv,251,753,447,740,502,293,0.9438285,20,,2,0.34991708126036486,
66,2,car,crv,126,1309,390,814,1183,424,0.30222148,20,,2,1.2916666666666667,
67,2,car,crv,249,757,448,740,508,292,0.91383094,20,,2,1.2916666666666667,
68,2,car,crv,111,1317,390,811,1206,421,0.2941505,20,,2,0.3490878938640133,
69,2,car,crv,247,756,446,741,509,295,0.96245986,20,,2,0.3490878938640133,
70,2,car,crv,134,1300,387,818,1166,431,0.35928637,20,,2,1.28,
71,2,car,crv,251,757,447,743,506,296,0.9412378,20,,2,1.28,
72,2,car,crv,126,1312,388,815,1186,427,0.3965622,20,,2,1.24,
73,2,car,crv,252,758,446,743,506,297,0.9420341,20,,2,1.24,
74,2,car,crv,121,1316,389,809,1195,420,0.4096516,20,,2,1.24,
75,2,car,crv,244,761,447,742,517,295,0.9289579,20,,2,1.24,
76,2,car,crv,125,1312,392,805,1187,413,0.30284005,20,,2,1.24,
77,2,car,crv,245,760,447,739,515,292,0.9596912,20,,2,1.24,
78,2,car,crv,131,1307,388,812,1176,424,0.43397242,20,,2,1.2916666666666667,
79,2,car,crv,247,764,447,744,517,297,0.9014591,20,,2,1.2916666666666667,
80,2,car,crv,123,1315,388,811,1192,423,0.4968379,20,,2,1.24,
81,2,car,crv,246,758,446,743,512,297,0.87933147,20,,2,1.24,
82,2,car,crv,118,1312,389,813,1194,424,0.25691053,20,,2,0.35510887772194305,
83,2,car,crv,249,756,447,742,507,295,0.96910256,20,,2,0.35510887772194305,
84,2,car,crv,118,1319,389,813,1201,424,0.4023961,20,,2,1.28,
85,2,car,crv,243,757,448,743,514,295,0.94143236,20,,2,1.28,
86,2,car,crv,119,1322,385,815,1203,430,0.42900166,20,,2,1.24,
87,2,car,crv,246,762,447,741,516,294,0.790523,20,,2,1.24,
88,2,car,crv,119,1319,386,815,1200,429,0.44753623,20,,2,1.28,
89,2,car,crv,248,759,450,741,511,291,0.8263495,20,,2,1.28,
90,2,car,crv,114,1318,387,813,1204,426,0.43434885,20,,2,1.2916666666666667,
91,2,car,crv,246,759,446,744,513,298,0.9186257,20,,2,1.2916666666666667,
92,2,car,crv,119,1325,389,808,1206,419,0.46840343,20,,2,1.24,
93,2,car,crv,244,759,447,741,515,294,0.83414143,20,,2,1.24,
94,2,car,crv,116,1322,388,811,1206,423,0.44209528,20,,2,1.28,
95,2,car,crv,241,764,450,741,523,291,0.8834957,20,,2,1.28,
96,2,car,crv,334,710,446,701,376,255,0.92716336,3,0,2,0.6781914893617021,
97,2,car,crv,336,711,446,700,375,254,0.9036748,3,0,2,0.6773333333333333,
98,2,car,crv,335,709,444,701,374,257,0.9452533,3,0,2,0.6871657754010695,
0,2,car,crv,129,1304,390,814,1175,424,0.26254445,20,,2,1.2916666666666667,
1,2,car,crv,252,755,447,740,503,293,0.94612926,20,,2,1.2916666666666667,
2,2,car,crv,114,1320,387,815,1206,428,0.30274954,20,,2,1.24,
3,2,car,crv,248,753,446,740,505,294,0.8954264,20,,2,1.24,
4,2,car,crv,127,1307,391,814,1180,423,0.278648,20,,2,0.35847457627118645,
5,2,car,crv,250,755,447,744,505,297,0.95984495,20,,2,0.35847457627118645,
6,2,car,crv,127,1302,386,816,1175,430,0.37110242,20,,2,1.28,
7,2,car,crv,246,757,444,747,511,303,0.96607155,20,,2,1.28,
8,2,car,crv,119,1307,387,816,1188,429,0.28644451,20,,2,0.3611111111111111,
9,2,car,crv,248,759,443,747,511,304,0.9593547,20,,2,0.3611111111111111,
10,2,car,crv,127,1306,389,820,1179,431,0.37050778,20,,2,1.24,
11,2,car,crv,252,758,449,742,506,293,0.9203835,20,,2,1.24,
12,2,car,crv,126,1306,387,819,1180,432,0.24266188,20,,2,0.36610169491525424,
13,2,car,crv,247,754,449,740,507,291,0.94762105,20,,2,0.36610169491525424,
14,2,car,crv,113,1317,388,815,1204,427,0.36209753,20,,2,1.24,
15,2,car,crv,247,755,446,738,508,292,0.93217456,20,,2,1.24,
16,2,car,crv,116,1312,386,813,1196,427,0.26130736,20,,2,0.35702341137123744,
17,2,car,crv,249,755,445,740,506,295,0.95275867,20,,2,0.35702341137123744,
18,2,car,crv,250,753,445,746,503,301,0.97777426,20,,2,1.24,
19,2,car,crv,117,1316,390,813,1199,423,0.30318785,20,,2,0.35279399499582986,
20,2,car,crv,239,759,447,740,520,293,0.956478,20,,2,0.35279399499582986,
21,2,car,crv,126,1307,387,813,1181,426,0.3400013,20,,2,1.24,
22,2,car,crv,250,757,446,745,507,299,0.93553233,20,,2,1.24,
23,2,car,crv,118,1316,385,817,1198,432,0.46192503,20,,2,1.24,
24,2,car,crv,242,760,449,744,518,295,0.9251644,20,,2,1.24,
25,2,car,crv,125,1310,389,811,1185,422,0.32076746,20,,2,0.3561181434599156,
26,2,car,crv,250,758,446,739,508,293,0.9462212,20,,2,0.3561181434599156,
27,2,car,crv,250,754,444,740,504,296,0.96969557,20,,2,1.24,
28,2,car,crv,113,1313,388,814,1200,426,0.2754978,20,,2,1.24,
29,2,car,crv,244,756,445,743,512,298,0.96916515,20,,2,1.24,
30,2,car,crv,123,1309,388,814,1186,426,0.2760011,20,,2,1.24,
31,2,car,crv,249,758,446,740,509,294,0.950518,20,,2,1.24,
32,2,car,crv,253,754,447,737,501,290,0.94723046,20,,2,1.24,
33,2,car,crv,121,1308,387,817,1187,430,0.21458383,20,,2,0.36225779275484415,
34,2,car,crv,250,754,447,740,504,293,0.9610552,20,,2,0.36225779275484415,
35,2,car,crv,119,1317,388,814,1198,426,0.4732625,20,,2,1.24,
36,2,car,crv,245,758,448,742,513,294,0.94409996,20,,2,1.24,
37,2,car,crv,121,1308,388,815,1187,427,0.21448645,20,,2,0.35973041280539175,
38,2,car,crv,249,753,445,746,504,301,0.9724925,20,,2,0.35973041280539175,
39,2,car,crv,135,1302,387,821,1167,434,0.35179994,20,,2,1.2916666666666667,
40,2,car,crv,250,760,450,741,510,291,0.8736024,20,,2,1.2916666666666667,
41,2,car,crv,117,1313,390,812,1196,422,0.32242462,20,,2,1.2916666666666667,
42,2,car,crv,243,759,447,742,516,295,0.9675998,20,,2,1.2916666666666667,
43,2,car,crv,122,1311,387,814,1189,427,0.36553156,20,,2,1.2916666666666667,
44,2,car,crv,250,757,444,744,507,300,0.9479286,20,,2,1.2916666666666667,
45,2,car,crv,115,1321,388,815,1206,427,0.3674716,20,,2,1.24,
46,2,car,crv,248,756,446,740,508,294,0.92142504,20,,2,1.24,
47,2,car,crv,109,1315,384,827,1206,443,0.2820505,20,,2,1.24,
48,2,car,crv,249,758,449,736,509,287,0.91024953,20,,2,1.24,
49,2,car,crv,122,1310,388,817,1188,429,0.29904467,20,,2,0.3611111111111111,
50,2,car,crv,250,760,448,741,510,293,0.927252,20,,2,0.3611111111111111,
51,2,car,crv,129,1303,389,814,1174,425,0.27334884,20,,2,1.28,
52,2,car,crv,247,760,448,741,513,293,0.9333165,20,,2,1.28,
53,2,car,crv,122,1311,385,813,1189,428,0.35830083,20,,2,1.24,
54,2,car,crv,246,757,442,746,511,304,0.9668414,20,,2,1.24,
55,2,car,crv,122,1312,391,808,1190,417,0.34383425,20,,2,1.28,
56,2,car,crv,248,755,446,741,507,295,0.90284395,20,,2,1.28,
57,2,car,crv,129,1303,386,819,1174,433,0.2341652,20,,2,0.368824531516184,
58,2,car,crv,252,756,447,744,504,297,0.9354642,20,,2,0.368824531516184,
59,2,car,crv,253,756,446,744,503,298,0.97629297,20,,2,1.24,
60,2,car,crv,128,1307,388,817,1179,429,0.32914877,20,,2,1.2916666666666667,
61,2,car,crv,247,762,447,741,515,294,0.9441378,20,,2,1.2916666666666667,
62,2,car,crv,117,1313,388,818,1196,430,0.27251616,20,,2,0.3595317725752508,
63,2,car,crv,247,762,449,740,515,291,0.96550846,20,,2,0.3595317725752508,
64,2,car,crv,124,1305,387,820,1181,433,0.27402008,20,,2,0.36663844199830653,
65,2,car,crv,252,750,447,746,498,299,0.9501165,20,,2,0.36663844199830653,
66,2,car,crv,111,1317,390,812,1206,422,0.27479288,20,,2,0.34991708126036486,
67,2,car,crv,251,753,447,740,502,293,0.9438285,20,,2,0.34991708126036486,
68,2,car,crv,126,1309,390,814,1183,424,0.30222148,20,,2,1.2916666666666667,
69,2,car,crv,249,757,448,740,508,292,0.91383094,20,,2,1.2916666666666667,
70,2,car,crv,111,1317,390,811,1206,421,0.2941505,20,,2,0.3490878938640133,
71,2,car,crv,247,756,446,741,509,295,0.96245986,20,,2,0.3490878938640133,
72,2,car,crv,134,1300,387,818,1166,431,0.35928637,20,,2,1.28,
73,2,car,crv,251,757,447,743,506,296,0.9412378,20,,2,1.28,
74,2,car,crv,126,1312,388,815,1186,427,0.3965622,20,,2,1.24,
75,2,car,crv,252,758,446,743,506,297,0.9420341,20,,2,1.24,
76,2,car,crv,121,1316,389,809,1195,420,0.4096516,20,,2,1.24,
77,2,car,crv,244,761,447,742,517,295,0.9289579,20,,2,1.24,
78,2,car,crv,125,1312,392,805,1187,413,0.30284005,20,,2,1.24,
79,2,car,crv,245,760,447,739,515,292,0.9596912,20,,2,1.24,
80,2,car,crv,131,1307,388,812,1176,424,0.43397242,20,,2,1.2916666666666667,
81,2,car,crv,247,764,447,744,517,297,0.9014591,20,,2,1.2916666666666667,
82,2,car,crv,123,1315,388,811,1192,423,0.4968379,20,,2,1.24,
83,2,car,crv,246,758,446,743,512,297,0.87933147,20,,2,1.24,
84,2,car,crv,118,1312,389,813,1194,424,0.25691053,20,,2,0.35510887772194305,
85,2,car,crv,249,756,447,742,507,295,0.96910256,20,,2,0.35510887772194305,
86,2,car,crv,118,1319,389,813,1201,424,0.4023961,20,,2,1.28,
87,2,car,crv,243,757,448,743,514,295,0.94143236,20,,2,1.28,
88,2,car,crv,119,1322,385,815,1203,430,0.42900166,20,,2,1.24,
89,2,car,crv,246,762,447,741,516,294,0.790523,20,,2,1.24,
90,2,car,crv,119,1319,386,815,1200,429,0.44753623,20,,2,1.28,
91,2,car,crv,248,759,450,741,511,291,0.8263495,20,,2,1.28,
92,2,car,crv,114,1318,387,813,1204,426,0.43434885,20,,2,1.2916666666666667,
93,2,car,crv,246,759,446,744,513,298,0.9186257,20,,2,1.2916666666666667,
94,2,car,crv,119,1325,389,808,1206,419,0.46840343,20,,2,1.24,
95,2,car,crv,244,759,447,741,515,294,0.83414143,20,,2,1.24,
96,2,car,crv,116,1322,388,811,1206,423,0.44209528,20,,2,1.28,
97,2,car,crv,241,764,450,741,523,291,0.8834957,20,,2,1.28,
98,2,car,crv,334,710,446,701,376,255,0.92716336,3,0,2,0.6781914893617021,
99,2,car,crv,336,711,446,700,375,254,0.9036748,3,0,2,0.6773333333333333,
100,2,car,crv,335,709,444,701,374,257,0.9452533,3,0,2,0.6871657754010695,
0,2,car,crv,125,1314,388,816,1189,428,0.42268884,20,,2,1.28,
1,2,car,crv,248,760,449,737,512,288,0.90941703,20,,2,1.28,
2,2,car,crv,129,1304,390,814,1175,424,0.26254445,20,,2,1.2916666666666667,
3,2,car,crv,252,755,447,740,503,293,0.94612926,20,,2,1.2916666666666667,
4,2,car,crv,114,1320,387,815,1206,428,0.30274954,20,,2,1.24,
5,2,car,crv,248,753,446,740,505,294,0.8954264,20,,2,1.24,
6,2,car,crv,127,1307,391,814,1180,423,0.278648,20,,2,0.35847457627118645,
7,2,car,crv,250,755,447,744,505,297,0.95984495,20,,2,0.35847457627118645,
8,2,car,crv,127,1302,386,816,1175,430,0.37110242,20,,2,1.28,
9,2,car,crv,246,757,444,747,511,303,0.96607155,20,,2,1.28,
10,2,car,crv,119,1307,387,816,1188,429,0.28644451,20,,2,0.3611111111111111,
11,2,car,crv,248,759,443,747,511,304,0.9593547,20,,2,0.3611111111111111,
12,2,car,crv,127,1306,389,820,1179,431,0.37050778,20,,2,1.24,
13,2,car,crv,252,758,449,742,506,293,0.9203835,20,,2,1.24,
14,2,car,crv,126,1306,387,819,1180,432,0.24266188,20,,2,0.36610169491525424,
15,2,car,crv,247,754,449,740,507,291,0.94762105,20,,2,0.36610169491525424,
16,2,car,crv,113,1317,388,815,1204,427,0.36209753,20,,2,1.24,
17,2,car,crv,247,755,446,738,508,292,0.93217456,20,,2,1.24,
18,2,car,crv,116,1312,386,813,1196,427,0.26130736,20,,2,0.35702341137123744,
19,2,car,crv,249,755,445,740,506,295,0.95275867,20,,2,0.35702341137123744,
20,2,car,crv,250,753,445,746,503,301,0.97777426,20,,2,1.24,
21,2,car,crv,117,1316,390,813,1199,423,0.30318785,20,,2,0.35279399499582986,
22,2,car,crv,239,759,447,740,520,293,0.956478,20,,2,0.35279399499582986,
23,2,car,crv,126,1307,387,813,1181,426,0.3400013,20,,2,1.24,
24,2,car,crv,250,757,446,745,507,299,0.93553233,20,,2,1.24,
25,2,car,crv,118,1316,385,817,1198,432,0.46192503,20,,2,1.24,
26,2,car,crv,242,760,449,744,518,295,0.9251644,20,,2,1.24,
27,2,car,crv,125,1310,389,811,1185,422,0.32076746,20,,2,0.3561181434599156,
28,2,car,crv,250,758,446,739,508,293,0.9462212,20,,2,0.3561181434599156,
29,2,car,crv,250,754,444,740,504,296,0.96969557,20,,2,1.24,
30,2,car,crv,113,1313,388,814,1200,426,0.2754978,20,,2,1.24,
31,2,car,crv,244,756,445,743,512,298,0.96916515,20,,2,1.24,
32,2,car,crv,123,1309,388,814,1186,426,0.2760011,20,,2,1.24,
33,2,car,crv,249,758,446,740,509,294,0.950518,20,,2,1.24,
34,2,car,crv,253,754,447,737,501,290,0.94723046,20,,2,1.24,
35,2,car,crv,121,1308,387,817,1187,430,0.21458383,20,,2,0.36225779275484415,
36,2,car,crv,250,754,447,740,504,293,0.9610552,20,,2,0.36225779275484415,
37,2,car,crv,119,1317,388,814,1198,426,0.4732625,20,,2,1.24,
38,2,car,crv,245,758,448,742,513,294,0.94409996,20,,2,1.24,
39,2,car,crv,121,1308,388,815,1187,427,0.21448645,20,,2,0.35973041280539175,
40,2,car,crv,249,753,445,746,504,301,0.9724925,20,,2,0.35973041280539175,
41,2,car,crv,135,1302,387,821,1167,434,0.35179994,20,,2,1.2916666666666667,
42,2,car,crv,250,760,450,741,510,291,0.8736024,20,,2,1.2916666666666667,
43,2,car,crv,117,1313,390,812,1196,422,0.32242462,20,,2,1.2916666666666667,
44,2,car,crv,243,759,447,742,516,295,0.9675998,20,,2,1.2916666666666667,
45,2,car,crv,122,1311,387,814,1189,427,0.36553156,20,,2,1.2916666666666667,
46,2,car,crv,250,757,444,744,507,300,0.9479286,20,,2,1.2916666666666667,
47,2,car,crv,115,1321,388,815,1206,427,0.3674716,20,,2,1.24,
48,2,car,crv,248,756,446,740,508,294,0.92142504,20,,2,1.24,
49,2,car,crv,109,1315,384,827,1206,443,0.2820505,20,,2,1.24,
50,2,car,crv,249,758,449,736,509,287,0.91024953,20,,2,1.24,
51,2,car,crv,122,1310,388,817,1188,429,0.29904467,20,,2,0.3611111111111111,
52,2,car,crv,250,760,448,741,510,293,0.927252,20,,2,0.3611111111111111,
53,2,car,crv,129,1303,389,814,1174,425,0.27334884,20,,2,1.28,
54,2,car,crv,247,760,448,741,513,293,0.9333165,20,,2,1.28,
55,2,car,crv,122,1311,385,813,1189,428,0.35830083,20,,2,1.24,
56,2,car,crv,246,757,442,746,511,304,0.9668414,20,,2,1.24,
57,2,car,crv,122,1312,391,808,1190,417,0.34383425,20,,2,1.28,
58,2,car,crv,248,755,446,741,507,295,0.90284395,20,,2,1.28,
59,2,car,crv,129,1303,386,819,1174,433,0.2341652,20,,2,0.368824531516184,
60,2,car,crv,252,756,447,744,504,297,0.9354642,20,,2,0.368824531516184,
61,2,car,crv,253,756,446,744,503,298,0.97629297,20,,2,1.24,
62,2,car,crv,128,1307,388,817,1179,429,0.32914877,20,,2,1.2916666666666667,
63,2,car,crv,247,762,447,741,515,294,0.9441378,20,,2,1.2916666666666667,
64,2,car,crv,117,1313,388,818,1196,430,0.27251616,20,,2,0.3595317725752508,
65,2,car,crv,247,762,449,740,515,291,0.96550846,20,,2,0.3595317725752508,
66,2,car,crv,124,1305,387,820,1181,433,0.27402008,20,,2,0.36663844199830653,
67,2,car,crv,252,750,447,746,498,299,0.9501165,20,,2,0.36663844199830653,
68,2,car,crv,111,1317,390,812,1206,422,0.27479288,20,,2,0.34991708126036486,
69,2,car,crv,251,753,447,740,502,293,0.9438285,20,,2,0.34991708126036486,
70,2,car,crv,126,1309,390,814,1183,424,0.30222148,20,,2,1.2916666666666667,
71,2,car,crv,249,757,448,740,508,292,0.91383094,20,,2,1.2916666666666667,
72,2,car,crv,111,1317,390,811,1206,421,0.2941505,20,,2,0.3490878938640133,
73,2,car,crv,247,756,446,741,509,295,0.96245986,20,,2,0.3490878938640133,
74,2,car,crv,134,1300,387,818,1166,431,0.35928637,20,,2,1.28,
75,2,car,crv,251,757,447,743,506,296,0.9412378,20,,2,1.28,
76,2,car,crv,126,1312,388,815,1186,427,0.3965622,20,,2,1.24,
77,2,car,crv,252,758,446,743,506,297,0.9420341,20,,2,1.24,
78,2,car,crv,121,1316,389,809,1195,420,0.4096516,20,,2,1.24,
79,2,car,crv,244,761,447,742,517,295,0.9289579,20,,2,1.24,
80,2,car,crv,125,1312,392,805,1187,413,0.30284005,20,,2,1.24,
81,2,car,crv,245,760,447,739,515,292,0.9596912,20,,2,1.24,
82,2,car,crv,131,1307,388,812,1176,424,0.43397242,20,,2,1.2916666666666667,
83,2,car,crv,247,764,447,744,517,297,0.9014591,20,,2,1.2916666666666667,
84,2,car,crv,123,1315,388,811,1192,423,0.4968379,20,,2,1.24,
85,2,car,crv,246,758,446,743,512,297,0.87933147,20,,2,1.24,
86,2,car,crv,118,1312,389,813,1194,424,0.25691053,20,,2,0.35510887772194305,
87,2,car,crv,249,756,447,742,507,295,0.96910256,20,,2,0.35510887772194305,
88,2,car,crv,118,1319,389,813,1201,424,0.4023961,20,,2,1.28,
89,2,car,crv,243,757,448,743,514,295,0.94143236,20,,2,1.28,
90,2,car,crv,119,1322,385,815,1203,430,0.42900166,20,,2,1.24,
91,2,car,crv,246,762,447,741,516,294,0.790523,20,,2,1.24,
92,2,car,crv,119,1319,386,815,1200,429,0.44753623,20,,2,1.28,
93,2,car,crv,248,759,450,741,511,291,0.8263495,20,,2,1.28,
94,2,car,crv,114,1318,387,813,1204,426,0.43434885,20,,2,1.2916666666666667,
95,2,car,crv,246,759,446,744,513,298,0.9186257,20,,2,1.2916666666666667,
96,2,car,crv,119,1325,389,808,1206,419,0.46840343,20,,2,1.24,
97,2,car,crv,244,759,447,741,515,294,0.83414143,20,,2,1.24,
98,2,car,crv,116,1322,388,811,1206,423,0.44209528,20,,2,1.28,
99,2,car,crv,241,764,450,741,523,291,0.8834957,20,,2,1.28,
100,2,car,crv,334,710,446,701,376,255,0.92716336,3,0,2,0.6781914893617021,
101,2,car,crv,336,711,446,700,375,254,0.9036748,3,0,2,0.6773333333333333,
102,2,car,crv,335,709,444,701,374,257,0.9452533,3,0,2,0.6871657754010695,
0,2,car,crv,127,1308,391,816,1181,425,0.2964813,20,,2,1.2916666666666667,
1,2,car,crv,250,757,447,742,507,295,0.9490655,20,,2,1.2916666666666667,
2,2,car,crv,125,1314,388,816,1189,428,0.42268884,20,,2,1.28,
3,2,car,crv,248,760,449,737,512,288,0.90941703,20,,2,1.28,
4,2,car,crv,129,1304,390,814,1175,424,0.26254445,20,,2,1.2916666666666667,
5,2,car,crv,252,755,447,740,503,293,0.94612926,20,,2,1.2916666666666667,
6,2,car,crv,114,1320,387,815,1206,428,0.30274954,20,,2,1.24,
7,2,car,crv,248,753,446,740,505,294,0.8954264,20,,2,1.24,
8,2,car,crv,127,1307,391,814,1180,423,0.278648,20,,2,0.35847457627118645,
9,2,car,crv,250,755,447,744,505,297,0.95984495,20,,2,0.35847457627118645,
10,2,car,crv,127,1302,386,816,1175,430,0.37110242,20,,2,1.28,
11,2,car,crv,246,757,444,747,511,303,0.96607155,20,,2,1.28,
12,2,car,crv,119,1307,387,816,1188,429,0.28644451,20,,2,0.3611111111111111,
13,2,car,crv,248,759,443,747,511,304,0.9593547,20,,2,0.3611111111111111,
14,2,car,crv,127,1306,389,820,1179,431,0.37050778,20,,2,1.24,
15,2,car,crv,252,758,449,742,506,293,0.9203835,20,,2,1.24,
16,2,car,crv,126,1306,387,819,1180,432,0.24266188,20,,2,0.36610169491525424,
17,2,car,crv,247,754,449,740,507,291,0.94762105,20,,2,0.36610169491525424,
18,2,car,crv,113,1317,388,815,1204,427,0.36209753,20,,2,1.24,
19,2,car,crv,247,755,446,738,508,292,0.93217456,20,,2,1.24,
20,2,car,crv,116,1312,386,813,1196,427,0.26130736,20,,2,0.35702341137123744,
21,2,car,crv,249,755,445,740,506,295,0.95275867,20,,2,0.35702341137123744,
22,2,car,crv,250,753,445,746,503,301,0.97777426,20,,2,1.24,
23,2,car,crv,117,1316,390,813,1199,423,0.30318785,20,,2,0.35279399499582986,
24,2,car,crv,239,759,447,740,520,293,0.956478,20,,2,0.35279399499582986,
25,2,car,crv,126,1307,387,813,1181,426,0.3400013,20,,2,1.24,
26,2,car,crv,250,757,446,745,507,299,0.93553233,20,,2,1.24,
27,2,car,crv,118,1316,385,817,1198,432,0.46192503,20,,2,1.24,
28,2,car,crv,242,760,449,744,518,295,0.9251644,20,,2,1.24,
29,2,car,crv,125,1310,389,811,1185,422,0.32076746,20,,2,0.3561181434599156,
30,2,car,crv,250,758,446,739,508,293,0.9462212,20,,2,0.3561181434599156,
31,2,car,crv,250,754,444,740,504,296,0.96969557,20,,2,1.24,
32,2,car,crv,113,1313,388,814,1200,426,0.2754978,20,,2,1.24,
33,2,car,crv,244,756,445,743,512,298,0.96916515,20,,2,1.24,
34,2,car,crv,123,1309,388,814,1186,426,0.2760011,20,,2,1.24,
35,2,car,crv,249,758,446,740,509,294,0.950518,20,,2,1.24,
36,2,car,crv,253,754,447,737,501,290,0.94723046,20,,2,1.24,
37,2,car,crv,121,1308,387,817,1187,430,0.21458383,20,,2,0.36225779275484415,
38,2,car,crv,250,754,447,740,504,293,0.9610552,20,,2,0.36225779275484415,
39,2,car,crv,119,1317,388,814,1198,426,0.4732625,20,,2,1.24,
40,2,car,crv,245,758,448,742,513,294,0.94409996,20,,2,1.24,
41,2,car,crv,121,1308,388,815,1187,427,0.21448645,20,,2,0.35973041280539175,
42,2,car,crv,249,753,445,746,504,301,0.9724925,20,,2,0.35973041280539175,
43,2,car,crv,135,1302,387,821,1167,434,0.35179994,20,,2,1.2916666666666667,
44,2,car,crv,250,760,450,741,510,291,0.8736024,20,,2,1.2916666666666667,
45,2,car,crv,117,1313,390,812,1196,422,0.32242462,20,,2,1.2916666666666667,
46,2,car,crv,243,759,447,742,516,295,0.9675998,20,,2,1.2916666666666667,
47,2,car,crv,122,1311,387,814,1189,427,0.36553156,20,,2,1.2916666666666667,
48,2,car,crv,250,757,444,744,507,300,0.9479286,20,,2,1.2916666666666667,
49,2,car,crv,115,1321,388,815,1206,427,0.3674716,20,,2,1.24,
50,2,car,crv,248,756,446,740,508,294,0.92142504,20,,2,1.24,
51,2,car,crv,109,1315,384,827,1206,443,0.2820505,20,,2,1.24,
52,2,car,crv,249,758,449,736,509,287,0.91024953,20,,2,1.24,
53,2,car,crv,122,1310,388,817,1188,429,0.29904467,20,,2,0.3611111111111111,
54,2,car,crv,250,760,448,741,510,293,0.927252,20,,2,0.3611111111111111,
55,2,car,crv,129,1303,389,814,1174,425,0.27334884,20,,2,1.28,
56,2,car,crv,247,760,448,741,513,293,0.9333165,20,,2,1.28,
57,2,car,crv,122,1311,385,813,1189,428,0.35830083,20,,2,1.24,
58,2,car,crv,246,757,442,746,511,304,0.9668414,20,,2,1.24,
59,2,car,crv,122,1312,391,808,1190,417,0.34383425,20,,2,1.28,
60,2,car,crv,248,755,446,741,507,295,0.90284395,20,,2,1.28,
61,2,car,crv,129,1303,386,819,1174,433,0.2341652,20,,2,0.368824531516184,
62,2,car,crv,252,756,447,744,504,297,0.9354642,20,,2,0.368824531516184,
63,2,car,crv,253,756,446,744,503,298,0.97629297,20,,2,1.24,
64,2,car,crv,128,1307,388,817,1179,429,0.32914877,20,,2,1.2916666666666667,
65,2,car,crv,247,762,447,741,515,294,0.9441378,20,,2,1.2916666666666667,
66,2,car,crv,117,1313,388,818,1196,430,0.27251616,20,,2,0.3595317725752508,
67,2,car,crv,247,762,449,740,515,291,0.96550846,20,,2,0.3595317725752508,
68,2,car,crv,124,1305,387,820,1181,433,0.27402008,20,,2,0.36663844199830653,
69,2,car,crv,252,750,447,746,498,299,0.9501165,20,,2,0.36663844199830653,
70,2,car,crv,111,1317,390,812,1206,422,0.27479288,20,,2,0.34991708126036486,
71,2,car,crv,251,753,447,740,502,293,0.9438285,20,,2,0.34991708126036486,
72,2,car,crv,126,1309,390,814,1183,424,0.30222148,20,,2,1.2916666666666667,
73,2,car,crv,249,757,448,740,508,292,0.91383094,20,,2,1.2916666666666667,
74,2,car,crv,111,1317,390,811,1206,421,0.2941505,20,,2,0.3490878938640133,
75,2,car,crv,247,756,446,741,509,295,0.96245986,20,,2,0.3490878938640133,
76,2,car,crv,134,1300,387,818,1166,431,0.35928637,20,,2,1.28,
77,2,car,crv,251,757,447,743,506,296,0.9412378,20,,2,1.28,
78,2,car,crv,126,1312,388,815,1186,427,0.3965622,20,,2,1.24,
79,2,car,crv,252,758,446,743,506,297,0.9420341,20,,2,1.24,
80,2,car,crv,121,1316,389,809,1195,420,0.4096516,20,,2,1.24,
81,2,car,crv,244,761,447,742,517,295,0.9289579,20,,2,1.24,
82,2,car,crv,125,1312,392,805,1187,413,0.30284005,20,,2,1.24,
83,2,car,crv,245,760,447,739,515,292,0.9596912,20,,2,1.24,
84,2,car,crv,131,1307,388,812,1176,424,0.43397242,20,,2,1.2916666666666667,
85,2,car,crv,247,764,447,744,517,297,0.9014591,20,,2,1.2916666666666667,
86,2,car,crv,123,1315,388,811,1192,423,0.4968379,20,,2,1.24,
87,2,car,crv,246,758,446,743,512,297,0.87933147,20,,2,1.24,
88,2,car,crv,118,1312,389,813,1194,424,0.25691053,20,,2,0.35510887772194305,
89,2,car,crv,249,756,447,742,507,295,0.96910256,20,,2,0.35510887772194305,
90,2,car,crv,118,1319,389,813,1201,424,0.4023961,20,,2,1.28,
91,2,car,crv,243,757,448,743,514,295,0.94143236,20,,2,1.28,
92,2,car,crv,119,1322,385,815,1203,430,0.42900166,20,,2,1.24,
93,2,car,crv,246,762,447,741,516,294,0.790523,20,,2,1.24,
94,2,car,crv,119,1319,386,815,1200,429,0.44753623,20,,2,1.28,
95,2,car,crv,248,759,450,741,511,291,0.8263495,20,,2,1.28,
96,2,car,crv,114,1318,387,813,1204,426,0.43434885,20,,2,1.2916666666666667,
97,2,car,crv,246,759,446,744,513,298,0.9186257,20,,2,1.2916666666666667,
98,2,car,crv,119,1325,389,808,1206,419,0.46840343,20,,2,1.24,
99,2,car,crv,244,759,447,741,515,294,0.83414143,20,,2,1.24,
100,2,car,crv,116,1322,388,811,1206,423,0.44209528,20,,2,1.28,
101,2,car,crv,241,764,450,741,523,291,0.8834957,20,,2,1.28,
102,2,car,crv,334,710,446,701,376,255,0.92716336,3,0,2,0.6781914893617021,
103,2,car,crv,336,711,446,700,375,254,0.9036748,3,0,2,0.6773333333333333,
104,2,car,crv,335,709,444,701,374,257,0.9452533,3,0,2,0.6871657754010695,
0,2,car,crv,109,1318,388,813,1209,425,0.32027155,20,,2,1.28,
1,2,car,crv,245,760,445,741,515,296,0.9680706,20,,2,1.28,
2,2,car,crv,127,1308,391,816,1181,425,0.2964813,20,,2,1.2916666666666667,
3,2,car,crv,250,757,447,742,507,295,0.9490655,20,,2,1.2916666666666667,
4,2,car,crv,125,1314,388,816,1189,428,0.42268884,20,,2,1.28,
5,2,car,crv,248,760,449,737,512,288,0.90941703,20,,2,1.28,
6,2,car,crv,129,1304,390,814,1175,424,0.26254445,20,,2,1.2916666666666667,
7,2,car,crv,252,755,447,740,503,293,0.94612926,20,,2,1.2916666666666667,
8,2,car,crv,114,1320,387,815,1206,428,0.30274954,20,,2,1.24,
9,2,car,crv,248,753,446,740,505,294,0.8954264,20,,2,1.24,
10,2,car,crv,127,1307,391,814,1180,423,0.278648,20,,2,0.35847457627118645,
11,2,car,crv,250,755,447,744,505,297,0.95984495,20,,2,0.35847457627118645,
12,2,car,crv,127,1302,386,816,1175,430,0.37110242,20,,2,1.28,
13,2,car,crv,246,757,444,747,511,303,0.96607155,20,,2,1.28,
14,2,car,crv,119,1307,387,816,1188,429,0.28644451,20,,2,0.3611111111111111,
15,2,car,crv,248,759,443,747,511,304,0.9593547,20,,2,0.3611111111111111,
16,2,car,crv,127,1306,389,820,1179,431,0.37050778,20,,2,1.24,
17,2,car,crv,252,758,449,742,506,293,0.9203835,20,,2,1.24,
18,2,car,crv,126,1306,387,819,1180,432,0.24266188,20,,2,0.36610169491525424,
19,2,car,crv,247,754,449,740,507,291,0.94762105,20,,2,0.36610169491525424,
20,2,car,crv,113,1317,388,815,1204,427,0.36209753,20,,2,1.24,
21,2,car,crv,247,755,446,738,508,292,0.93217456,20,,2,1.24,
22,2,car,crv,116,1312,386,813,1196,427,0.26130736,20,,2,0.35702341137123744,
23,2,car,crv,249,755,445,740,506,295,0.95275867,20,,2,0.35702341137123744,
24,2,car,crv,250,753,445,746,503,301,0.97777426,20,,2,1.24,
25,2,car,crv,117,1316,390,813,1199,423,0.30318785,20,,2,0.35279399499582986,
26,2,car,crv,239,759,447,740,520,293,0.956478,20,,2,0.35279399499582986,
27,2,car,crv,126,1307,387,813,1181,426,0.3400013,20,,2,1.24,
28,2,car,crv,250,757,446,745,507,299,0.93553233,20,,2,1.24,
29,2,car,crv,118,1316,385,817,1198,432,0.46192503,20,,2,1.24,
30,2,car,crv,242,760,449,744,518,295,0.9251644,20,,2,1.24,
31,2,car,crv,125,1310,389,811,1185,422,0.32076746,20,,2,0.3561181434599156,
32,2,car,crv,250,758,446,739,508,293,0.9462212,20,,2,0.3561181434599156,
33,2,car,crv,250,754,444,740,504,296,0.96969557,20,,2,1.24,
34,2,car,crv,113,1313,388,814,1200,426,0.2754978,20,,2,1.24,
35,2,car,crv,244,756,445,743,512,298,0.96916515,20,,2,1.24,
36,2,car,crv,123,1309,388,814,1186,426,0.2760011,20,,2,1.24,
37,2,car,crv,249,758,446,740,509,294,0.950518,20,,2,1.24,
38,2,car,crv,253,754,447,737,501,290,0.94723046,20,,2,1.24,
39,2,car,crv,121,1308,387,817,1187,430,0.21458383,20,,2,0.36225779275484415,
40,2,car,crv,250,754,447,740,504,293,0.9610552,20,,2,0.36225779275484415,
41,2,car,crv,119,1317,388,814,1198,426,0.4732625,20,,2,1.24,
42,2,car,crv,245,758,448,742,513,294,0.94409996,20,,2,1.24,
43,2,car,crv,121,1308,388,815,1187,427,0.21448645,20,,2,0.35973041280539175,
44,2,car,crv,249,753,445,746,504,301,0.9724925,20,,2,0.35973041280539175,
45,2,car,crv,135,1302,387,821,1167,434,0.35179994,20,,2,1.2916666666666667,
46,2,car,crv,250,760,450,741,510,291,0.8736024,20,,2,1.2916666666666667,
47,2,car,crv,117,1313,390,812,1196,422,0.32242462,20,,2,1.2916666666666667,
48,2,car,crv,243,759,447,742,516,295,0.9675998,20,,2,1.2916666666666667,
49,2,car,crv,122,1311,387,814,1189,427,0.36553156,20,,2,1.2916666666666667,
50,2,car,crv,250,757,444,744,507,300,0.9479286,20,,2,1.2916666666666667,
51,2,car,crv,115,1321,388,815,1206,427,0.3674716,20,,2,1.24,
52,2,car,crv,248,756,446,740,508,294,0.92142504,20,,2,1.24,
53,2,car,crv,109,1315,384,827,1206,443,0.2820505,20,,2,1.24,
54,2,car,crv,249,758,449,736,509,287,0.91024953,20,,2,1.24,
55,2,car,crv,122,1310,388,817,1188,429,0.29904467,20,,2,0.3611111111111111,
56,2,car,crv,250,760,448,741,510,293,0.927252,20,,2,0.3611111111111111,
57,2,car,crv,129,1303,389,814,1174,425,0.27334884,20,,2,1.28,
58,2,car,crv,247,760,448,741,513,293,0.9333165,20,,2,1.28,
59,2,car,crv,122,1311,385,813,1189,428,0.35830083,20,,2,1.24,
60,2,car,crv,246,757,442,746,511,304,0.9668414,20,,2,1.24,
61,2,car,crv,122,1312,391,808,1190,417,0.34383425,20,,2,1.28,
62,2,car,crv,248,755,446,741,507,295,0.90284395,20,,2,1.28,
63,2,car,crv,129,1303,386,819,1174,433,0.2341652,20,,2,0.368824531516184,
64,2,car,crv,252,756,447,744,504,297,0.9354642,20,,2,0.368824531516184,
65,2,car,crv,253,756,446,744,503,298,0.97629297,20,,2,1.24,
66,2,car,crv,128,1307,388,817,1179,429,0.32914877,20,,2,1.2916666666666667,
67,2,car,crv,247,762,447,741,515,294,0.9441378,20,,2,1.2916666666666667,
68,2,car,crv,117,1313,388,818,1196,430,0.27251616,20,,2,0.3595317725752508,
69,2,car,crv,247,762,449,740,515,291,0.96550846,20,,2,0.3595317725752508,
70,2,car,crv,124,1305,387,820,1181,433,0.27402008,20,,2,0.36663844199830653,
71,2,car,crv,252,750,447,746,498,299,0.9501165,20,,2,0.36663844199830653,
72,2,car,crv,111,1317,390,812,1206,422,0.27479288,20,,2,0.34991708126036486,
73,2,car,crv,251,753,447,740,502,293,0.9438285,20,,2,0.34991708126036486,
74,2,car,crv,126,1309,390,814,1183,424,0.30222148,20,,2,1.2916666666666667,
75,2,car,crv,249,757,448,740,508,292,0.91383094,20,,2,1.2916666666666667,
76,2,car,crv,111,1317,390,811,1206,421,0.2941505,20,,2,0.3490878938640133,
77,2,car,crv,247,756,446,741,509,295,0.96245986,20,,2,0.3490878938640133,
78,2,car,crv,134,1300,387,818,1166,431,0.35928637,20,,2,1.28,
79,2,car,crv,251,757,447,743,506,296,0.9412378,20,,2,1.28,
80,2,car,crv,126,1312,388,815,1186,427,0.3965622,20,,2,1.24,
81,2,car,crv,252,758,446,743,506,297,0.9420341,20,,2,1.24,
82,2,car,crv,121,1316,389,809,1195,420,0.4096516,20,,2,1.24,
83,2,car,crv,244,761,447,742,517,295,0.9289579,20,,2,1.24,
84,2,car,crv,125,1312,392,805,1187,413,0.30284005,20,,2,1.24,
85,2,car,crv,245,760,447,739,515,292,0.9596912,20,,2,1.24,
86,2,car,crv,131,1307,388,812,1176,424,0.43397242,20,,2,1.2916666666666667,
87,2,car,crv,247,764,447,744,517,297,0.9014591,20,,2,1.2916666666666667,
88,2,car,crv,123,1315,388,811,1192,423,0.4968379,20,,2,1.24,
89,2,car,crv,246,758,446,743,512,297,0.87933147,20,,2,1.24,
90,2,car,crv,118,1312,389,813,1194,424,0.25691053,20,,2,0.35510887772194305,
91,2,car,crv,249,756,447,742,507,295,0.96910256,20,,2,0.35510887772194305,
92,2,car,crv,118,1319,389,813,1201,424,0.4023961,20,,2,1.28,
93,2,car,crv,243,757,448,743,514,295,0.94143236,20,,2,1.28,
94,2,car,crv,119,1322,385,815,1203,430,0.42900166,20,,2,1.24,
95,2,car,crv,246,762,447,741,516,294,0.790523,20,,2,1.24,
96,2,car,crv,119,1319,386,815,1200,429,0.44753623,20,,2,1.28,
97,2,car,crv,248,759,450,741,511,291,0.8263495,20,,2,1.28,
98,2,car,crv,114,1318,387,813,1204,426,0.43434885,20,,2,1.2916666666666667,
99,2,car,crv,246,759,446,744,513,298,0.9186257,20,,2,1.2916666666666667,
100,2,car,crv,119,1325,389,808,1206,419,0.46840343,20,,2,1.24,
101,2,car,crv,244,759,447,741,515,294,0.83414143,20,,2,1.24,
102,2,car,crv,116,1322,388,811,1206,423,0.44209528,20,,2,1.28,
103,2,car,crv,241,764,450,741,523,291,0.8834957,20,,2,1.28,
104,2,car,crv,334,710,446,701,376,255,0.92716336,3,0,2,0.6781914893617021,
105,2,car,crv,336,711,446,700,375,254,0.9036748,3,0,2,0.6773333333333333,
106,2,car,crv,335,709,444,701,374,257,0.9452533,3,0,2,0.6871657754010695,
0,2,car,crv,250,754,447,738,504,291,0.9767751,20,,2,1.24,
1,2,car,crv,109,1318,388,813,1209,425,0.32027155,20,,2,1.28,
2,2,car,crv,245,760,445,741,515,296,0.9680706,20,,2,1.28,
3,2,car,crv,127,1308,391,816,1181,425,0.2964813,20,,2,1.2916666666666667,
4,2,car,crv,250,757,447,742,507,295,0.9490655,20,,2,1.2916666666666667,
5,2,car,crv,125,1314,388,816,1189,428,0.42268884,20,,2,1.28,
6,2,car,crv,248,760,449,737,512,288,0.90941703,20,,2,1.28,
7,2,car,crv,129,1304,390,814,1175,424,0.26254445,20,,2,1.2916666666666667,
8,2,car,crv,252,755,447,740,503,293,0.94612926,20,,2,1.2916666666666667,
9,2,car,crv,114,1320,387,815,1206,428,0.30274954,20,,2,1.24,
10,2,car,crv,248,753,446,740,505,294,0.8954264,20,,2,1.24,
11,2,car,crv,127,1307,391,814,1180,423,0.278648,20,,2,0.35847457627118645,
12,2,car,crv,250,755,447,744,505,297,0.95984495,20,,2,0.35847457627118645,
13,2,car,crv,127,1302,386,816,1175,430,0.37110242,20,,2,1.28,
14,2,car,crv,246,757,444,747,511,303,0.96607155,20,,2,1.28,
15,2,car,crv,119,1307,387,816,1188,429,0.28644451,20,,2,0.3611111111111111,
16,2,car,crv,248,759,443,747,511,304,0.9593547,20,,2,0.3611111111111111,
17,2,car,crv,127,1306,389,820,1179,431,0.37050778,20,,2,1.24,
18,2,car,crv,252,758,449,742,506,293,0.9203835,20,,2,1.24,
19,2,car,crv,126,1306,387,819,1180,432,0.24266188,20,,2,0.36610169491525424,
20,2,car,crv,247,754,449,740,507,291,0.94762105,20,,2,0.36610169491525424,
21,2,car,crv,113,1317,388,815,1204,427,0.36209753,20,,2,1.24,
22,2,car,crv,247,755,446,738,508,292,0.93217456,20,,2,1.24,
23,2,car,crv,116,1312,386,813,1196,427,0.26130736,20,,2,0.35702341137123744,
24,2,car,crv,249,755,445,740,506,295,0.95275867,20,,2,0.35702341137123744,
25,2,car,crv,250,753,445,746,503,301,0.97777426,20,,2,1.24,
26,2,car,crv,117,1316,390,813,1199,423,0.30318785,20,,2,0.35279399499582986,
27,2,car,crv,239,759,447,740,520,293,0.956478,20,,2,0.35279399499582986,
28,2,car,crv,126,1307,387,813,1181,426,0.3400013,20,,2,1.24,
29,2,car,crv,250,757,446,745,507,299,0.93553233,20,,2,1.24,
30,2,car,crv,118,1316,385,817,1198,432,0.46192503,20,,2,1.24,
31,2,car,crv,242,760,449,744,518,295,0.9251644,20,,2,1.24,
32,2,car,crv,125,1310,389,811,1185,422,0.32076746,20,,2,0.3561181434599156,
33,2,car,crv,250,758,446,739,508,293,0.9462212,20,,2,0.3561181434599156,
34,2,car,crv,250,754,444,740,504,296,0.96969557,20,,2,1.24,
35,2,car,crv,113,1313,388,814,1200,426,0.2754978,20,,2,1.24,
36,2,car,crv,244,756,445,743,512,298,0.96916515,20,,2,1.24,
37,2,car,crv,123,1309,388,814,1186,426,0.2760011,20,,2,1.24,
38,2,car,crv,249,758,446,740,509,294,0.950518,20,,2,1.24,
39,2,car,crv,253,754,447,737,501,290,0.94723046,20,,2,1.24,
40,2,car,crv,121,1308,387,817,1187,430,0.21458383,20,,2,0.36225779275484415,
41,2,car,crv,250,754,447,740,504,293,0.9610552,20,,2,0.36225779275484415,
42,2,car,crv,119,1317,388,814,1198,426,0.4732625,20,,2,1.24,
43,2,car,crv,245,758,448,742,513,294,0.94409996,20,,2,1.24,
44,2,car,crv,121,1308,388,815,1187,427,0.21448645,20,,2,0.35973041280539175,
45,2,car,crv,249,753,445,746,504,301,0.9724925,20,,2,0.35973041280539175,
46,2,car,crv,135,1302,387,821,1167,434,0.35179994,20,,2,1.2916666666666667,
47,2,car,crv,250,760,450,741,510,291,0.8736024,20,,2,1.2916666666666667,
48,2,car,crv,117,1313,390,812,1196,422,0.32242462,20,,2,1.2916666666666667,
49,2,car,crv,243,759,447,742,516,295,0.9675998,20,,2,1.2916666666666667,
50,2,car,crv,122,1311,387,814,1189,427,0.36553156,20,,2,1.2916666666666667,
51,2,car,crv,250,757,444,744,507,300,0.9479286,20,,2,1.2916666666666667,
52,2,car,crv,115,1321,388,815,1206,427,0.3674716,20,,2,1.24,
53,2,car,crv,248,756,446,740,508,294,0.92142504,20,,2,1.24,
54,2,car,crv,109,1315,384,827,1206,443,0.2820505,20,,2,1.24,
55,2,car,crv,249,758,449,736,509,287,0.91024953,20,,2,1.24,
56,2,car,crv,122,1310,388,817,1188,429,0.29904467,20,,2,0.3611111111111111,
57,2,car,crv,250,760,448,741,510,293,0.927252,20,,2,0.3611111111111111,
58,2,car,crv,129,1303,389,814,1174,425,0.27334884,20,,2,1.28,
59,2,car,crv,247,760,448,741,513,293,0.9333165,20,,2,1.28,
60,2,car,crv,122,1311,385,813,1189,428,0.35830083,20,,2,1.24,
61,2,car,crv,246,757,442,746,511,304,0.9668414,20,,2,1.24,
62,2,car,crv,122,1312,391,808,1190,417,0.34383425,20,,2,1.28,
63,2,car,crv,248,755,446,741,507,295,0.90284395,20,,2,1.28,
64,2,car,crv,129,1303,386,819,1174,433,0.2341652,20,,2,0.368824531516184,
65,2,car,crv,252,756,447,744,504,297,0.9354642,20,,2,0.368824531516184,
66,2,car,crv,253,756,446,744,503,298,0.97629297,20,,2,1.24,
67,2,car,crv,128,1307,388,817,1179,429,0.32914877,20,,2,1.2916666666666667,
68,2,car,crv,247,762,447,741,515,294,0.9441378,20,,2,1.2916666666666667,
69,2,car,crv,117,1313,388,818,1196,430,0.27251616,20,,2,0.3595317725752508,
70,2,car,crv,247,762,449,740,515,291,0.96550846,20,,2,0.3595317725752508,
71,2,car,crv,124,1305,387,820,1181,433,0.27402008,20,,2,0.36663844199830653,
72,2,car,crv,252,750,447,746,498,299,0.9501165,20,,2,0.36663844199830653,
73,2,car,crv,111,1317,390,812,1206,422,0.27479288,20,,2,0.34991708126036486,
74,2,car,crv,251,753,447,740,502,293,0.9438285,20,,2,0.34991708126036486,
75,2,car,crv,126,1309,390,814,1183,424,0.30222148,20,,2,1.2916666666666667,
76,2,car,crv,249,757,448,740,508,292,0.91383094,20,,2,1.2916666666666667,
77,2,car,crv,111,1317,390,811,1206,421,0.2941505,20,,2,0.3490878938640133,
78,2,car,crv,247,756,446,741,509,295,0.96245986,20,,2,0.3490878938640133,
79,2,car,crv,134,1300,387,818,1166,431,0.35928637,20,,2,1.28,
80,2,car,crv,251,757,447,743,506,296,0.9412378,20,,2,1.28,
81,2,car,crv,126,1312,388,815,1186,427,0.3965622,20,,2,1.24,
82,2,car,crv,252,758,446,743,506,297,0.9420341,20,,2,1.24,
83,2,car,crv,121,1316,389,809,1195,420,0.4096516,20,,2,1.24,
84,2,car,crv,244,761,447,742,517,295,0.9289579,20,,2,1.24,
85,2,car,crv,125,1312,392,805,1187,413,0.30284005,20,,2,1.24,
86,2,car,crv,245,760,447,739,515,292,0.9596912,20,,2,1.24,
87,2,car,crv,131,1307,388,812,1176,424,0.43397242,20,,2,1.2916666666666667,
88,2,car,crv,247,764,447,744,517,297,0.9014591,20,,2,1.2916666666666667,
89,2,car,crv,123,1315,388,811,1192,423,0.4968379,20,,2,1.24,
90,2,car,crv,246,758,446,743,512,297,0.87933147,20,,2,1.24,
91,2,car,crv,118,1312,389,813,1194,424,0.25691053,20,,2,0.35510887772194305,
92,2,car,crv,249,756,447,742,507,295,0.96910256,20,,2,0.35510887772194305,
93,2,car,crv,118,1319,389,813,1201,424,0.4023961,20,,2,1.28,
94,2,car,crv,243,757,448,743,514,295,0.94143236,20,,2,1.28,
95,2,car,crv,119,1322,385,815,1203,430,0.42900166,20,,2,1.24,
96,2,car,crv,246,762,447,741,516,294,0.790523,20,,2,1.24,
97,2,car,crv,119,1319,386,815,1200,429,0.44753623,20,,2,1.28,
98,2,car,crv,248,759,450,741,511,291,0.8263495,20,,2,1.28,
99,2,car,crv,114,1318,387,813,1204,426,0.43434885,20,,2,1.2916666666666667,
100,2,car,crv,246,759,446,744,513,298,0.9186257,20,,2,1.2916666666666667,
101,2,car,crv,119,1325,389,808,1206,419,0.46840343,20,,2,1.24,
102,2,car,crv,244,759,447,741,515,294,0.83414143,20,,2,1.24,
103,2,car,crv,116,1322,388,811,1206,423,0.44209528,20,,2,1.28,
104,2,car,crv,241,764,450,741,523,291,0.8834957,20,,2,1.28,
105,2,car,crv,334,710,446,701,376,255,0.92716336,3,0,2,0.6781914893617021,
106,2,car,crv,336,711,446,700,375,254,0.9036748,3,0,2,0.6773333333333333,
107,2,car,crv,335,709,444,701,374,257,0.9452533,3,0,2,0.6871657754010695,
0,2,car,crv,128,1304,388,815,1176,427,0.30647025,20,,2,1.28,
1,2,car,crv,251,758,443,746,507,303,0.93285924,20,,2,1.28,
2,2,car,crv,250,754,447,738,504,291,0.9767751,20,,2,1.24,
3,2,car,crv,109,1318,388,813,1209,425,0.32027155,20,,2,1.28,
4,2,car,crv,245,760,445,741,515,296,0.9680706,20,,2,1.28,
5,2,car,crv,127,1308,391,816,1181,425,0.2964813,20,,2,1.2916666666666667,
6,2,car,crv,250,757,447,742,507,295,0.9490655,20,,2,1.2916666666666667,
7,2,car,crv,125,1314,388,816,1189,428,0.42268884,20,,2,1.28,
8,2,car,crv,248,760,449,737,512,288,0.90941703,20,,2,1.28,
9,2,car,crv,129,1304,390,814,1175,424,0.26254445,20,,2,1.2916666666666667,
10,2,car,crv,252,755,447,740,503,293,0.94612926,20,,2,1.2916666666666667,
11,2,car,crv,114,1320,387,815,1206,428,0.30274954,20,,2,1.24,
12,2,car,crv,248,753,446,740,505,294,0.8954264,20,,2,1.24,
13,2,car,crv,127,1307,391,814,1180,423,0.278648,20,,2,0.35847457627118645,
14,2,car,crv,250,755,447,744,505,297,0.95984495,20,,2,0.35847457627118645,
15,2,car,crv,127,1302,386,816,1175,430,0.37110242,20,,2,1.28,
16,2,car,crv,246,757,444,747,511,303,0.96607155,20,,2,1.28,
17,2,car,crv,119,1307,387,816,1188,429,0.28644451,20,,2,0.3611111111111111,
18,2,car,crv,248,759,443,747,511,304,0.9593547,20,,2,0.3611111111111111,
19,2,car,crv,127,1306,389,820,1179,431,0.37050778,20,,2,1.24,
20,2,car,crv,252,758,449,742,506,293,0.9203835,20,,2,1.24,
21,2,car,crv,126,1306,387,819,1180,432,0.24266188,20,,2,0.36610169491525424,
22,2,car,crv,247,754,449,740,507,291,0.94762105,20,,2,0.36610169491525424,
23,2,car,crv,113,1317,388,815,1204,427,0.36209753,20,,2,1.24,
24,2,car,crv,247,755,446,738,508,292,0.93217456,20,,2,1.24,
25,2,car,crv,116,1312,386,813,1196,427,0.26130736,20,,2,0.35702341137123744,
26,2,car,crv,249,755,445,740,506,295,0.95275867,20,,2,0.35702341137123744,
27,2,car,crv,250,753,445,746,503,301,0.97777426,20,,2,1.24,
28,2,car,crv,117,1316,390,813,1199,423,0.30318785,20,,2,0.35279399499582986,
29,2,car,crv,239,759,447,740,520,293,0.956478,20,,2,0.35279399499582986,
30,2,car,crv,126,1307,387,813,1181,426,0.3400013,20,,2,1.24,
31,2,car,crv,250,757,446,745,507,299,0.93553233,20,,2,1.24,
32,2,car,crv,118,1316,385,817,1198,432,0.46192503,20,,2,1.24,
33,2,car,crv,242,760,449,744,518,295,0.9251644,20,,2,1.24,
34,2,car,crv,125,1310,389,811,1185,422,0.32076746,20,,2,0.3561181434599156,
35,2,car,crv,250,758,446,739,508,293,0.9462212,20,,2,0.3561181434599156,
36,2,car,crv,250,754,444,740,504,296,0.96969557,20,,2,1.24,
37,2,car,crv,113,1313,388,814,1200,426,0.2754978,20,,2,1.24,
38,2,car,crv,244,756,445,743,512,298,0.96916515,20,,2,1.24,
39,2,car,crv,123,1309,388,814,1186,426,0.2760011,20,,2,1.24,
40,2,car,crv,249,758,446,740,509,294,0.950518,20,,2,1.24,
41,2,car,crv,253,754,447,737,501,290,0.94723046,20,,2,1.24,
42,2,car,crv,121,1308,387,817,1187,430,0.21458383,20,,2,0.36225779275484415,
43,2,car,crv,250,754,447,740,504,293,0.9610552,20,,2,0.36225779275484415,
44,2,car,crv,119,1317,388,814,1198,426,0.4732625,20,,2,1.24,
45,2,car,crv,245,758,448,742,513,294,0.94409996,20,,2,1.24,
46,2,car,crv,121,1308,388,815,1187,427,0.21448645,20,,2,0.35973041280539175,
47,2,car,crv,249,753,445,746,504,301,0.9724925,20,,2,0.35973041280539175,
48,2,car,crv,135,1302,387,821,1167,434,0.35179994,20,,2,1.2916666666666667,
49,2,car,crv,250,760,450,741,510,291,0.8736024,20,,2,1.2916666666666667,
50,2,car,crv,117,1313,390,812,1196,422,0.32242462,20,,2,1.2916666666666667,
51,2,car,crv,243,759,447,742,516,295,0.9675998,20,,2,1.2916666666666667,
52,2,car,crv,122,1311,387,814,1189,427,0.36553156,20,,2,1.2916666666666667,
53,2,car,crv,250,757,444,744,507,300,0.9479286,20,,2,1.2916666666666667,
54,2,car,crv,115,1321,388,815,1206,427,0.3674716,20,,2,1.24,
55,2,car,crv,248,756,446,740,508,294,0.92142504,20,,2,1.24,
56,2,car,crv,109,1315,384,827,1206,443,0.2820505,20,,2,1.24,
57,2,car,crv,249,758,449,736,509,287,0.91024953,20,,2,1.24,
58,2,car,crv,122,1310,388,817,1188,429,0.29904467,20,,2,0.3611111111111111,
59,2,car,crv,250,760,448,741,510,293,0.927252,20,,2,0.3611111111111111,
60,2,car,crv,129,1303,389,814,1174,425,0.27334884,20,,2,1.28,
61,2,car,crv,247,760,448,741,513,293,0.9333165,20,,2,1.28,
62,2,car,crv,122,1311,385,813,1189,428,0.35830083,20,,2,1.24,
63,2,car,crv,246,757,442,746,511,304,0.9668414,20,,2,1.24,
64,2,car,crv,122,1312,391,808,1190,417,0.34383425,20,,2,1.28,
65,2,car,crv,248,755,446,741,507,295,0.90284395,20,,2,1.28,
66,2,car,crv,129,1303,386,819,1174,433,0.2341652,20,,2,0.368824531516184,
67,2,car,crv,252,756,447,744,504,297,0.9354642,20,,2,0.368824531516184,
68,2,car,crv,253,756,446,744,503,298,0.97629297,20,,2,1.24,
69,2,car,crv,128,1307,388,817,1179,429,0.32914877,20,,2,1.2916666666666667,
70,2,car,crv,247,762,447,741,515,294,0.9441378,20,,2,1.2916666666666667,
71,2,car,crv,117,1313,388,818,1196,430,0.27251616,20,,2,0.3595317725752508,
72,2,car,crv,247,762,449,740,515,291,0.96550846,20,,2,0.3595317725752508,
73,2,car,crv,124,1305,387,820,1181,433,0.27402008,20,,2,0.36663844199830653,
74,2,car,crv,252,750,447,746,498,299,0.9501165,20,,2,0.36663844199830653,
75,2,car,crv,111,1317,390,812,1206,422,0.27479288,20,,2,0.34991708126036486,
76,2,car,crv,251,753,447,740,502,293,0.9438285,20,,2,0.34991708126036486,
77,2,car,crv,126,1309,390,814,1183,424,0.30222148,20,,2,1.2916666666666667,
78,2,car,crv,249,757,448,740,508,292,0.91383094,20,,2,1.2916666666666667,
79,2,car,crv,111,1317,390,811,1206,421,0.2941505,20,,2,0.3490878938640133,
80,2,car,crv,247,756,446,741,509,295,0.96245986,20,,2,0.3490878938640133,
81,2,car,crv,134,1300,387,818,1166,431,0.35928637,20,,2,1.28,
82,2,car,crv,251,757,447,743,506,296,0.9412378,20,,2,1.28,
83,2,car,crv,126,1312,388,815,1186,427,0.3965622,20,,2,1.24,
84,2,car,crv,252,758,446,743,506,297,0.9420341,20,,2,1.24,
85,2,car,crv,121,1316,389,809,1195,420,0.4096516,20,,2,1.24,
86,2,car,crv,244,761,447,742,517,295,0.9289579,20,,2,1.24,
87,2,car,crv,125,1312,392,805,1187,413,0.30284005,20,,2,1.24,
88,2,car,crv,245,760,447,739,515,292,0.9596912,20,,2,1.24,
89,2,car,crv,131,1307,388,812,1176,424,0.43397242,20,,2,1.2916666666666667,
90,2,car,crv,247,764,447,744,517,297,0.9014591,20,,2,1.2916666666666667,
91,2,car,crv,123,1315,388,811,1192,423,0.4968379,20,,2,1.24,
92,2,car,crv,246,758,446,743,512,297,0.87933147,20,,2,1.24,
93,2,car,crv,118,1312,389,813,1194,424,0.25691053,20,,2,0.35510887772194305,
94,2,car,crv,249,756,447,742,507,295,0.96910256,20,,2,0.35510887772194305,
95,2,car,crv,118,1319,389,813,1201,424,0.4023961,20,,2,1.28,
96,2,car,crv,243,757,448,743,514,295,0.94143236,20,,2,1.28,
97,2,car,crv,119,1322,385,815,1203,430,0.42900166,20,,2,1.24,
98,2,car,crv,246,762,447,741,516,294,0.790523,20,,2,1.24,
99,2,car,crv,119,1319,386,815,1200,429,0.44753623,20,,2,1.28,
100,2,car,crv,248,759,450,741,511,291,0.8263495,20,,2,1.28,
101,2,car,crv,114,1318,387,813,1204,426,0.43434885,20,,2,1.2916666666666667,
102,2,car,crv,246,759,446,744,513,298,0.9186257,20,,2,1.2916666666666667,
103,2,car,crv,119,1325,389,808,1206,419,0.46840343,20,,2,1.24,
104,2,car,crv,244,759,447,741,515,294,0.83414143,20,,2,1.24,
105,2,car,crv,116,1322,388,811,1206,423,0.44209528,20,,2,1.28,
106,2,car,crv,241,764,450,741,523,291,0.8834957,20,,2,1.28,
107,2,car,crv,334,710,446,701,376,255,0.92716336,3,0,2,0.6781914893617021,
108,2,car,crv,336,711,446,700,375,254,0.9036748,3,0,2,0.6773333333333333,
109,2,car,crv,335,709,444,701,374,257,0.9452533,3,0,2,0.6871657754010695,
0,2,car,crv,119,1311,391,813,1192,422,0.25885653,20,,2,1.25,
1,2,car,crv,246,752,446,739,506,293,0.95473194,20,,2,1.25,
2,2,car,crv,128,1304,388,815,1176,427,0.30647025,20,,2,1.28,
3,2,car,crv,251,758,443,746,507,303,0.93285924,20,,2,1.28,
4,2,car,crv,250,754,447,738,504,291,0.9767751,20,,2,1.24,
5,2,car,crv,109,1318,388,813,1209,425,0.32027155,20,,2,1.28,
6,2,car,crv,245,760,445,741,515,296,0.9680706,20,,2,1.28,
7,2,car,crv,127,1308,391,816,1181,425,0.2964813,20,,2,1.2916666666666667,
8,2,car,crv,250,757,447,742,507,295,0.9490655,20,,2,1.2916666666666667,
9,2,car,crv,125,1314,388,816,1189,428,0.42268884,20,,2,1.28,
10,2,car,crv,248,760,449,737,512,288,0.90941703,20,,2,1.28,
11,2,car,crv,129,1304,390,814,1175,424,0.26254445,20,,2,1.2916666666666667,
12,2,car,crv,252,755,447,740,503,293,0.94612926,20,,2,1.2916666666666667,
13,2,car,crv,114,1320,387,815,1206,428,0.30274954,20,,2,1.24,
14,2,car,crv,248,753,446,740,505,294,0.8954264,20,,2,1.24,
15,2,car,crv,127,1307,391,814,1180,423,0.278648,20,,2,0.35847457627118645,
16,2,car,crv,250,755,447,744,505,297,0.95984495,20,,2,0.35847457627118645,
17,2,car,crv,127,1302,386,816,1175,430,0.37110242,20,,2,1.28,
18,2,car,crv,246,757,444,747,511,303,0.96607155,20,,2,1.28,
19,2,car,crv,119,1307,387,816,1188,429,0.28644451,20,,2,0.3611111111111111,
20,2,car,crv,248,759,443,747,511,304,0.9593547,20,,2,0.3611111111111111,
21,2,car,crv,127,1306,389,820,1179,431,0.37050778,20,,2,1.24,
22,2,car,crv,252,758,449,742,506,293,0.9203835,20,,2,1.24,
23,2,car,crv,126,1306,387,819,1180,432,0.24266188,20,,2,0.36610169491525424,
24,2,car,crv,247,754,449,740,507,291,0.94762105,20,,2,0.36610169491525424,
25,2,car,crv,113,1317,388,815,1204,427,0.36209753,20,,2,1.24,
26,2,car,crv,247,755,446,738,508,292,0.93217456,20,,2,1.24,
27,2,car,crv,116,1312,386,813,1196,427,0.26130736,20,,2,0.35702341137123744,
28,2,car,crv,249,755,445,740,506,295,0.95275867,20,,2,0.35702341137123744,
29,2,car,crv,250,753,445,746,503,301,0.97777426,20,,2,1.24,
30,2,car,crv,117,1316,390,813,1199,423,0.30318785,20,,2,0.35279399499582986,
31,2,car,crv,239,759,447,740,520,293,0.956478,20,,2,0.35279399499582986,
32,2,car,crv,126,1307,387,813,1181,426,0.3400013,20,,2,1.24,
33,2,car,crv,250,757,446,745,507,299,0.93553233,20,,2,1.24,
34,2,car,crv,118,1316,385,817,1198,432,0.46192503,20,,2,1.24,
35,2,car,crv,242,760,449,744,518,295,0.9251644,20,,2,1.24,
36,2,car,crv,125,1310,389,811,1185,422,0.32076746,20,,2,0.3561181434599156,
37,2,car,crv,250,758,446,739,508,293,0.9462212,20,,2,0.3561181434599156,
38,2,car,crv,250,754,444,740,504,296,0.96969557,20,,2,1.24,
39,2,car,crv,113,1313,388,814,1200,426,0.2754978,20,,2,1.24,
40,2,car,crv,244,756,445,743,512,298,0.96916515,20,,2,1.24,
41,2,car,crv,123,1309,388,814,1186,426,0.2760011,20,,2,1.24,
42,2,car,crv,249,758,446,740,509,294,0.950518,20,,2,1.24,
43,2,car,crv,253,754,447,737,501,290,0.94723046,20,,2,1.24,
44,2,car,crv,121,1308,387,817,1187,430,0.21458383,20,,2,0.36225779275484415,
45,2,car,crv,250,754,447,740,504,293,0.9610552,20,,2,0.36225779275484415,
46,2,car,crv,119,1317,388,814,1198,426,0.4732625,20,,2,1.24,
47,2,car,crv,245,758,448,742,513,294,0.94409996,20,,2,1.24,
48,2,car,crv,121,1308,388,815,1187,427,0.21448645,20,,2,0.35973041280539175,
49,2,car,crv,249,753,445,746,504,301,0.9724925,20,,2,0.35973041280539175,
50,2,car,crv,135,1302,387,821,1167,434,0.35179994,20,,2,1.2916666666666667,
51,2,car,crv,250,760,450,741,510,291,0.8736024,20,,2,1.2916666666666667,
52,2,car,crv,117,1313,390,812,1196,422,0.32242462,20,,2,1.2916666666666667,
53,2,car,crv,243,759,447,742,516,295,0.9675998,20,,2,1.2916666666666667,
54,2,car,crv,122,1311,387,814,1189,427,0.36553156,20,,2,1.2916666666666667,
55,2,car,crv,250,757,444,744,507,300,0.9479286,20,,2,1.2916666666666667,
56,2,car,crv,115,1321,388,815,1206,427,0.3674716,20,,2,1.24,
57,2,car,crv,248,756,446,740,508,294,0.92142504,20,,2,1.24,
58,2,car,crv,109,1315,384,827,1206,443,0.2820505,20,,2,1.24,
59,2,car,crv,249,758,449,736,509,287,0.91024953,20,,2,1.24,
60,2,car,crv,122,1310,388,817,1188,429,0.29904467,20,,2,0.3611111111111111,
61,2,car,crv,250,760,448,741,510,293,0.927252,20,,2,0.3611111111111111,
62,2,car,crv,129,1303,389,814,1174,425,0.27334884,20,,2,1.28,
63,2,car,crv,247,760,448,741,513,293,0.9333165,20,,2,1.28,
64,2,car,crv,122,1311,385,813,1189,428,0.35830083,20,,2,1.24,
65,2,car,crv,246,757,442,746,511,304,0.9668414,20,,2,1.24,
66,2,car,crv,122,1312,391,808,1190,417,0.34383425,20,,2,1.28,
67,2,car,crv,248,755,446,741,507,295,0.90284395,20,,2,1.28,
68,2,car,crv,129,1303,386,819,1174,433,0.2341652,20,,2,0.368824531516184,
69,2,car,crv,252,756,447,744,504,297,0.9354642,20,,2,0.368824531516184,
70,2,car,crv,253,756,446,744,503,298,0.97629297,20,,2,1.24,
71,2,car,crv,128,1307,388,817,1179,429,0.32914877,20,,2,1.2916666666666667,
72,2,car,crv,247,762,447,741,515,294,0.9441378,20,,2,1.2916666666666667,
73,2,car,crv,117,1313,388,818,1196,430,0.27251616,20,,2,0.3595317725752508,
74,2,car,crv,247,762,449,740,515,291,0.96550846,20,,2,0.3595317725752508,
75,2,car,crv,124,1305,387,820,1181,433,0.27402008,20,,2,0.36663844199830653,
76,2,car,crv,252,750,447,746,498,299,0.9501165,20,,2,0.36663844199830653,
77,2,car,crv,111,1317,390,812,1206,422,0.27479288,20,,2,0.34991708126036486,
78,2,car,crv,251,753,447,740,502,293,0.9438285,20,,2,0.34991708126036486,
79,2,car,crv,126,1309,390,814,1183,424,0.30222148,20,,2,1.2916666666666667,
80,2,car,crv,249,757,448,740,508,292,0.91383094,20,,2,1.2916666666666667,
81,2,car,crv,111,1317,390,811,1206,421,0.2941505,20,,2,0.3490878938640133,
82,2,car,crv,247,756,446,741,509,295,0.96245986,20,,2,0.3490878938640133,
83,2,car,crv,134,1300,387,818,1166,431,0.35928637,20,,2,1.28,
84,2,car,crv,251,757,447,743,506,296,0.9412378,20,,2,1.28,
85,2,car,crv,126,1312,388,815,1186,427,0.3965622,20,,2,1.24,
86,2,car,crv,252,758,446,743,506,297,0.9420341,20,,2,1.24,
87,2,car,crv,121,1316,389,809,1195,420,0.4096516,20,,2,1.24,
88,2,car,crv,244,761,447,742,517,295,0.9289579,20,,2,1.24,
89,2,car,crv,125,1312,392,805,1187,413,0.30284005,20,,2,1.24,
90,2,car,crv,245,760,447,739,515,292,0.9596912,20,,2,1.24,
91,2,car,crv,131,1307,388,812,1176,424,0.43397242,20,,2,1.2916666666666667,
92,2,car,crv,247,764,447,744,517,297,0.9014591,20,,2,1.2916666666666667,
93,2,car,crv,123,1315,388,811,1192,423,0.4968379,20,,2,1.24,
94,2,car,crv,246,758,446,743,512,297,0.87933147,20,,2,1.24,
95,2,car,crv,118,1312,389,813,1194,424,0.25691053,20,,2,0.35510887772194305,
96,2,car,crv,249,756,447,742,507,295,0.96910256,20,,2,0.35510887772194305,
97,2,car,crv,118,1319,389,813,1201,424,0.4023961,20,,2,1.28,
98,2,car,crv,243,757,448,743,514,295,0.94143236,20,,2,1.28,
99,2,car,crv,119,1322,385,815,1203,430,0.42900166,20,,2,1.24,
100,2,car,crv,246,762,447,741,516,294,0.790523,20,,2,1.24,
101,2,car,crv,119,1319,386,815,1200,429,0.44753623,20,,2,1.28,
102,2,car,crv,248,759,450,741,511,291,0.8263495,20,,2,1.28,
103,2,car,crv,114,1318,387,813,1204,426,0.43434885,20,,2,1.2916666666666667,
104,2,car,crv,246,759,446,744,513,298,0.9186257,20,,2,1.2916666666666667,
105,2,car,crv,119,1325,389,808,1206,419,0.46840343,20,,2,1.24,
106,2,car,crv,244,759,447,741,515,294,0.83414143,20,,2,1.24,
107,2,car,crv,116,1322,388,811,1206,423,0.44209528,20,,2,1.28,
108,2,car,crv,241,764,450,741,523,291,0.8834957,20,,2,1.28,
109,2,car,crv,334,710,446,701,376,255,0.92716336,3,0,2,0.6781914893617021,
110,2,car,crv,336,711,446,700,375,254,0.9036748,3,0,2,0.6773333333333333,
111,2,car,crv,335,709,444,701,374,257,0.9452533,3,0,2,0.6871657754010695,
0,2,car,crv,117,1318,387,822,1201,435,0.42310923,20,,2,1.2916666666666667,
1,2,car,crv,248,763,450,742,515,292,0.92204607,20,,2,1.2916666666666667,
2,2,car,crv,119,1311,391,813,1192,422,0.25885653,20,,2,1.25,
3,2,car,crv,246,752,446,739,506,293,0.95473194,20,,2,1.25,
4,2,car,crv,128,1304,388,815,1176,427,0.30647025,20,,2,1.28,
5,2,car,crv,251,758,443,746,507,303,0.93285924,20,,2,1.28,
6,2,car,crv,250,754,447,738,504,291,0.9767751,20,,2,1.24,
7,2,car,crv,109,1318,388,813,1209,425,0.32027155,20,,2,1.28,
8,2,car,crv,245,760,445,741,515,296,0.9680706,20,,2,1.28,
9,2,car,crv,127,1308,391,816,1181,425,0.2964813,20,,2,1.2916666666666667,
10,2,car,crv,250,757,447,742,507,295,0.9490655,20,,2,1.2916666666666667,
11,2,car,crv,125,1314,388,816,1189,428,0.42268884,20,,2,1.28,
12,2,car,crv,248,760,449,737,512,288,0.90941703,20,,2,1.28,
13,2,car,crv,129,1304,390,814,1175,424,0.26254445,20,,2,1.2916666666666667,
14,2,car,crv,252,755,447,740,503,293,0.94612926,20,,2,1.2916666666666667,
15,2,car,crv,114,1320,387,815,1206,428,0.30274954,20,,2,1.24,
16,2,car,crv,248,753,446,740,505,294,0.8954264,20,,2,1.24,
17,2,car,crv,127,1307,391,814,1180,423,0.278648,20,,2,0.35847457627118645,
18,2,car,crv,250,755,447,744,505,297,0.95984495,20,,2,0.35847457627118645,
19,2,car,crv,127,1302,386,816,1175,430,0.37110242,20,,2,1.28,
20,2,car,crv,246,757,444,747,511,303,0.96607155,20,,2,1.28,
21,2,car,crv,119,1307,387,816,1188,429,0.28644451,20,,2,0.3611111111111111,
22,2,car,crv,248,759,443,747,511,304,0.9593547,20,,2,0.3611111111111111,
23,2,car,crv,127,1306,389,820,1179,431,0.37050778,20,,2,1.24,
24,2,car,crv,252,758,449,742,506,293,0.9203835,20,,2,1.24,
25,2,car,crv,126,1306,387,819,1180,432,0.24266188,20,,2,0.36610169491525424,
26,2,car,crv,247,754,449,740,507,291,0.94762105,20,,2,0.36610169491525424,
27,2,car,crv,113,1317,388,815,1204,427,0.36209753,20,,2,1.24,
28,2,car,crv,247,755,446,738,508,292,0.93217456,20,,2,1.24,
29,2,car,crv,116,1312,386,813,1196,427,0.26130736,20,,2,0.35702341137123744,
30,2,car,crv,249,755,445,740,506,295,0.95275867,20,,2,0.35702341137123744,
31,2,car,crv,250,753,445,746,503,301,0.97777426,20,,2,1.24,
32,2,car,crv,117,1316,390,813,1199,423,0.30318785,20,,2,0.35279399499582986,
33,2,car,crv,239,759,447,740,520,293,0.956478,20,,2,0.35279399499582986,
34,2,car,crv,126,1307,387,813,1181,426,0.3400013,20,,2,1.24,
35,2,car,crv,250,757,446,745,507,299,0.93553233,20,,2,1.24,
36,2,car,crv,118,1316,385,817,1198,432,0.46192503,20,,2,1.24,
37,2,car,crv,242,760,449,744,518,295,0.9251644,20,,2,1.24,
38,2,car,crv,125,1310,389,811,1185,422,0.32076746,20,,2,0.3561181434599156,
39,2,car,crv,250,758,446,739,508,293,0.9462212,20,,2,0.3561181434599156,
40,2,car,crv,250,754,444,740,504,296,0.96969557,20,,2,1.24,
41,2,car,crv,113,1313,388,814,1200,426,0.2754978,20,,2,1.24,
42,2,car,crv,244,756,445,743,512,298,0.96916515,20,,2,1.24,
43,2,car,crv,123,1309,388,814,1186,426,0.2760011,20,,2,1.24,
44,2,car,crv,249,758,446,740,509,294,0.950518,20,,2,1.24,
45,2,car,crv,253,754,447,737,501,290,0.94723046,20,,2,1.24,
46,2,car,crv,121,1308,387,817,1187,430,0.21458383,20,,2,0.36225779275484415,
47,2,car,crv,250,754,447,740,504,293,0.9610552,20,,2,0.36225779275484415,
48,2,car,crv,119,1317,388,814,1198,426,0.4732625,20,,2,1.24,
49,2,car,crv,245,758,448,742,513,294,0.94409996,20,,2,1.24,
50,2,car,crv,121,1308,388,815,1187,427,0.21448645,20,,2,0.35973041280539175,
51,2,car,crv,249,753,445,746,504,301,0.9724925,20,,2,0.35973041280539175,
52,2,car,crv,135,1302,387,821,1167,434,0.35179994,20,,2,1.2916666666666667,
53,2,car,crv,250,760,450,741,510,291,0.8736024,20,,2,1.2916666666666667,
54,2,car,crv,117,1313,390,812,1196,422,0.32242462,20,,2,1.2916666666666667,
55,2,car,crv,243,759,447,742,516,295,0.9675998,20,,2,1.2916666666666667,
56,2,car,crv,122,1311,387,814,1189,427,0.36553156,20,,2,1.2916666666666667,
57,2,car,crv,250,757,444,744,507,300,0.9479286,20,,2,1.2916666666666667,
58,2,car,crv,115,1321,388,815,1206,427,0.3674716,20,,2,1.24,
59,2,car,crv,248,756,446,740,508,294,0.92142504,20,,2,1.24,
60,2,car,crv,109,1315,384,827,1206,443,0.2820505,20,,2,1.24,
61,2,car,crv,249,758,449,736,509,287,0.91024953,20,,2,1.24,
62,2,car,crv,122,1310,388,817,1188,429,0.29904467,20,,2,0.3611111111111111,
63,2,car,crv,250,760,448,741,510,293,0.927252,20,,2,0.3611111111111111,
64,2,car,crv,129,1303,389,814,1174,425,0.27334884,20,,2,1.28,
65,2,car,crv,247,760,448,741,513,293,0.9333165,20,,2,1.28,
66,2,car,crv,122,1311,385,813,1189,428,0.35830083,20,,2,1.24,
67,2,car,crv,246,757,442,746,511,304,0.9668414,20,,2,1.24,
68,2,car,crv,122,1312,391,808,1190,417,0.34383425,20,,2,1.28,
69,2,car,crv,248,755,446,741,507,295,0.90284395,20,,2,1.28,
70,2,car,crv,129,1303,386,819,1174,433,0.2341652,20,,2,0.368824531516184,
71,2,car,crv,252,756,447,744,504,297,0.9354642,20,,2,0.368824531516184,
72,2,car,crv,253,756,446,744,503,298,0.97629297,20,,2,1.24,
73,2,car,crv,128,1307,388,817,1179,429,0.32914877,20,,2,1.2916666666666667,
74,2,car,crv,247,762,447,741,515,294,0.9441378,20,,2,1.2916666666666667,
75,2,car,crv,117,1313,388,818,1196,430,0.27251616,20,,2,0.3595317725752508,
76,2,car,crv,247,762,449,740,515,291,0.96550846,20,,2,0.3595317725752508,
77,2,car,crv,124,1305,387,820,1181,433,0.27402008,20,,2,0.36663844199830653,
78,2,car,crv,252,750,447,746,498,299,0.9501165,20,,2,0.36663844199830653,
79,2,car,crv,111,1317,390,812,1206,422,0.27479288,20,,2,0.34991708126036486,
80,2,car,crv,251,753,447,740,502,293,0.9438285,20,,2,0.34991708126036486,
81,2,car,crv,126,1309,390,814,1183,424,0.30222148,20,,2,1.2916666666666667,
82,2,car,crv,249,757,448,740,508,292,0.91383094,20,,2,1.2916666666666667,
83,2,car,crv,111,1317,390,811,1206,421,0.2941505,20,,2,0.3490878938640133,
84,2,car,crv,247,756,446,741,509,295,0.96245986,20,,2,0.3490878938640133,
85,2,car,crv,134,1300,387,818,1166,431,0.35928637,20,,2,1.28,
86,2,car,crv,251,757,447,743,506,296,0.9412378,20,,2,1.28,
87,2,car,crv,126,1312,388,815,1186,427,0.3965622,20,,2,1.24,
88,2,car,crv,252,758,446,743,506,297,0.9420341,20,,2,1.24,
89,2,car,crv,121,1316,389,809,1195,420,0.4096516,20,,2,1.24,
90,2,car,crv,244,761,447,742,517,295,0.9289579,20,,2,1.24,
91,2,car,crv,125,1312,392,805,1187,413,0.30284005,20,,2,1.24,
92,2,car,crv,245,760,447,739,515,292,0.9596912,20,,2,1.24,
93,2,car,crv,131,1307,388,812,1176,424,0.43397242,20,,2,1.2916666666666667,
94,2,car,crv,247,764,447,744,517,297,0.9014591,20,,2,1.2916666666666667,
95,2,car,crv,123,1315,388,811,1192,423,0.4968379,20,,2,1.24,
96,2,car,crv,246,758,446,743,512,297,0.87933147,20,,2,1.24,
97,2,car,crv,118,1312,389,813,1194,424,0.25691053,20,,2,0.35510887772194305,
98,2,car,crv,249,756,447,742,507,295,0.96910256,20,,2,0.35510887772194305,
99,2,car,crv,118,1319,389,813,1201,424,0.4023961,20,,2,1.28,
100,2,car,crv,243,757,448,743,514,295,0.94143236,20,,2,1.28,
101,2,car,crv,119,1322,385,815,1203,430,0.42900166,20,,2,1.24,
102,2,car,crv,246,762,447,741,516,294,0.790523,20,,2,1.24,
103,2,car,crv,119,1319,386,815,1200,429,0.44753623,20,,2,1.28,
104,2,car,crv,248,759,450,741,511,291,0.8263495,20,,2,1.28,
105,2,car,crv,114,1318,387,813,1204,426,0.43434885,20,,2,1.2916666666666667,
106,2,car,crv,246,759,446,744,513,298,0.9186257,20,,2,1.2916666666666667,
107,2,car,crv,119,1325,389,808,1206,419,0.46840343,20,,2,1.24,
108,2,car,crv,244,759,447,741,515,294,0.83414143,20,,2,1.24,
109,2,car,crv,116,1322,388,811,1206,423,0.44209528,20,,2,1.28,
110,2,car,crv,241,764,450,741,523,291,0.8834957,20,,2,1.28,
111,2,car,crv,334,710,446,701,376,255,0.92716336,3,0,2,0.6781914893617021,
112,2,car,crv,336,711,446,700,375,254,0.9036748,3,0,2,0.6773333333333333,
113,2,car,crv,335,709,444,701,374,257,0.9452533,3,0,2,0.6871657754010695,
0,2,car,crv,251,754,443,743,503,300,0.96310854,20,,2,1.24,
1,2,car,crv,117,1318,387,822,1201,435,0.42310923,20,,2,1.2916666666666667,
2,2,car,crv,248,763,450,742,515,292,0.92204607,20,,2,1.2916666666666667,
3,2,car,crv,119,1311,391,813,1192,422,0.25885653,20,,2,1.25,
4,2,car,crv,246,752,446,739,506,293,0.95473194,20,,2,1.25,
5,2,car,crv,128,1304,388,815,1176,427,0.30647025,20,,2,1.28,
6,2,car,crv,251,758,443,746,507,303,0.93285924,20,,2,1.28,
7,2,car,crv,250,754,447,738,504,291,0.9767751,20,,2,1.24,
8,2,car,crv,109,1318,388,813,1209,425,0.32027155,20,,2,1.28,
9,2,car,crv,245,760,445,741,515,296,0.9680706,20,,2,1.28,
10,2,car,crv,127,1308,391,816,1181,425,0.2964813,20,,2,1.2916666666666667,
11,2,car,crv,250,757,447,742,507,295,0.9490655,20,,2,1.2916666666666667,
12,2,car,crv,125,1314,388,816,1189,428,0.42268884,20,,2,1.28,
13,2,car,crv,248,760,449,737,512,288,0.90941703,20,,2,1.28,
14,2,car,crv,129,1304,390,814,1175,424,0.26254445,20,,2,1.2916666666666667,
15,2,car,crv,252,755,447,740,503,293,0.94612926,20,,2,1.2916666666666667,
16,2,car,crv,114,1320,387,815,1206,428,0.30274954,20,,2,1.24,
17,2,car,crv,248,753,446,740,505,294,0.8954264,20,,2,1.24,
18,2,car,crv,127,1307,391,814,1180,423,0.278648,20,,2,0.35847457627118645,
19,2,car,crv,250,755,447,744,505,297,0.95984495,20,,2,0.35847457627118645,
20,2,car,crv,127,1302,386,816,1175,430,0.37110242,20,,2,1.28,
21,2,car,crv,246,757,444,747,511,303,0.96607155,20,,2,1.28,
22,2,car,crv,119,1307,387,816,1188,429,0.28644451,20,,2,0.3611111111111111,
23,2,car,crv,248,759,443,747,511,304,0.9593547,20,,2,0.3611111111111111,
24,2,car,crv,127,1306,389,820,1179,431,0.37050778,20,,2,1.24,
25,2,car,crv,252,758,449,742,506,293,0.9203835,20,,2,1.24,
26,2,car,crv,126,1306,387,819,1180,432,0.24266188,20,,2,0.36610169491525424,
27,2,car,crv,247,754,449,740,507,291,0.94762105,20,,2,0.36610169491525424,
28,2,car,crv,113,1317,388,815,1204,427,0.36209753,20,,2,1.24,
29,2,car,crv,247,755,446,738,508,292,0.93217456,20,,2,1.24,
30,2,car,crv,116,1312,386,813,1196,427,0.26130736,20,,2,0.35702341137123744,
31,2,car,crv,249,755,445,740,506,295,0.95275867,20,,2,0.35702341137123744,
32,2,car,crv,250,753,445,746,503,301,0.97777426,20,,2,1.24,
33,2,car,crv,117,1316,390,813,1199,423,0.30318785,20,,2,0.35279399499582986,
34,2,car,crv,239,759,447,740,520,293,0.956478,20,,2,0.35279399499582986,
35,2,car,crv,126,1307,387,813,1181,426,0.3400013,20,,2,1.24,
36,2,car,crv,250,757,446,745,507,299,0.93553233,20,,2,1.24,
37,2,car,crv,118,1316,385,817,1198,432,0.46192503,20,,2,1.24,
38,2,car,crv,242,760,449,744,518,295,0.9251644,20,,2,1.24,
39,2,car,crv,125,1310,389,811,1185,422,0.32076746,20,,2,0.3561181434599156,
40,2,car,crv,250,758,446,739,508,293,0.9462212,20,,2,0.3561181434599156,
41,2,car,crv,250,754,444,740,504,296,0.96969557,20,,2,1.24,
42,2,car,crv,113,1313,388,814,1200,426,0.2754978,20,,2,1.24,
43,2,car,crv,244,756,445,743,512,298,0.96916515,20,,2,1.24,
44,2,car,crv,123,1309,388,814,1186,426,0.2760011,20,,2,1.24,
45,2,car,crv,249,758,446,740,509,294,0.950518,20,,2,1.24,
46,2,car,crv,253,754,447,737,501,290,0.94723046,20,,2,1.24,
47,2,car,crv,121,1308,387,817,1187,430,0.21458383,20,,2,0.36225779275484415,
48,2,car,crv,250,754,447,740,504,293,0.9610552,20,,2,0.36225779275484415,
49,2,car,crv,119,1317,388,814,1198,426,0.4732625,20,,2,1.24,
50,2,car,crv,245,758,448,742,513,294,0.94409996,20,,2,1.24,
51,2,car,crv,121,1308,388,815,1187,427,0.21448645,20,,2,0.35973041280539175,
52,2,car,crv,249,753,445,746,504,301,0.9724925,20,,2,0.35973041280539175,
53,2,car,crv,135,1302,387,821,1167,434,0.35179994,20,,2,1.2916666666666667,
54,2,car,crv,250,760,450,741,510,291,0.8736024,20,,2,1.2916666666666667,
55,2,car,crv,117,1313,390,812,1196,422,0.32242462,20,,2,1.2916666666666667,
56,2,car,crv,243,759,447,742,516,295,0.9675998,20,,2,1.2916666666666667,
57,2,car,crv,122,1311,387,814,1189,427,0.36553156,20,,2,1.2916666666666667,
58,2,car,crv,250,757,444,744,507,300,0.9479286,20,,2,1.2916666666666667,
59,2,car,crv,115,1321,388,815,1206,427,0.3674716,20,,2,1.24,
60,2,car,crv,248,756,446,740,508,294,0.92142504,20,,2,1.24,
61,2,car,crv,109,1315,384,827,1206,443,0.2820505,20,,2,1.24,
62,2,car,crv,249,758,449,736,509,287,0.91024953,20,,2,1.24,
63,2,car,crv,122,1310,388,817,1188,429,0.29904467,20,,2,0.3611111111111111,
64,2,car,crv,250,760,448,741,510,293,0.927252,20,,2,0.3611111111111111,
65,2,car,crv,129,1303,389,814,1174,425,0.27334884,20,,2,1.28,
66,2,car,crv,247,760,448,741,513,293,0.9333165,20,,2,1.28,
67,2,car,crv,122,1311,385,813,1189,428,0.35830083,20,,2,1.24,
68,2,car,crv,246,757,442,746,511,304,0.9668414,20,,2,1.24,
69,2,car,crv,122,1312,391,808,1190,417,0.34383425,20,,2,1.28,
70,2,car,crv,248,755,446,741,507,295,0.90284395,20,,2,1.28,
71,2,car,crv,129,1303,386,819,1174,433,0.2341652,20,,2,0.368824531516184,
72,2,car,crv,252,756,447,744,504,297,0.9354642,20,,2,0.368824531516184,
73,2,car,crv,253,756,446,744,503,298,0.97629297,20,,2,1.24,
74,2,car,crv,128,1307,388,817,1179,429,0.32914877,20,,2,1.2916666666666667,
75,2,car,crv,247,762,447,741,515,294,0.9441378,20,,2,1.2916666666666667,
76,2,car,crv,117,1313,388,818,1196,430,0.27251616,20,,2,0.3595317725752508,
77,2,car,crv,247,762,449,740,515,291,0.96550846,20,,2,0.3595317725752508,
78,2,car,crv,124,1305,387,820,1181,433,0.27402008,20,,2,0.36663844199830653,
79,2,car,crv,252,750,447,746,498,299,0.9501165,20,,2,0.36663844199830653,
80,2,car,crv,111,1317,390,812,1206,422,0.27479288,20,,2,0.34991708126036486,
81,2,car,crv,251,753,447,740,502,293,0.9438285,20,,2,0.34991708126036486,
82,2,car,crv,126,1309,390,814,1183,424,0.30222148,20,,2,1.2916666666666667,
83,2,car,crv,249,757,448,740,508,292,0.91383094,20,,2,1.2916666666666667,
84,2,car,crv,111,1317,390,811,1206,421,0.2941505,20,,2,0.3490878938640133,
85,2,car,crv,247,756,446,741,509,295,0.96245986,20,,2,0.3490878938640133,
86,2,car,crv,134,1300,387,818,1166,431,0.35928637,20,,2,1.28,
87,2,car,crv,251,757,447,743,506,296,0.9412378,20,,2,1.28,
88,2,car,crv,126,1312,388,815,1186,427,0.3965622,20,,2,1.24,
89,2,car,crv,252,758,446,743,506,297,0.9420341,20,,2,1.24,
90,2,car,crv,121,1316,389,809,1195,420,0.4096516,20,,2,1.24,
91,2,car,crv,244,761,447,742,517,295,0.9289579,20,,2,1.24,
92,2,car,crv,125,1312,392,805,1187,413,0.30284005,20,,2,1.24,
93,2,car,crv,245,760,447,739,515,292,0.9596912,20,,2,1.24,
94,2,car,crv,131,1307,388,812,1176,424,0.43397242,20,,2,1.2916666666666667,
95,2,car,crv,247,764,447,744,517,297,0.9014591,20,,2,1.2916666666666667,
96,2,car,crv,123,1315,388,811,1192,423,0.4968379,20,,2,1.24,
97,2,car,crv,246,758,446,743,512,297,0.87933147,20,,2,1.24,
98,2,car,crv,118,1312,389,813,1194,424,0.25691053,20,,2,0.35510887772194305,
99,2,car,crv,249,756,447,742,507,295,0.96910256,20,,2,0.35510887772194305,
100,2,car,crv,118,1319,389,813,1201,424,0.4023961,20,,2,1.28,
101,2,car,crv,243,757,448,743,514,295,0.94143236,20,,2,1.28,
102,2,car,crv,119,1322,385,815,1203,430,0.42900166,20,,2,1.24,
103,2,car,crv,246,762,447,741,516,294,0.790523,20,,2,1.24,
104,2,car,crv,119,1319,386,815,1200,429,0.44753623,20,,2,1.28,
105,2,car,crv,248,759,450,741,511,291,0.8263495,20,,2,1.28,
106,2,car,crv,114,1318,387,813,1204,426,0.43434885,20,,2,1.2916666666666667,
107,2,car,crv,246,759,446,744,513,298,0.9186257,20,,2,1.2916666666666667,
108,2,car,crv,119,1325,389,808,1206,419,0.46840343,20,,2,1.24,
109,2,car,crv,244,759,447,741,515,294,0.83414143,20,,2,1.24,
110,2,car,crv,116,1322,388,811,1206,423,0.44209528,20,,2,1.28,
111,2,car,crv,241,764,450,741,523,291,0.8834957,20,,2,1.28,
112,2,car,crv,334,710,446,701,376,255,0.92716336,3,0,2,0.6781914893617021,
113,2,car,crv,336,711,446,700,375,254,0.9036748,3,0,2,0.6773333333333333,
114,2,car,crv,335,709,444,701,374,257,0.9452533,3,0,2,0.6871657754010695,
0,2,car,crv,121,1305,386,819,1184,433,0.24762785,20,,2,0.3657094594594595,
1,2,car,crv,248,759,448,745,511,297,0.96054053,20,,2,0.3657094594594595,
2,2,car,crv,251,754,443,743,503,300,0.96310854,20,,2,1.24,
3,2,car,crv,117,1318,387,822,1201,435,0.42310923,20,,2,1.2916666666666667,
4,2,car,crv,248,763,450,742,515,292,0.92204607,20,,2,1.2916666666666667,
5,2,car,crv,119,1311,391,813,1192,422,0.25885653,20,,2,1.25,
6,2,car,crv,246,752,446,739,506,293,0.95473194,20,,2,1.25,
7,2,car,crv,128,1304,388,815,1176,427,0.30647025,20,,2,1.28,
8,2,car,crv,251,758,443,746,507,303,0.93285924,20,,2,1.28,
9,2,car,crv,250,754,447,738,504,291,0.9767751,20,,2,1.24,
10,2,car,crv,109,1318,388,813,1209,425,0.32027155,20,,2,1.28,
11,2,car,crv,245,760,445,741,515,296,0.9680706,20,,2,1.28,
12,2,car,crv,127,1308,391,816,1181,425,0.2964813,20,,2,1.2916666666666667,
13,2,car,crv,250,757,447,742,507,295,0.9490655,20,,2,1.2916666666666667,
14,2,car,crv,125,1314,388,816,1189,428,0.42268884,20,,2,1.28,
15,2,car,crv,248,760,449,737,512,288,0.90941703,20,,2,1.28,
16,2,car,crv,129,1304,390,814,1175,424,0.26254445,20,,2,1.2916666666666667,
17,2,car,crv,252,755,447,740,503,293,0.94612926,20,,2,1.2916666666666667,
18,2,car,crv,114,1320,387,815,1206,428,0.30274954,20,,2,1.24,
19,2,car,crv,248,753,446,740,505,294,0.8954264,20,,2,1.24,
20,2,car,crv,127,1307,391,814,1180,423,0.278648,20,,2,0.35847457627118645,
21,2,car,crv,250,755,447,744,505,297,0.95984495,20,,2,0.35847457627118645,
22,2,car,crv,127,1302,386,816,1175,430,0.37110242,20,,2,1.28,
23,2,car,crv,246,757,444,747,511,303,0.96607155,20,,2,1.28,
24,2,car,crv,119,1307,387,816,1188,429,0.28644451,20,,2,0.3611111111111111,
25,2,car,crv,248,759,443,747,511,304,0.9593547,20,,2,0.3611111111111111,
26,2,car,crv,127,1306,389,820,1179,431,0.37050778,20,,2,1.24,
27,2,car,crv,252,758,449,742,506,293,0.9203835,20,,2,1.24,
28,2,car,crv,126,1306,387,819,1180,432,0.24266188,20,,2,0.36610169491525424,
29,2,car,crv,247,754,449,740,507,291,0.94762105,20,,2,0.36610169491525424,
30,2,car,crv,113,1317,388,815,1204,427,0.36209753,20,,2,1.24,
31,2,car,crv,247,755,446,738,508,292,0.93217456,20,,2,1.24,
32,2,car,crv,116,1312,386,813,1196,427,0.26130736,20,,2,0.35702341137123744,
33,2,car,crv,249,755,445,740,506,295,0.95275867,20,,2,0.35702341137123744,
34,2,car,crv,250,753,445,746,503,301,0.97777426,20,,2,1.24,
35,2,car,crv,117,1316,390,813,1199,423,0.30318785,20,,2,0.35279399499582986,
36,2,car,crv,239,759,447,740,520,293,0.956478,20,,2,0.35279399499582986,
37,2,car,crv,126,1307,387,813,1181,426,0.3400013,20,,2,1.24,
38,2,car,crv,250,757,446,745,507,299,0.93553233,20,,2,1.24,
39,2,car,crv,118,1316,385,817,1198,432,0.46192503,20,,2,1.24,
40,2,car,crv,242,760,449,744,518,295,0.9251644,20,,2,1.24,
41,2,car,crv,125,1310,389,811,1185,422,0.32076746,20,,2,0.3561181434599156,
42,2,car,crv,250,758,446,739,508,293,0.9462212,20,,2,0.3561181434599156,
43,2,car,crv,250,754,444,740,504,296,0.96969557,20,,2,1.24,
44,2,car,crv,113,1313,388,814,1200,426,0.2754978,20,,2,1.24,
45,2,car,crv,244,756,445,743,512,298,0.96916515,20,,2,1.24,
46,2,car,crv,123,1309,388,814,1186,426,0.2760011,20,,2,1.24,
47,2,car,crv,249,758,446,740,509,294,0.950518,20,,2,1.24,
48,2,car,crv,253,754,447,737,501,290,0.94723046,20,,2,1.24,
49,2,car,crv,121,1308,387,817,1187,430,0.21458383,20,,2,0.36225779275484415,
50,2,car,crv,250,754,447,740,504,293,0.9610552,20,,2,0.36225779275484415,
51,2,car,crv,119,1317,388,814,1198,426,0.4732625,20,,2,1.24,
52,2,car,crv,245,758,448,742,513,294,0.94409996,20,,2,1.24,
53,2,car,crv,121,1308,388,815,1187,427,0.21448645,20,,2,0.35973041280539175,
54,2,car,crv,249,753,445,746,504,301,0.9724925,20,,2,0.35973041280539175,
55,2,car,crv,135,1302,387,821,1167,434,0.35179994,20,,2,1.2916666666666667,
56,2,car,crv,250,760,450,741,510,291,0.8736024,20,,2,1.2916666666666667,
57,2,car,crv,117,1313,390,812,1196,422,0.32242462,20,,2,1.2916666666666667,
58,2,car,crv,243,759,447,742,516,295,0.9675998,20,,2,1.2916666666666667,
59,2,car,crv,122,1311,387,814,1189,427,0.36553156,20,,2,1.2916666666666667,
60,2,car,crv,250,757,444,744,507,300,0.9479286,20,,2,1.2916666666666667,
61,2,car,crv,115,1321,388,815,1206,427,0.3674716,20,,2,1.24,
62,2,car,crv,248,756,446,740,508,294,0.92142504,20,,2,1.24,
63,2,car,crv,109,1315,384,827,1206,443,0.2820505,20,,2,1.24,
64,2,car,crv,249,758,449,736,509,287,0.91024953,20,,2,1.24,
65,2,car,crv,122,1310,388,817,1188,429,0.29904467,20,,2,0.3611111111111111,
66,2,car,crv,250,760,448,741,510,293,0.927252,20,,2,0.3611111111111111,
67,2,car,crv,129,1303,389,814,1174,425,0.27334884,20,,2,1.28,
68,2,car,crv,247,760,448,741,513,293,0.9333165,20,,2,1.28,
69,2,car,crv,122,1311,385,813,1189,428,0.35830083,20,,2,1.24,
70,2,car,crv,246,757,442,746,511,304,0.9668414,20,,2,1.24,
71,2,car,crv,122,1312,391,808,1190,417,0.34383425,20,,2,1.28,
72,2,car,crv,248,755,446,741,507,295,0.90284395,20,,2,1.28,
73,2,car,crv,129,1303,386,819,1174,433,0.2341652,20,,2,0.368824531516184,
74,2,car,crv,252,756,447,744,504,297,0.9354642,20,,2,0.368824531516184,
75,2,car,crv,253,756,446,744,503,298,0.97629297,20,,2,1.24,
76,2,car,crv,128,1307,388,817,1179,429,0.32914877,20,,2,1.2916666666666667,
77,2,car,crv,247,762,447,741,515,294,0.9441378,20,,2,1.2916666666666667,
78,2,car,crv,117,1313,388,818,1196,430,0.27251616,20,,2,0.3595317725752508,
79,2,car,crv,247,762,449,740,515,291,0.96550846,20,,2,0.3595317725752508,
80,2,car,crv,124,1305,387,820,1181,433,0.27402008,20,,2,0.36663844199830653,
81,2,car,crv,252,750,447,746,498,299,0.9501165,20,,2,0.36663844199830653,
82,2,car,crv,111,1317,390,812,1206,422,0.27479288,20,,2,0.34991708126036486,
83,2,car,crv,251,753,447,740,502,293,0.9438285,20,,2,0.34991708126036486,
84,2,car,crv,126,1309,390,814,1183,424,0.30222148,20,,2,1.2916666666666667,
85,2,car,crv,249,757,448,740,508,292,0.91383094,20,,2,1.2916666666666667,
86,2,car,crv,111,1317,390,811,1206,421,0.2941505,20,,2,0.3490878938640133,
87,2,car,crv,247,756,446,741,509,295,0.96245986,20,,2,0.3490878938640133,
88,2,car,crv,134,1300,387,818,1166,431,0.35928637,20,,2,1.28,
89,2,car,crv,251,757,447,743,506,296,0.9412378,20,,2,1.28,
90,2,car,crv,126,1312,388,815,1186,427,0.3965622,20,,2,1.24,
91,2,car,crv,252,758,446,743,506,297,0.9420341,20,,2,1.24,
92,2,car,crv,121,1316,389,809,1195,420,0.4096516,20,,2,1.24,
93,2,car,crv,244,761,447,742,517,295,0.9289579,20,,2,1.24,
94,2,car,crv,125,1312,392,805,1187,413,0.30284005,20,,2,1.24,
95,2,car,crv,245,760,447,739,515,292,0.9596912,20,,2,1.24,
96,2,car,crv,131,1307,388,812,1176,424,0.43397242,20,,2,1.2916666666666667,
97,2,car,crv,247,764,447,744,517,297,0.9014591,20,,2,1.2916666666666667,
98,2,car,crv,123,1315,388,811,1192,423,0.4968379,20,,2,1.24,
99,2,car,crv,246,758,446,743,512,297,0.87933147,20,,2,1.24,
100,2,car,crv,118,1312,389,813,1194,424,0.25691053,20,,2,0.35510887772194305,
101,2,car,crv,249,756,447,742,507,295,0.96910256,20,,2,0.35510887772194305,
102,2,car,crv,118,1319,389,813,1201,424,0.4023961,20,,2,1.28,
103,2,car,crv,243,757,448,743,514,295,0.94143236,20,,2,1.28,
104,2,car,crv,119,1322,385,815,1203,430,0.42900166,20,,2,1.24,
105,2,car,crv,246,762,447,741,516,294,0.790523,20,,2,1.24,
106,2,car,crv,119,1319,386,815,1200,429,0.44753623,20,,2,1.28,
107,2,car,crv,248,759,450,741,511,291,0.8263495,20,,2,1.28,
108,2,car,crv,114,1318,387,813,1204,426,0.43434885,20,,2,1.2916666666666667,
109,2,car,crv,246,759,446,744,513,298,0.9186257,20,,2,1.2916666666666667,
110,2,car,crv,119,1325,389,808,1206,419,0.46840343,20,,2,1.24,
111,2,car,crv,244,759,447,741,515,294,0.83414143,20,,2,1.24,
112,2,car,crv,116,1322,388,811,1206,423,0.44209528,20,,2,1.28,
113,2,car,crv,241,764,450,741,523,291,0.8834957,20,,2,1.28,
114,2,car,crv,334,710,446,701,376,255,0.92716336,3,0,2,0.6781914893617021,
115,2,car,crv,336,711,446,700,375,254,0.9036748,3,0,2,0.6773333333333333,
116,2,car,crv,335,709,444,701,374,257,0.9452533,3,0,2,0.6871657754010695,
0,2,car,crv,123,1309,389,813,1186,424,0.31858423,20,,2,1.24,
1,2,car,crv,248,758,447,745,510,298,0.9534346,20,,2,1.24,
2,2,car,crv,121,1305,386,819,1184,433,0.24762785,20,,2,0.3657094594594595,
3,2,car,crv,248,759,448,745,511,297,0.96054053,20,,2,0.3657094594594595,
4,2,car,crv,251,754,443,743,503,300,0.96310854,20,,2,1.24,
5,2,car,crv,117,1318,387,822,1201,435,0.42310923,20,,2,1.2916666666666667,
6,2,car,crv,248,763,450,742,515,292,0.92204607,20,,2,1.2916666666666667,
7,2,car,crv,119,1311,391,813,1192,422,0.25885653,20,,2,1.25,
8,2,car,crv,246,752,446,739,506,293,0.95473194,20,,2,1.25,
9,2,car,crv,128,1304,388,815,1176,427,0.30647025,20,,2,1.28,
10,2,car,crv,251,758,443,746,507,303,0.93285924,20,,2,1.28,
11,2,car,crv,250,754,447,738,504,291,0.9767751,20,,2,1.24,
12,2,car,crv,109,1318,388,813,1209,425,0.32027155,20,,2,1.28,
13,2,car,crv,245,760,445,741,515,296,0.9680706,20,,2,1.28,
14,2,car,crv,127,1308,391,816,1181,425,0.2964813,20,,2,1.2916666666666667,
15,2,car,crv,250,757,447,742,507,295,0.9490655,20,,2,1.2916666666666667,
16,2,car,crv,125,1314,388,816,1189,428,0.42268884,20,,2,1.28,
17,2,car,crv,248,760,449,737,512,288,0.90941703,20,,2,1.28,
18,2,car,crv,129,1304,390,814,1175,424,0.26254445,20,,2,1.2916666666666667,
19,2,car,crv,252,755,447,740,503,293,0.94612926,20,,2,1.2916666666666667,
20,2,car,crv,114,1320,387,815,1206,428,0.30274954,20,,2,1.24,
21,2,car,crv,248,753,446,740,505,294,0.8954264,20,,2,1.24,
22,2,car,crv,127,1307,391,814,1180,423,0.278648,20,,2,0.35847457627118645,
23,2,car,crv,250,755,447,744,505,297,0.95984495,20,,2,0.35847457627118645,
24,2,car,crv,127,1302,386,816,1175,430,0.37110242,20,,2,1.28,
25,2,car,crv,246,757,444,747,511,303,0.96607155,20,,2,1.28,
26,2,car,crv,119,1307,387,816,1188,429,0.28644451,20,,2,0.3611111111111111,
27,2,car,crv,248,759,443,747,511,304,0.9593547,20,,2,0.3611111111111111,
28,2,car,crv,127,1306,389,820,1179,431,0.37050778,20,,2,1.24,
29,2,car,crv,252,758,449,742,506,293,0.9203835,20,,2,1.24,
30,2,car,crv,126,1306,387,819,1180,432,0.24266188,20,,2,0.36610169491525424,
31,2,car,crv,247,754,449,740,507,291,0.94762105,20,,2,0.36610169491525424,
32,2,car,crv,113,1317,388,815,1204,427,0.36209753,20,,2,1.24,
33,2,car,crv,247,755,446,738,508,292,0.93217456,20,,2,1.24,
34,2,car,crv,116,1312,386,813,1196,427,0.26130736,20,,2,0.35702341137123744,
35,2,car,crv,249,755,445,740,506,295,0.95275867,20,,2,0.35702341137123744,
36,2,car,crv,250,753,445,746,503,301,0.97777426,20,,2,1.24,
37,2,car,crv,117,1316,390,813,1199,423,0.30318785,20,,2,0.35279399499582986,
38,2,car,crv,239,759,447,740,520,293,0.956478,20,,2,0.35279399499582986,
39,2,car,crv,126,1307,387,813,1181,426,0.3400013,20,,2,1.24,
40,2,car,crv,250,757,446,745,507,299,0.93553233,20,,2,1.24,
41,2,car,crv,118,1316,385,817,1198,432,0.46192503,20,,2,1.24,
42,2,car,crv,242,760,449,744,518,295,0.9251644,20,,2,1.24,
43,2,car,crv,125,1310,389,811,1185,422,0.32076746,20,,2,0.3561181434599156,
44,2,car,crv,250,758,446,739,508,293,0.9462212,20,,2,0.3561181434599156,
45,2,car,crv,250,754,444,740,504,296,0.96969557,20,,2,1.24,
46,2,car,crv,113,1313,388,814,1200,426,0.2754978,20,,2,1.24,
47,2,car,crv,244,756,445,743,512,298,0.96916515,20,,2,1.24,
48,2,car,crv,123,1309,388,814,1186,426,0.2760011,20,,2,1.24,
49,2,car,crv,249,758,446,740,509,294,0.950518,20,,2,1.24,
50,2,car,crv,253,754,447,737,501,290,0.94723046,20,,2,1.24,
51,2,car,crv,121,1308,387,817,1187,430,0.21458383,20,,2,0.36225779275484415,
52,2,car,crv,250,754,447,740,504,293,0.9610552,20,,2,0.36225779275484415,
53,2,car,crv,119,1317,388,814,1198,426,0.4732625,20,,2,1.24,
54,2,car,crv,245,758,448,742,513,294,0.94409996,20,,2,1.24,
55,2,car,crv,121,1308,388,815,1187,427,0.21448645,20,,2,0.35973041280539175,
56,2,car,crv,249,753,445,746,504,301,0.9724925,20,,2,0.35973041280539175,
57,2,car,crv,135,1302,387,821,1167,434,0.35179994,20,,2,1.2916666666666667,
58,2,car,crv,250,760,450,741,510,291,0.8736024,20,,2,1.2916666666666667,
59,2,car,crv,117,1313,390,812,1196,422,0.32242462,20,,2,1.2916666666666667,
60,2,car,crv,243,759,447,742,516,295,0.9675998,20,,2,1.2916666666666667,
61,2,car,crv,122,1311,387,814,1189,427,0.36553156,20,,2,1.2916666666666667,
62,2,car,crv,250,757,444,744,507,300,0.9479286,20,,2,1.2916666666666667,
63,2,car,crv,115,1321,388,815,1206,427,0.3674716,20,,2,1.24,
64,2,car,crv,248,756,446,740,508,294,0.92142504,20,,2,1.24,
65,2,car,crv,109,1315,384,827,1206,443,0.2820505,20,,2,1.24,
66,2,car,crv,249,758,449,736,509,287,0.91024953,20,,2,1.24,
67,2,car,crv,122,1310,388,817,1188,429,0.29904467,20,,2,0.3611111111111111,
68,2,car,crv,250,760,448,741,510,293,0.927252,20,,2,0.3611111111111111,
69,2,car,crv,129,1303,389,814,1174,425,0.27334884,20,,2,1.28,
70,2,car,crv,247,760,448,741,513,293,0.9333165,20,,2,1.28,
71,2,car,crv,122,1311,385,813,1189,428,0.35830083,20,,2,1.24,
72,2,car,crv,246,757,442,746,511,304,0.9668414,20,,2,1.24,
73,2,car,crv,122,1312,391,808,1190,417,0.34383425,20,,2,1.28,
74,2,car,crv,248,755,446,741,507,295,0.90284395,20,,2,1.28,
75,2,car,crv,129,1303,386,819,1174,433,0.2341652,20,,2,0.368824531516184,
76,2,car,crv,252,756,447,744,504,297,0.9354642,20,,2,0.368824531516184,
77,2,car,crv,253,756,446,744,503,298,0.97629297,20,,2,1.24,
78,2,car,crv,128,1307,388,817,1179,429,0.32914877,20,,2,1.2916666666666667,
79,2,car,crv,247,762,447,741,515,294,0.9441378,20,,2,1.2916666666666667,
80,2,car,crv,117,1313,388,818,1196,430,0.27251616,20,,2,0.3595317725752508,
81,2,car,crv,247,762,449,740,515,291,0.96550846,20,,2,0.3595317725752508,
82,2,car,crv,124,1305,387,820,1181,433,0.27402008,20,,2,0.36663844199830653,
83,2,car,crv,252,750,447,746,498,299,0.9501165,20,,2,0.36663844199830653,
84,2,car,crv,111,1317,390,812,1206,422,0.27479288,20,,2,0.34991708126036486,
85,2,car,crv,251,753,447,740,502,293,0.9438285,20,,2,0.34991708126036486,
86,2,car,crv,126,1309,390,814,1183,424,0.30222148,20,,2,1.2916666666666667,
87,2,car,crv,249,757,448,740,508,292,0.91383094,20,,2,1.2916666666666667,
88,2,car,crv,111,1317,390,811,1206,421,0.2941505,20,,2,0.3490878938640133,
89,2,car,crv,247,756,446,741,509,295,0.96245986,20,,2,0.3490878938640133,
90,2,car,crv,134,1300,387,818,1166,431,0.35928637,20,,2,1.28,
91,2,car,crv,251,757,447,743,506,296,0.9412378,20,,2,1.28,
92,2,car,crv,126,1312,388,815,1186,427,0.3965622,20,,2,1.24,
93,2,car,crv,252,758,446,743,506,297,0.9420341,20,,2,1.24,
94,2,car,crv,121,1316,389,809,1195,420,0.4096516,20,,2,1.24,
95,2,car,crv,244,761,447,742,517,295,0.9289579,20,,2,1.24,
96,2,car,crv,125,1312,392,805,1187,413,0.30284005,20,,2,1.24,
97,2,car,crv,245,760,447,739,515,292,0.9596912,20,,2,1.24,
98,2,car,crv,131,1307,388,812,1176,424,0.43397242,20,,2,1.2916666666666667,
99,2,car,crv,247,764,447,744,517,297,0.9014591,20,,2,1.2916666666666667,
100,2,car,crv,123,1315,388,811,1192,423,0.4968379,20,,2,1.24,
101,2,car,crv,246,758,446,743,512,297,0.87933147,20,,2,1.24,
102,2,car,crv,118,1312,389,813,1194,424,0.25691053,20,,2,0.35510887772194305,
103,2,car,crv,249,756,447,742,507,295,0.96910256,20,,2,0.35510887772194305,
104,2,car,crv,118,1319,389,813,1201,424,0.4023961,20,,2,1.28,
105,2,car,crv,243,757,448,743,514,295,0.94143236,20,,2,1.28,
106,2,car,crv,119,1322,385,815,1203,430,0.42900166,20,,2,1.24,
107,2,car,crv,246,762,447,741,516,294,0.790523,20,,2,1.24,
108,2,car,crv,119,1319,386,815,1200,429,0.44753623,20,,2,1.28,
109,2,car,crv,248,759,450,741,511,291,0.8263495,20,,2,1.28,
110,2,car,crv,114,1318,387,813,1204,426,0.43434885,20,,2,1.2916666666666667,
111,2,car,crv,246,759,446,744,513,298,0.9186257,20,,2,1.2916666666666667,
112,2,car,crv,119,1325,389,808,1206,419,0.46840343,20,,2,1.24,
113,2,car,crv,244,759,447,741,515,294,0.83414143,20,,2,1.24,
114,2,car,crv,116,1322,388,811,1206,423,0.44209528,20,,2,1.28,
115,2,car,crv,241,764,450,741,523,291,0.8834957,20,,2,1.28,
116,2,car,crv,334,710,446,701,376,255,0.92716336,3,0,2,0.6781914893617021,
117,2,car,crv,336,711,446,700,375,254,0.9036748,3,0,2,0.6773333333333333,
118,2,car,crv,335,709,444,701,374,257,0.9452533,3,0,2,0.6871657754010695,
0,2,car,crv,130,1306,391,810,1176,419,0.26097575,20,,2,0.3562925170068027,
1,2,car,crv,250,756,447,739,506,292,0.95065075,20,,2,0.3562925170068027,
2,2,car,crv,123,1309,389,813,1186,424,0.31858423,20,,2,1.24,
3,2,car,crv,248,758,447,745,510,298,0.9534346,20,,2,1.24,
4,2,car,crv,121,1305,386,819,1184,433,0.24762785,20,,2,0.3657094594594595,
5,2,car,crv,248,759,448,745,511,297,0.96054053,20,,2,0.3657094594594595,
6,2,car,crv,251,754,443,743,503,300,0.96310854,20,,2,1.24,
7,2,car,crv,117,1318,387,822,1201,435,0.42310923,20,,2,1.2916666666666667,
8,2,car,crv,248,763,450,742,515,292,0.92204607,20,,2,1.2916666666666667,
9,2,car,crv,119,1311,391,813,1192,422,0.25885653,20,,2,1.25,
10,2,car,crv,246,752,446,739,506,293,0.95473194,20,,2,1.25,
11,2,car,crv,128,1304,388,815,1176,427,0.30647025,20,,2,1.28,
12,2,car,crv,251,758,443,746,507,303,0.93285924,20,,2,1.28,
13,2,car,crv,250,754,447,738,504,291,0.9767751,20,,2,1.24,
14,2,car,crv,109,1318,388,813,1209,425,0.32027155,20,,2,1.28,
15,2,car,crv,245,760,445,741,515,296,0.9680706,20,,2,1.28,
16,2,car,crv,127,1308,391,816,1181,425,0.2964813,20,,2,1.2916666666666667,
17,2,car,crv,250,757,447,742,507,295,0.9490655,20,,2,1.2916666666666667,
18,2,car,crv,125,1314,388,816,1189,428,0.42268884,20,,2,1.28,
19,2,car,crv,248,760,449,737,512,288,0.90941703,20,,2,1.28,
20,2,car,crv,129,1304,390,814,1175,424,0.26254445,20,,2,1.2916666666666667,
21,2,car,crv,252,755,447,740,503,293,0.94612926,20,,2,1.2916666666666667,
22,2,car,crv,114,1320,387,815,1206,428,0.30274954,20,,2,1.24,
23,2,car,crv,248,753,446,740,505,294,0.8954264,20,,2,1.24,
24,2,car,crv,127,1307,391,814,1180,423,0.278648,20,,2,0.35847457627118645,
25,2,car,crv,250,755,447,744,505,297,0.95984495,20,,2,0.35847457627118645,
26,2,car,crv,127,1302,386,816,1175,430,0.37110242,20,,2,1.28,
27,2,car,crv,246,757,444,747,511,303,0.96607155,20,,2,1.28,
28,2,car,crv,119,1307,387,816,1188,429,0.28644451,20,,2,0.3611111111111111,
29,2,car,crv,248,759,443,747,511,304,0.9593547,20,,2,0.3611111111111111,
30,2,car,crv,127,1306,389,820,1179,431,0.37050778,20,,2,1.24,
31,2,car,crv,252,758,449,742,506,293,0.9203835,20,,2,1.24,
32,2,car,crv,126,1306,387,819,1180,432,0.24266188,20,,2,0.36610169491525424,
33,2,car,crv,247,754,449,740,507,291,0.94762105,20,,2,0.36610169491525424,
34,2,car,crv,113,1317,388,815,1204,427,0.36209753,20,,2,1.24,
35,2,car,crv,247,755,446,738,508,292,0.93217456,20,,2,1.24,
36,2,car,crv,116,1312,386,813,1196,427,0.26130736,20,,2,0.35702341137123744,
37,2,car,crv,249,755,445,740,506,295,0.95275867,20,,2,0.35702341137123744,
38,2,car,crv,250,753,445,746,503,301,0.97777426,20,,2,1.24,
39,2,car,crv,117,1316,390,813,1199,423,0.30318785,20,,2,0.35279399499582986,
40,2,car,crv,239,759,447,740,520,293,0.956478,20,,2,0.35279399499582986,
41,2,car,crv,126,1307,387,813,1181,426,0.3400013,20,,2,1.24,
42,2,car,crv,250,757,446,745,507,299,0.93553233,20,,2,1.24,
43,2,car,crv,118,1316,385,817,1198,432,0.46192503,20,,2,1.24,
44,2,car,crv,242,760,449,744,518,295,0.9251644,20,,2,1.24,
45,2,car,crv,125,1310,389,811,1185,422,0.32076746,20,,2,0.3561181434599156,
46,2,car,crv,250,758,446,739,508,293,0.9462212,20,,2,0.3561181434599156,
47,2,car,crv,250,754,444,740,504,296,0.96969557,20,,2,1.24,
48,2,car,crv,113,1313,388,814,1200,426,0.2754978,20,,2,1.24,
49,2,car,crv,244,756,445,743,512,298,0.96916515,20,,2,1.24,
50,2,car,crv,123,1309,388,814,1186,426,0.2760011,20,,2,1.24,
51,2,car,crv,249,758,446,740,509,294,0.950518,20,,2,1.24,
52,2,car,crv,253,754,447,737,501,290,0.94723046,20,,2,1.24,
53,2,car,crv,121,1308,387,817,1187,430,0.21458383,20,,2,0.36225779275484415,
54,2,car,crv,250,754,447,740,504,293,0.9610552,20,,2,0.36225779275484415,
55,2,car,crv,119,1317,388,814,1198,426,0.4732625,20,,2,1.24,
56,2,car,crv,245,758,448,742,513,294,0.94409996,20,,2,1.24,
57,2,car,crv,121,1308,388,815,1187,427,0.21448645,20,,2,0.35973041280539175,
58,2,car,crv,249,753,445,746,504,301,0.9724925,20,,2,0.35973041280539175,
59,2,car,crv,135,1302,387,821,1167,434,0.35179994,20,,2,1.2916666666666667,
60,2,car,crv,250,760,450,741,510,291,0.8736024,20,,2,1.2916666666666667,
61,2,car,crv,117,1313,390,812,1196,422,0.32242462,20,,2,1.2916666666666667,
62,2,car,crv,243,759,447,742,516,295,0.9675998,20,,2,1.2916666666666667,
63,2,car,crv,122,1311,387,814,1189,427,0.36553156,20,,2,1.2916666666666667,
64,2,car,crv,250,757,444,744,507,300,0.9479286,20,,2,1.2916666666666667,
65,2,car,crv,115,1321,388,815,1206,427,0.3674716,20,,2,1.24,
66,2,car,crv,248,756,446,740,508,294,0.92142504,20,,2,1.24,
67,2,car,crv,109,1315,384,827,1206,443,0.2820505,20,,2,1.24,
68,2,car,crv,249,758,449,736,509,287,0.91024953,20,,2,1.24,
69,2,car,crv,122,1310,388,817,1188,429,0.29904467,20,,2,0.3611111111111111,
70,2,car,crv,250,760,448,741,510,293,0.927252,20,,2,0.3611111111111111,
71,2,car,crv,129,1303,389,814,1174,425,0.27334884,20,,2,1.28,
72,2,car,crv,247,760,448,741,513,293,0.9333165,20,,2,1.28,
73,2,car,crv,122,1311,385,813,1189,428,0.35830083,20,,2,1.24,
74,2,car,crv,246,757,442,746,511,304,0.9668414,20,,2,1.24,
75,2,car,crv,122,1312,391,808,1190,417,0.34383425,20,,2,1.28,
76,2,car,crv,248,755,446,741,507,295,0.90284395,20,,2,1.28,
77,2,car,crv,129,1303,386,819,1174,433,0.2341652,20,,2,0.368824531516184,
78,2,car,crv,252,756,447,744,504,297,0.9354642,20,,2,0.368824531516184,
79,2,car,crv,253,756,446,744,503,298,0.97629297,20,,2,1.24,
80,2,car,crv,128,1307,388,817,1179,429,0.32914877,20,,2,1.2916666666666667,
81,2,car,crv,247,762,447,741,515,294,0.9441378,20,,2,1.2916666666666667,
82,2,car,crv,117,1313,388,818,1196,430,0.27251616,20,,2,0.3595317725752508,
83,2,car,crv,247,762,449,740,515,291,0.96550846,20,,2,0.3595317725752508,
84,2,car,crv,124,1305,387,820,1181,433,0.27402008,20,,2,0.36663844199830653,
85,2,car,crv,252,750,447,746,498,299,0.9501165,20,,2,0.36663844199830653,
86,2,car,crv,111,1317,390,812,1206,422,0.27479288,20,,2,0.34991708126036486,
87,2,car,crv,251,753,447,740,502,293,0.9438285,20,,2,0.34991708126036486,
88,2,car,crv,126,1309,390,814,1183,424,0.30222148,20,,2,1.2916666666666667,
89,2,car,crv,249,757,448,740,508,292,0.91383094,20,,2,1.2916666666666667,
90,2,car,crv,111,1317,390,811,1206,421,0.2941505,20,,2,0.3490878938640133,
91,2,car,crv,247,756,446,741,509,295,0.96245986,20,,2,0.3490878938640133,
92,2,car,crv,134,1300,387,818,1166,431,0.35928637,20,,2,1.28,
93,2,car,crv,251,757,447,743,506,296,0.9412378,20,,2,1.28,
94,2,car,crv,126,1312,388,815,1186,427,0.3965622,20,,2,1.24,
95,2,car,crv,252,758,446,743,506,297,0.9420341,20,,2,1.24,
96,2,car,crv,121,1316,389,809,1195,420,0.4096516,20,,2,1.24,
97,2,car,crv,244,761,447,742,517,295,0.9289579,20,,2,1.24,
98,2,car,crv,125,1312,392,805,1187,413,0.30284005,20,,2,1.24,
99,2,car,crv,245,760,447,739,515,292,0.9596912,20,,2,1.24,
100,2,car,crv,131,1307,388,812,1176,424,0.43397242,20,,2,1.2916666666666667,
101,2,car,crv,247,764,447,744,517,297,0.9014591,20,,2,1.2916666666666667,
102,2,car,crv,123,1315,388,811,1192,423,0.4968379,20,,2,1.24,
103,2,car,crv,246,758,446,743,512,297,0.87933147,20,,2,1.24,
104,2,car,crv,118,1312,389,813,1194,424,0.25691053,20,,2,0.35510887772194305,
105,2,car,crv,249,756,447,742,507,295,0.96910256,20,,2,0.35510887772194305,
106,2,car,crv,118,1319,389,813,1201,424,0.4023961,20,,2,1.28,
107,2,car,crv,243,757,448,743,514,295,0.94143236,20,,2,1.28,
108,2,car,crv,119,1322,385,815,1203,430,0.42900166,20,,2,1.24,
109,2,car,crv,246,762,447,741,516,294,0.790523,20,,2,1.24,
110,2,car,crv,119,1319,386,815,1200,429,0.44753623,20,,2,1.28,
111,2,car,crv,248,759,450,741,511,291,0.8263495,20,,2,1.28,
112,2,car,crv,114,1318,387,813,1204,426,0.43434885,20,,2,1.2916666666666667,
113,2,car,crv,246,759,446,744,513,298,0.9186257,20,,2,1.2916666666666667,
114,2,car,crv,119,1325,389,808,1206,419,0.46840343,20,,2,1.24,
115,2,car,crv,244,759,447,741,515,294,0.83414143,20,,2,1.24,
116,2,car,crv,116,1322,388,811,1206,423,0.44209528,20,,2,1.28,
117,2,car,crv,241,764,450,741,523,291,0.8834957,20,,2,1.28,
118,2,car,crv,334,710,446,701,376,255,0.92716336,3,0,2,0.6781914893617021,
119,2,car,crv,336,711,446,700,375,254,0.9036748,3,0,2,0.6773333333333333,
120,2,car,crv,335,709,444,701,374,257,0.9452533,3,0,2,0.6871657754010695,
0,2,car,crv,123,1304,388,814,1181,426,0.2588897,20,,2,0.3607112616426757,
1,2,car,crv,250,759,447,742,509,295,0.9416412,20,,2,0.3607112616426757,
2,2,car,crv,130,1306,391,810,1176,419,0.26097575,20,,2,0.3562925170068027,
3,2,car,crv,250,756,447,739,506,292,0.95065075,20,,2,0.3562925170068027,
4,2,car,crv,123,1309,389,813,1186,424,0.31858423,20,,2,1.24,
5,2,car,crv,248,758,447,745,510,298,0.9534346,20,,2,1.24,
6,2,car,crv,121,1305,386,819,1184,433,0.24762785,20,,2,0.3657094594594595,
7,2,car,crv,248,759,448,745,511,297,0.96054053,20,,2,0.3657094594594595,
8,2,car,crv,251,754,443,743,503,300,0.96310854,20,,2,1.24,
9,2,car,crv,117,1318,387,822,1201,435,0.42310923,20,,2,1.2916666666666667,
10,2,car,crv,248,763,450,742,515,292,0.92204607,20,,2,1.2916666666666667,
11,2,car,crv,119,1311,391,813,1192,422,0.25885653,20,,2,1.25,
12,2,car,crv,246,752,446,739,506,293,0.95473194,20,,2,1.25,
13,2,car,crv,128,1304,388,815,1176,427,0.30647025,20,,2,1.28,
14,2,car,crv,251,758,443,746,507,303,0.93285924,20,,2,1.28,
15,2,car,crv,250,754,447,738,504,291,0.9767751,20,,2,1.24,
16,2,car,crv,109,1318,388,813,1209,425,0.32027155,20,,2,1.28,
17,2,car,crv,245,760,445,741,515,296,0.9680706,20,,2,1.28,
18,2,car,crv,127,1308,391,816,1181,425,0.2964813,20,,2,1.2916666666666667,
19,2,car,crv,250,757,447,742,507,295,0.9490655,20,,2,1.2916666666666667,
20,2,car,crv,125,1314,388,816,1189,428,0.42268884,20,,2,1.28,
21,2,car,crv,248,760,449,737,512,288,0.90941703,20,,2,1.28,
22,2,car,crv,129,1304,390,814,1175,424,0.26254445,20,,2,1.2916666666666667,
23,2,car,crv,252,755,447,740,503,293,0.94612926,20,,2,1.2916666666666667,
24,2,car,crv,114,1320,387,815,1206,428,0.30274954,20,,2,1.24,
25,2,car,crv,248,753,446,740,505,294,0.8954264,20,,2,1.24,
26,2,car,crv,127,1307,391,814,1180,423,0.278648,20,,2,0.35847457627118645,
27,2,car,crv,250,755,447,744,505,297,0.95984495,20,,2,0.35847457627118645,
28,2,car,crv,127,1302,386,816,1175,430,0.37110242,20,,2,1.28,
29,2,car,crv,246,757,444,747,511,303,0.96607155,20,,2,1.28,
30,2,car,crv,119,1307,387,816,1188,429,0.28644451,20,,2,0.3611111111111111,
31,2,car,crv,248,759,443,747,511,304,0.9593547,20,,2,0.3611111111111111,
32,2,car,crv,127,1306,389,820,1179,431,0.37050778,20,,2,1.24,
33,2,car,crv,252,758,449,742,506,293,0.9203835,20,,2,1.24,
34,2,car,crv,126,1306,387,819,1180,432,0.24266188,20,,2,0.36610169491525424,
35,2,car,crv,247,754,449,740,507,291,0.94762105,20,,2,0.36610169491525424,
36,2,car,crv,113,1317,388,815,1204,427,0.36209753,20,,2,1.24,
37,2,car,crv,247,755,446,738,508,292,0.93217456,20,,2,1.24,
38,2,car,crv,116,1312,386,813,1196,427,0.26130736,20,,2,0.35702341137123744,
39,2,car,crv,249,755,445,740,506,295,0.95275867,20,,2,0.35702341137123744,
40,2,car,crv,250,753,445,746,503,301,0.97777426,20,,2,1.24,
41,2,car,crv,117,1316,390,813,1199,423,0.30318785,20,,2,0.35279399499582986,
42,2,car,crv,239,759,447,740,520,293,0.956478,20,,2,0.35279399499582986,
43,2,car,crv,126,1307,387,813,1181,426,0.3400013,20,,2,1.24,
44,2,car,crv,250,757,446,745,507,299,0.93553233,20,,2,1.24,
45,2,car,crv,118,1316,385,817,1198,432,0.46192503,20,,2,1.24,
46,2,car,crv,242,760,449,744,518,295,0.9251644,20,,2,1.24,
47,2,car,crv,125,1310,389,811,1185,422,0.32076746,20,,2,0.3561181434599156,
48,2,car,crv,250,758,446,739,508,293,0.9462212,20,,2,0.3561181434599156,
49,2,car,crv,250,754,444,740,504,296,0.96969557,20,,2,1.24,
50,2,car,crv,113,1313,388,814,1200,426,0.2754978,20,,2,1.24,
51,2,car,crv,244,756,445,743,512,298,0.96916515,20,,2,1.24,
52,2,car,crv,123,1309,388,814,1186,426,0.2760011,20,,2,1.24,
53,2,car,crv,249,758,446,740,509,294,0.950518,20,,2,1.24,
54,2,car,crv,253,754,447,737,501,290,0.94723046,20,,2,1.24,
55,2,car,crv,121,1308,387,817,1187,430,0.21458383,20,,2,0.36225779275484415,
56,2,car,crv,250,754,447,740,504,293,0.9610552,20,,2,0.36225779275484415,
57,2,car,crv,119,1317,388,814,1198,426,0.4732625,20,,2,1.24,
58,2,car,crv,245,758,448,742,513,294,0.94409996,20,,2,1.24,
59,2,car,crv,121,1308,388,815,1187,427,0.21448645,20,,2,0.35973041280539175,
60,2,car,crv,249,753,445,746,504,301,0.9724925,20,,2,0.35973041280539175,
61,2,car,crv,135,1302,387,821,1167,434,0.35179994,20,,2,1.2916666666666667,
62,2,car,crv,250,760,450,741,510,291,0.8736024,20,,2,1.2916666666666667,
63,2,car,crv,117,1313,390,812,1196,422,0.32242462,20,,2,1.2916666666666667,
64,2,car,crv,243,759,447,742,516,295,0.9675998,20,,2,1.2916666666666667,
65,2,car,crv,122,1311,387,814,1189,427,0.36553156,20,,2,1.2916666666666667,
66,2,car,crv,250,757,444,744,507,300,0.9479286,20,,2,1.2916666666666667,
67,2,car,crv,115,1321,388,815,1206,427,0.3674716,20,,2,1.24,
68,2,car,crv,248,756,446,740,508,294,0.92142504,20,,2,1.24,
69,2,car,crv,109,1315,384,827,1206,443,0.2820505,20,,2,1.24,
70,2,car,crv,249,758,449,736,509,287,0.91024953,20,,2,1.24,
71,2,car,crv,122,1310,388,817,1188,429,0.29904467,20,,2,0.3611111111111111,
72,2,car,crv,250,760,448,741,510,293,0.927252,20,,2,0.3611111111111111,
73,2,car,crv,129,1303,389,814,1174,425,0.27334884,20,,2,1.28,
74,2,car,crv,247,760,448,741,513,293,0.9333165,20,,2,1.28,
75,2,car,crv,122,1311,385,813,1189,428,0.35830083,20,,2,1.24,
76,2,car,crv,246,757,442,746,511,304,0.9668414,20,,2,1.24,
77,2,car,crv,122,1312,391,808,1190,417,0.34383425,20,,2,1.28,
78,2,car,crv,248,755,446,741,507,295,0.90284395,20,,2,1.28,
79,2,car,crv,129,1303,386,819,1174,433,0.2341652,20,,2,0.368824531516184,
80,2,car,crv,252,756,447,744,504,297,0.9354642,20,,2,0.368824531516184,
81,2,car,crv,253,756,446,744,503,298,0.97629297,20,,2,1.24,
82,2,car,crv,128,1307,388,817,1179,429,0.32914877,20,,2,1.2916666666666667,
83,2,car,crv,247,762,447,741,515,294,0.9441378,20,,2,1.2916666666666667,
84,2,car,crv,117,1313,388,818,1196,430,0.27251616,20,,2,0.3595317725752508,
85,2,car,crv,247,762,449,740,515,291,0.96550846,20,,2,0.3595317725752508,
86,2,car,crv,124,1305,387,820,1181,433,0.27402008,20,,2,0.36663844199830653,
87,2,car,crv,252,750,447,746,498,299,0.9501165,20,,2,0.36663844199830653,
88,2,car,crv,111,1317,390,812,1206,422,0.27479288,20,,2,0.34991708126036486,
89,2,car,crv,251,753,447,740,502,293,0.9438285,20,,2,0.34991708126036486,
90,2,car,crv,126,1309,390,814,1183,424,0.30222148,20,,2,1.2916666666666667,
91,2,car,crv,249,757,448,740,508,292,0.91383094,20,,2,1.2916666666666667,
92,2,car,crv,111,1317,390,811,1206,421,0.2941505,20,,2,0.3490878938640133,
93,2,car,crv,247,756,446,741,509,295,0.96245986,20,,2,0.3490878938640133,
94,2,car,crv,134,1300,387,818,1166,431,0.35928637,20,,2,1.28,
95,2,car,crv,251,757,447,743,506,296,0.9412378,20,,2,1.28,
96,2,car,crv,126,1312,388,815,1186,427,0.3965622,20,,2,1.24,
97,2,car,crv,252,758,446,743,506,297,0.9420341,20,,2,1.24,
98,2,car,crv,121,1316,389,809,1195,420,0.4096516,20,,2,1.24,
99,2,car,crv,244,761,447,742,517,295,0.9289579,20,,2,1.24,
100,2,car,crv,125,1312,392,805,1187,413,0.30284005,20,,2,1.24,
101,2,car,crv,245,760,447,739,515,292,0.9596912,20,,2,1.24,
102,2,car,crv,131,1307,388,812,1176,424,0.43397242,20,,2,1.2916666666666667,
103,2,car,crv,247,764,447,744,517,297,0.9014591,20,,2,1.2916666666666667,
104,2,car,crv,123,1315,388,811,1192,423,0.4968379,20,,2,1.24,
105,2,car,crv,246,758,446,743,512,297,0.87933147,20,,2,1.24,
106,2,car,crv,118,1312,389,813,1194,424,0.25691053,20,,2,0.35510887772194305,
107,2,car,crv,249,756,447,742,507,295,0.96910256,20,,2,0.35510887772194305,
108,2,car,crv,118,1319,389,813,1201,424,0.4023961,20,,2,1.28,
109,2,car,crv,243,757,448,743,514,295,0.94143236,20,,2,1.28,
110,2,car,crv,119,1322,385,815,1203,430,0.42900166,20,,2,1.24,
111,2,car,crv,246,762,447,741,516,294,0.790523,20,,2,1.24,
112,2,car,crv,119,1319,386,815,1200,429,0.44753623,20,,2,1.28,
113,2,car,crv,248,759,450,741,511,291,0.8263495,20,,2,1.28,
114,2,car,crv,114,1318,387,813,1204,426,0.43434885,20,,2,1.2916666666666667,
115,2,car,crv,246,759,446,744,513,298,0.9186257,20,,2,1.2916666666666667,
116,2,car,crv,119,1325,389,808,1206,419,0.46840343,20,,2,1.24,
117,2,car,crv,244,759,447,741,515,294,0.83414143,20,,2,1.24,
118,2,car,crv,116,1322,388,811,1206,423,0.44209528,20,,2,1.28,
119,2,car,crv,241,764,450,741,523,291,0.8834957,20,,2,1.28,
120,2,car,crv,334,710,446,701,376,255,0.92716336,3,0,2,0.6781914893617021,
121,2,car,crv,336,711,446,700,375,254,0.9036748,3,0,2,0.6773333333333333,
122,2,car,crv,335,709,444,701,374,257,0.9452533,3,0,2,0.6871657754010695,
0,2,car,crv,123,1309,392,810,1186,418,0.28978387,20,,2,1.24,
1,2,car,crv,248,758,446,738,510,292,0.96847486,20,,2,1.24,
2,2,car,crv,123,1304,388,814,1181,426,0.2588897,20,,2,0.3607112616426757,
3,2,car,crv,250,759,447,742,509,295,0.9416412,20,,2,0.3607112616426757,
4,2,car,crv,130,1306,391,810,1176,419,0.26097575,20,,2,0.3562925170068027,
5,2,car,crv,250,756,447,739,506,292,0.95065075,20,,2,0.3562925170068027,
6,2,car,crv,123,1309,389,813,1186,424,0.31858423,20,,2,1.24,
7,2,car,crv,248,758,447,745,510,298,0.9534346,20,,2,1.24,
8,2,car,crv,121,1305,386,819,1184,433,0.24762785,20,,2,0.3657094594594595,
9,2,car,crv,248,759,448,745,511,297,0.96054053,20,,2,0.3657094594594595,
10,2,car,crv,251,754,443,743,503,300,0.96310854,20,,2,1.24,
11,2,car,crv,117,1318,387,822,1201,435,0.42310923,20,,2,1.2916666666666667,
12,2,car,crv,248,763,450,742,515,292,0.92204607,20,,2,1.2916666666666667,
13,2,car,crv,119,1311,391,813,1192,422,0.25885653,20,,2,1.25,
14,2,car,crv,246,752,446,739,506,293,0.95473194,20,,2,1.25,
15,2,car,crv,128,1304,388,815,1176,427,0.30647025,20,,2,1.28,
16,2,car,crv,251,758,443,746,507,303,0.93285924,20,,2,1.28,
17,2,car,crv,250,754,447,738,504,291,0.9767751,20,,2,1.24,
18,2,car,crv,109,1318,388,813,1209,425,0.32027155,20,,2,1.28,
19,2,car,crv,245,760,445,741,515,296,0.9680706,20,,2,1.28,
20,2,car,crv,127,1308,391,816,1181,425,0.2964813,20,,2,1.2916666666666667,
21,2,car,crv,250,757,447,742,507,295,0.9490655,20,,2,1.2916666666666667,
22,2,car,crv,125,1314,388,816,1189,428,0.42268884,20,,2,1.28,
23,2,car,crv,248,760,449,737,512,288,0.90941703,20,,2,1.28,
24,2,car,crv,129,1304,390,814,1175,424,0.26254445,20,,2,1.2916666666666667,
25,2,car,crv,252,755,447,740,503,293,0.94612926,20,,2,1.2916666666666667,
26,2,car,crv,114,1320,387,815,1206,428,0.30274954,20,,2,1.24,
27,2,car,crv,248,753,446,740,505,294,0.8954264,20,,2,1.24,
28,2,car,crv,127,1307,391,814,1180,423,0.278648,20,,2,0.35847457627118645,
29,2,car,crv,250,755,447,744,505,297,0.95984495,20,,2,0.35847457627118645,
30,2,car,crv,127,1302,386,816,1175,430,0.37110242,20,,2,1.28,
31,2,car,crv,246,757,444,747,511,303,0.96607155,20,,2,1.28,
32,2,car,crv,119,1307,387,816,1188,429,0.28644451,20,,2,0.3611111111111111,
33,2,car,crv,248,759,443,747,511,304,0.9593547,20,,2,0.3611111111111111,
34,2,car,crv,127,1306,389,820,1179,431,0.37050778,20,,2,1.24,
35,2,car,crv,252,758,449,742,506,293,0.9203835,20,,2,1.24,
36,2,car,crv,126,1306,387,819,1180,432,0.24266188,20,,2,0.36610169491525424,
37,2,car,crv,247,754,449,740,507,291,0.94762105,20,,2,0.36610169491525424,
38,2,car,crv,113,1317,388,815,1204,427,0.36209753,20,,2,1.24,
39,2,car,crv,247,755,446,738,508,292,0.93217456,20,,2,1.24,
40,2,car,crv,116,1312,386,813,1196,427,0.26130736,20,,2,0.35702341137123744,
41,2,car,crv,249,755,445,740,506,295,0.95275867,20,,2,0.35702341137123744,
42,2,car,crv,250,753,445,746,503,301,0.97777426,20,,2,1.24,
43,2,car,crv,117,1316,390,813,1199,423,0.30318785,20,,2,0.35279399499582986,
44,2,car,crv,239,759,447,740,520,293,0.956478,20,,2,0.35279399499582986,
45,2,car,crv,126,1307,387,813,1181,426,0.3400013,20,,2,1.24,
46,2,car,crv,250,757,446,745,507,299,0.93553233,20,,2,1.24,
47,2,car,crv,118,1316,385,817,1198,432,0.46192503,20,,2,1.24,
48,2,car,crv,242,760,449,744,518,295,0.9251644,20,,2,1.24,
49,2,car,crv,125,1310,389,811,1185,422,0.32076746,20,,2,0.3561181434599156,
50,2,car,crv,250,758,446,739,508,293,0.9462212,20,,2,0.3561181434599156,
51,2,car,crv,250,754,444,740,504,296,0.96969557,20,,2,1.24,
52,2,car,crv,113,1313,388,814,1200,426,0.2754978,20,,2,1.24,
53,2,car,crv,244,756,445,743,512,298,0.96916515,20,,2,1.24,
54,2,car,crv,123,1309,388,814,1186,426,0.2760011,20,,2,1.24,
55,2,car,crv,249,758,446,740,509,294,0.950518,20,,2,1.24,
56,2,car,crv,253,754,447,737,501,290,0.94723046,20,,2,1.24,
57,2,car,crv,121,1308,387,817,1187,430,0.21458383,20,,2,0.36225779275484415,
58,2,car,crv,250,754,447,740,504,293,0.9610552,20,,2,0.36225779275484415,
59,2,car,crv,119,1317,388,814,1198,426,0.4732625,20,,2,1.24,
60,2,car,crv,245,758,448,742,513,294,0.94409996,20,,2,1.24,
61,2,car,crv,121,1308,388,815,1187,427,0.21448645,20,,2,0.35973041280539175,
62,2,car,crv,249,753,445,746,504,301,0.9724925,20,,2,0.35973041280539175,
63,2,car,crv,135,1302,387,821,1167,434,0.35179994,20,,2,1.2916666666666667,
64,2,car,crv,250,760,450,741,510,291,0.8736024,20,,2,1.2916666666666667,
65,2,car,crv,117,1313,390,812,1196,422,0.32242462,20,,2,1.2916666666666667,
66,2,car,crv,243,759,447,742,516,295,0.9675998,20,,2,1.2916666666666667,
67,2,car,crv,122,1311,387,814,1189,427,0.36553156,20,,2,1.2916666666666667,
68,2,car,crv,250,757,444,744,507,300,0.9479286,20,,2,1.2916666666666667,
69,2,car,crv,115,1321,388,815,1206,427,0.3674716,20,,2,1.24,
70,2,car,crv,248,756,446,740,508,294,0.92142504,20,,2,1.24,
71,2,car,crv,109,1315,384,827,1206,443,0.2820505,20,,2,1.24,
72,2,car,crv,249,758,449,736,509,287,0.91024953,20,,2,1.24,
73,2,car,crv,122,1310,388,817,1188,429,0.29904467,20,,2,0.3611111111111111,
74,2,car,crv,250,760,448,741,510,293,0.927252,20,,2,0.3611111111111111,
75,2,car,crv,129,1303,389,814,1174,425,0.27334884,20,,2,1.28,
76,2,car,crv,247,760,448,741,513,293,0.9333165,20,,2,1.28,
77,2,car,crv,122,1311,385,813,1189,428,0.35830083,20,,2,1.24,
78,2,car,crv,246,757,442,746,511,304,0.9668414,20,,2,1.24,
79,2,car,crv,122,1312,391,808,1190,417,0.34383425,20,,2,1.28,
80,2,car,crv,248,755,446,741,507,295,0.90284395,20,,2,1.28,
81,2,car,crv,129,1303,386,819,1174,433,0.2341652,20,,2,0.368824531516184,
82,2,car,crv,252,756,447,744,504,297,0.9354642,20,,2,0.368824531516184,
83,2,car,crv,253,756,446,744,503,298,0.97629297,20,,2,1.24,
84,2,car,crv,128,1307,388,817,1179,429,0.32914877,20,,2,1.2916666666666667,
85,2,car,crv,247,762,447,741,515,294,0.9441378,20,,2,1.2916666666666667,
86,2,car,crv,117,1313,388,818,1196,430,0.27251616,20,,2,0.3595317725752508,
87,2,car,crv,247,762,449,740,515,291,0.96550846,20,,2,0.3595317725752508,
88,2,car,crv,124,1305,387,820,1181,433,0.27402008,20,,2,0.36663844199830653,
89,2,car,crv,252,750,447,746,498,299,0.9501165,20,,2,0.36663844199830653,
90,2,car,crv,111,1317,390,812,1206,422,0.27479288,20,,2,0.34991708126036486,
91,2,car,crv,251,753,447,740,502,293,0.9438285,20,,2,0.34991708126036486,
92,2,car,crv,126,1309,390,814,1183,424,0.30222148,20,,2,1.2916666666666667,
93,2,car,crv,249,757,448,740,508,292,0.91383094,20,,2,1.2916666666666667,
94,2,car,crv,111,1317,390,811,1206,421,0.2941505,20,,2,0.3490878938640133,
95,2,car,crv,247,756,446,741,509,295,0.96245986,20,,2,0.3490878938640133,
96,2,car,crv,134,1300,387,818,1166,431,0.35928637,20,,2,1.28,
97,2,car,crv,251,757,447,743,506,296,0.9412378,20,,2,1.28,
98,2,car,crv,126,1312,388,815,1186,427,0.3965622,20,,2,1.24,
99,2,car,crv,252,758,446,743,506,297,0.9420341,20,,2,1.24,
100,2,car,crv,121,1316,389,809,1195,420,0.4096516,20,,2,1.24,
101,2,car,crv,244,761,447,742,517,295,0.9289579,20,,2,1.24,
102,2,car,crv,125,1312,392,805,1187,413,0.30284005,20,,2,1.24,
103,2,car,crv,245,760,447,739,515,292,0.9596912,20,,2,1.24,
104,2,car,crv,131,1307,388,812,1176,424,0.43397242,20,,2,1.2916666666666667,
105,2,car,crv,247,764,447,744,517,297,0.9014591,20,,2,1.2916666666666667,
106,2,car,crv,123,1315,388,811,1192,423,0.4968379,20,,2,1.24,
107,2,car,crv,246,758,446,743,512,297,0.87933147,20,,2,1.24,
108,2,car,crv,118,1312,389,813,1194,424,0.25691053,20,,2,0.35510887772194305,
109,2,car,crv,249,756,447,742,507,295,0.96910256,20,,2,0.35510887772194305,
110,2,car,crv,118,1319,389,813,1201,424,0.4023961,20,,2,1.28,
111,2,car,crv,243,757,448,743,514,295,0.94143236,20,,2,1.28,
112,2,car,crv,119,1322,385,815,1203,430,0.42900166,20,,2,1.24,
113,2,car,crv,246,762,447,741,516,294,0.790523,20,,2,1.24,
114,2,car,crv,119,1319,386,815,1200,429,0.44753623,20,,2,1.28,
115,2,car,crv,248,759,450,741,511,291,0.8263495,20,,2,1.28,
116,2,car,crv,114,1318,387,813,1204,426,0.43434885,20,,2,1.2916666666666667,
117,2,car,crv,246,759,446,744,513,298,0.9186257,20,,2,1.2916666666666667,
118,2,car,crv,119,1325,389,808,1206,419,0.46840343,20,,2,1.24,
119,2,car,crv,244,759,447,741,515,294,0.83414143,20,,2,1.24,
120,2,car,crv,116,1322,388,811,1206,423,0.44209528,20,,2,1.28,
121,2,car,crv,241,764,450,741,523,291,0.8834957,20,,2,1.28,
122,2,car,crv,334,710,446,701,376,255,0.92716336,3,0,2,0.6781914893617021,
123,2,car,crv,336,711,446,700,375,254,0.9036748,3,0,2,0.6773333333333333,
124,2,car,crv,335,709,444,701,374,257,0.9452533,3,0,2,0.6871657754010695,
0,2,car,crv,127,1305,390,811,1178,421,0.25976446,20,,2,0.35738539898132426,
1,2,car,crv,250,757,443,743,507,300,0.9547171,20,,2,0.35738539898132426,
2,2,car,crv,123,1309,392,810,1186,418,0.28978387,20,,2,1.24,
3,2,car,crv,248,758,446,738,510,292,0.96847486,20,,2,1.24,
4,2,car,crv,123,1304,388,814,1181,426,0.2588897,20,,2,0.3607112616426757,
5,2,car,crv,250,759,447,742,509,295,0.9416412,20,,2,0.3607112616426757,
6,2,car,crv,130,1306,391,810,1176,419,0.26097575,20,,2,0.3562925170068027,
7,2,car,crv,250,756,447,739,506,292,0.95065075,20,,2,0.3562925170068027,
8,2,car,crv,123,1309,389,813,1186,424,0.31858423,20,,2,1.24,
9,2,car,crv,248,758,447,745,510,298,0.9534346,20,,2,1.24,
10,2,car,crv,121,1305,386,819,1184,433,0.24762785,20,,2,0.3657094594594595,
11,2,car,crv,248,759,448,745,511,297,0.96054053,20,,2,0.3657094594594595,
12,2,car,crv,251,754,443,743,503,300,0.96310854,20,,2,1.24,
13,2,car,crv,117,1318,387,822,1201,435,0.42310923,20,,2,1.2916666666666667,
14,2,car,crv,248,763,450,742,515,292,0.92204607,20,,2,1.2916666666666667,
15,2,car,crv,119,1311,391,813,1192,422,0.25885653,20,,2,1.25,
16,2,car,crv,246,752,446,739,506,293,0.95473194,20,,2,1.25,
17,2,car,crv,128,1304,388,815,1176,427,0.30647025,20,,2,1.28,
18,2,car,crv,251,758,443,746,507,303,0.93285924,20,,2,1.28,
19,2,car,crv,250,754,447,738,504,291,0.9767751,20,,2,1.24,
20,2,car,crv,109,1318,388,813,1209,425,0.32027155,20,,2,1.28,
21,2,car,crv,245,760,445,741,515,296,0.9680706,20,,2,1.28,
22,2,car,crv,127,1308,391,816,1181,425,0.2964813,20,,2,1.2916666666666667,
23,2,car,crv,250,757,447,742,507,295,0.9490655,20,,2,1.2916666666666667,
24,2,car,crv,125,1314,388,816,1189,428,0.42268884,20,,2,1.28,
25,2,car,crv,248,760,449,737,512,288,0.90941703,20,,2,1.28,
26,2,car,crv,129,1304,390,814,1175,424,0.26254445,20,,2,1.2916666666666667,
27,2,car,crv,252,755,447,740,503,293,0.94612926,20,,2,1.2916666666666667,
28,2,car,crv,114,1320,387,815,1206,428,0.30274954,20,,2,1.24,
29,2,car,crv,248,753,446,740,505,294,0.8954264,20,,2,1.24,
30,2,car,crv,127,1307,391,814,1180,423,0.278648,20,,2,0.35847457627118645,
31,2,car,crv,250,755,447,744,505,297,0.95984495,20,,2,0.35847457627118645,
32,2,car,crv,127,1302,386,816,1175,430,0.37110242,20,,2,1.28,
33,2,car,crv,246,757,444,747,511,303,0.96607155,20,,2,1.28,
34,2,car,crv,119,1307,387,816,1188,429,0.28644451,20,,2,0.3611111111111111,
35,2,car,crv,248,759,443,747,511,304,0.9593547,20,,2,0.3611111111111111,
36,2,car,crv,127,1306,389,820,1179,431,0.37050778,20,,2,1.24,
37,2,car,crv,252,758,449,742,506,293,0.9203835,20,,2,1.24,
38,2,car,crv,126,1306,387,819,1180,432,0.24266188,20,,2,0.36610169491525424,
39,2,car,crv,247,754,449,740,507,291,0.94762105,20,,2,0.36610169491525424,
40,2,car,crv,113,1317,388,815,1204,427,0.36209753,20,,2,1.24,
41,2,car,crv,247,755,446,738,508,292,0.93217456,20,,2,1.24,
42,2,car,crv,116,1312,386,813,1196,427,0.26130736,20,,2,0.35702341137123744,
43,2,car,crv,249,755,445,740,506,295,0.95275867,20,,2,0.35702341137123744,
44,2,car,crv,250,753,445,746,503,301,0.97777426,20,,2,1.24,
45,2,car,crv,117,1316,390,813,1199,423,0.30318785,20,,2,0.35279399499582986,
46,2,car,crv,239,759,447,740,520,293,0.956478,20,,2,0.35279399499582986,
47,2,car,crv,126,1307,387,813,1181,426,0.3400013,20,,2,1.24,
48,2,car,crv,250,757,446,745,507,299,0.93553233,20,,2,1.24,
49,2,car,crv,118,1316,385,817,1198,432,0.46192503,20,,2,1.24,
50,2,car,crv,242,760,449,744,518,295,0.9251644,20,,2,1.24,
51,2,car,crv,125,1310,389,811,1185,422,0.32076746,20,,2,0.3561181434599156,
52,2,car,crv,250,758,446,739,508,293,0.9462212,20,,2,0.3561181434599156,
53,2,car,crv,250,754,444,740,504,296,0.96969557,20,,2,1.24,
54,2,car,crv,113,1313,388,814,1200,426,0.2754978,20,,2,1.24,
55,2,car,crv,244,756,445,743,512,298,0.96916515,20,,2,1.24,
56,2,car,crv,123,1309,388,814,1186,426,0.2760011,20,,2,1.24,
57,2,car,crv,249,758,446,740,509,294,0.950518,20,,2,1.24,
58,2,car,crv,253,754,447,737,501,290,0.94723046,20,,2,1.24,
59,2,car,crv,121,1308,387,817,1187,430,0.21458383,20,,2,0.36225779275484415,
60,2,car,crv,250,754,447,740,504,293,0.9610552,20,,2,0.36225779275484415,
61,2,car,crv,119,1317,388,814,1198,426,0.4732625,20,,2,1.24,
62,2,car,crv,245,758,448,742,513,294,0.94409996,20,,2,1.24,
63,2,car,crv,121,1308,388,815,1187,427,0.21448645,20,,2,0.35973041280539175,
64,2,car,crv,249,753,445,746,504,301,0.9724925,20,,2,0.35973041280539175,
65,2,car,crv,135,1302,387,821,1167,434,0.35179994,20,,2,1.2916666666666667,
66,2,car,crv,250,760,450,741,510,291,0.8736024,20,,2,1.2916666666666667,
67,2,car,crv,117,1313,390,812,1196,422,0.32242462,20,,2,1.2916666666666667,
68,2,car,crv,243,759,447,742,516,295,0.9675998,20,,2,1.2916666666666667,
69,2,car,crv,122,1311,387,814,1189,427,0.36553156,20,,2,1.2916666666666667,
70,2,car,crv,250,757,444,744,507,300,0.9479286,20,,2,1.2916666666666667,
71,2,car,crv,115,1321,388,815,1206,427,0.3674716,20,,2,1.24,
72,2,car,crv,248,756,446,740,508,294,0.92142504,20,,2,1.24,
73,2,car,crv,109,1315,384,827,1206,443,0.2820505,20,,2,1.24,
74,2,car,crv,249,758,449,736,509,287,0.91024953,20,,2,1.24,
75,2,car,crv,122,1310,388,817,1188,429,0.29904467,20,,2,0.3611111111111111,
76,2,car,crv,250,760,448,741,510,293,0.927252,20,,2,0.3611111111111111,
77,2,car,crv,129,1303,389,814,1174,425,0.27334884,20,,2,1.28,
78,2,car,crv,247,760,448,741,513,293,0.9333165,20,,2,1.28,
79,2,car,crv,122,1311,385,813,1189,428,0.35830083,20,,2,1.24,
80,2,car,crv,246,757,442,746,511,304,0.9668414,20,,2,1.24,
81,2,car,crv,122,1312,391,808,1190,417,0.34383425,20,,2,1.28,
82,2,car,crv,248,755,446,741,507,295,0.90284395,20,,2,1.28,
83,2,car,crv,129,1303,386,819,1174,433,0.2341652,20,,2,0.368824531516184,
84,2,car,crv,252,756,447,744,504,297,0.9354642,20,,2,0.368824531516184,
85,2,car,crv,253,756,446,744,503,298,0.97629297,20,,2,1.24,
86,2,car,crv,128,1307,388,817,1179,429,0.32914877,20,,2,1.2916666666666667,
87,2,car,crv,247,762,447,741,515,294,0.9441378,20,,2,1.2916666666666667,
88,2,car,crv,117,1313,388,818,1196,430,0.27251616,20,,2,0.3595317725752508,
89,2,car,crv,247,762,449,740,515,291,0.96550846,20,,2,0.3595317725752508,
90,2,car,crv,124,1305,387,820,1181,433,0.27402008,20,,2,0.36663844199830653,
91,2,car,crv,252,750,447,746,498,299,0.9501165,20,,2,0.36663844199830653,
92,2,car,crv,111,1317,390,812,1206,422,0.27479288,20,,2,0.34991708126036486,
93,2,car,crv,251,753,447,740,502,293,0.9438285,20,,2,0.34991708126036486,
94,2,car,crv,126,1309,390,814,1183,424,0.30222148,20,,2,1.2916666666666667,
95,2,car,crv,249,757,448,740,508,292,0.91383094,20,,2,1.2916666666666667,
96,2,car,crv,111,1317,390,811,1206,421,0.2941505,20,,2,0.3490878938640133,
97,2,car,crv,247,756,446,741,509,295,0.96245986,20,,2,0.3490878938640133,
98,2,car,crv,134,1300,387,818,1166,431,0.35928637,20,,2,1.28,
99,2,car,crv,251,757,447,743,506,296,0.9412378,20,,2,1.28,
100,2,car,crv,126,1312,388,815,1186,427,0.3965622,20,,2,1.24,
101,2,car,crv,252,758,446,743,506,297,0.9420341,20,,2,1.24,
102,2,car,crv,121,1316,389,809,1195,420,0.4096516,20,,2,1.24,
103,2,car,crv,244,761,447,742,517,295,0.9289579,20,,2,1.24,
104,2,car,crv,125,1312,392,805,1187,413,0.30284005,20,,2,1.24,
105,2,car,crv,245,760,447,739,515,292,0.9596912,20,,2,1.24,
106,2,car,crv,131,1307,388,812,1176,424,0.43397242,20,,2,1.2916666666666667,
107,2,car,crv,247,764,447,744,517,297,0.9014591,20,,2,1.2916666666666667,
108,2,car,crv,123,1315,388,811,1192,423,0.4968379,20,,2,1.24,
109,2,car,crv,246,758,446,743,512,297,0.87933147,20,,2,1.24,
110,2,car,crv,118,1312,389,813,1194,424,0.25691053,20,,2,0.35510887772194305,
111,2,car,crv,249,756,447,742,507,295,0.96910256,20,,2,0.35510887772194305,
112,2,car,crv,118,1319,389,813,1201,424,0.4023961,20,,2,1.28,
113,2,car,crv,243,757,448,743,514,295,0.94143236,20,,2,1.28,
114,2,car,crv,119,1322,385,815,1203,430,0.42900166,20,,2,1.24,
115,2,car,crv,246,762,447,741,516,294,0.790523,20,,2,1.24,
116,2,car,crv,119,1319,386,815,1200,429,0.44753623,20,,2,1.28,
117,2,car,crv,248,759,450,741,511,291,0.8263495,20,,2,1.28,
118,2,car,crv,114,1318,387,813,1204,426,0.43434885,20,,2,1.2916666666666667,
119,2,car,crv,246,759,446,744,513,298,0.9186257,20,,2,1.2916666666666667,
120,2,car,crv,119,1325,389,808,1206,419,0.46840343,20,,2,1.24,
121,2,car,crv,244,759,447,741,515,294,0.83414143,20,,2,1.24,
122,2,car,crv,116,1322,388,811,1206,423,0.44209528,20,,2,1.28,
123,2,car,crv,241,764,450,741,523,291,0.8834957,20,,2,1.28,
124,2,car,crv,334,710,446,701,376,255,0.92716336,3,0,2,0.6781914893617021,
125,2,car,crv,336,711,446,700,375,254,0.9036748,3,0,2,0.6773333333333333,
126,2,car,crv,335,709,444,701,374,257,0.9452533,3,0,2,0.6871657754010695,
0,2,car,crv,130,1307,389,819,1177,430,0.2569041,20,,2,1.24,
1,2,car,crv,256,753,448,740,497,292,0.955823,20,,2,1.24,
2,2,car,crv,127,1305,390,811,1178,421,0.25976446,20,,2,0.35738539898132426,
3,2,car,crv,250,757,443,743,507,300,0.9547171,20,,2,0.35738539898132426,
4,2,car,crv,123,1309,392,810,1186,418,0.28978387,20,,2,1.24,
5,2,car,crv,248,758,446,738,510,292,0.96847486,20,,2,1.24,
6,2,car,crv,123,1304,388,814,1181,426,0.2588897,20,,2,0.3607112616426757,
7,2,car,crv,250,759,447,742,509,295,0.9416412,20,,2,0.3607112616426757,
8,2,car,crv,130,1306,391,810,1176,419,0.26097575,20,,2,0.3562925170068027,
9,2,car,crv,250,756,447,739,506,292,0.95065075,20,,2,0.3562925170068027,
10,2,car,crv,123,1309,389,813,1186,424,0.31858423,20,,2,1.24,
11,2,car,crv,248,758,447,745,510,298,0.9534346,20,,2,1.24,
12,2,car,crv,121,1305,386,819,1184,433,0.24762785,20,,2,0.3657094594594595,
13,2,car,crv,248,759,448,745,511,297,0.96054053,20,,2,0.3657094594594595,
14,2,car,crv,251,754,443,743,503,300,0.96310854,20,,2,1.24,
15,2,car,crv,117,1318,387,822,1201,435,0.42310923,20,,2,1.2916666666666667,
16,2,car,crv,248,763,450,742,515,292,0.92204607,20,,2,1.2916666666666667,
17,2,car,crv,119,1311,391,813,1192,422,0.25885653,20,,2,1.25,
18,2,car,crv,246,752,446,739,506,293,0.95473194,20,,2,1.25,
19,2,car,crv,128,1304,388,815,1176,427,0.30647025,20,,2,1.28,
20,2,car,crv,251,758,443,746,507,303,0.93285924,20,,2,1.28,
21,2,car,crv,250,754,447,738,504,291,0.9767751,20,,2,1.24,
22,2,car,crv,109,1318,388,813,1209,425,0.32027155,20,,2,1.28,
23,2,car,crv,245,760,445,741,515,296,0.9680706,20,,2,1.28,
24,2,car,crv,127,1308,391,816,1181,425,0.2964813,20,,2,1.2916666666666667,
25,2,car,crv,250,757,447,742,507,295,0.9490655,20,,2,1.2916666666666667,
26,2,car,crv,125,1314,388,816,1189,428,0.42268884,20,,2,1.28,
27,2,car,crv,248,760,449,737,512,288,0.90941703,20,,2,1.28,
28,2,car,crv,129,1304,390,814,1175,424,0.26254445,20,,2,1.2916666666666667,
29,2,car,crv,252,755,447,740,503,293,0.94612926,20,,2,1.2916666666666667,
30,2,car,crv,114,1320,387,815,1206,428,0.30274954,20,,2,1.24,
31,2,car,crv,248,753,446,740,505,294,0.8954264,20,,2,1.24,
32,2,car,crv,127,1307,391,814,1180,423,0.278648,20,,2,0.35847457627118645,
33,2,car,crv,250,755,447,744,505,297,0.95984495,20,,2,0.35847457627118645,
34,2,car,crv,127,1302,386,816,1175,430,0.37110242,20,,2,1.28,
35,2,car,crv,246,757,444,747,511,303,0.96607155,20,,2,1.28,
36,2,car,crv,119,1307,387,816,1188,429,0.28644451,20,,2,0.3611111111111111,
37,2,car,crv,248,759,443,747,511,304,0.9593547,20,,2,0.3611111111111111,
38,2,car,crv,127,1306,389,820,1179,431,0.37050778,20,,2,1.24,
39,2,car,crv,252,758,449,742,506,293,0.9203835,20,,2,1.24,
40,2,car,crv,126,1306,387,819,1180,432,0.24266188,20,,2,0.36610169491525424,
41,2,car,crv,247,754,449,740,507,291,0.94762105,20,,2,0.36610169491525424,
42,2,car,crv,113,1317,388,815,1204,427,0.36209753,20,,2,1.24,
43,2,car,crv,247,755,446,738,508,292,0.93217456,20,,2,1.24,
44,2,car,crv,116,1312,386,813,1196,427,0.26130736,20,,2,0.35702341137123744,
45,2,car,crv,249,755,445,740,506,295,0.95275867,20,,2,0.35702341137123744,
46,2,car,crv,250,753,445,746,503,301,0.97777426,20,,2,1.24,
47,2,car,crv,117,1316,390,813,1199,423,0.30318785,20,,2,0.35279399499582986,
48,2,car,crv,239,759,447,740,520,293,0.956478,20,,2,0.35279399499582986,
49,2,car,crv,126,1307,387,813,1181,426,0.3400013,20,,2,1.24,
50,2,car,crv,250,757,446,745,507,299,0.93553233,20,,2,1.24,
51,2,car,crv,118,1316,385,817,1198,432,0.46192503,20,,2,1.24,
52,2,car,crv,242,760,449,744,518,295,0.9251644,20,,2,1.24,
53,2,car,crv,125,1310,389,811,1185,422,0.32076746,20,,2,0.3561181434599156,
54,2,car,crv,250,758,446,739,508,293,0.9462212,20,,2,0.3561181434599156,
55,2,car,crv,250,754,444,740,504,296,0.96969557,20,,2,1.24,
56,2,car,crv,113,1313,388,814,1200,426,0.2754978,20,,2,1.24,
57,2,car,crv,244,756,445,743,512,298,0.96916515,20,,2,1.24,
58,2,car,crv,123,1309,388,814,1186,426,0.2760011,20,,2,1.24,
59,2,car,crv,249,758,446,740,509,294,0.950518,20,,2,1.24,
60,2,car,crv,253,754,447,737,501,290,0.94723046,20,,2,1.24,
61,2,car,crv,121,1308,387,817,1187,430,0.21458383,20,,2,0.36225779275484415,
62,2,car,crv,250,754,447,740,504,293,0.9610552,20,,2,0.36225779275484415,
63,2,car,crv,119,1317,388,814,1198,426,0.4732625,20,,2,1.24,
64,2,car,crv,245,758,448,742,513,294,0.94409996,20,,2,1.24,
65,2,car,crv,121,1308,388,815,1187,427,0.21448645,20,,2,0.35973041280539175,
66,2,car,crv,249,753,445,746,504,301,0.9724925,20,,2,0.35973041280539175,
67,2,car,crv,135,1302,387,821,1167,434,0.35179994,20,,2,1.2916666666666667,
68,2,car,crv,250,760,450,741,510,291,0.8736024,20,,2,1.2916666666666667,
69,2,car,crv,117,1313,390,812,1196,422,0.32242462,20,,2,1.2916666666666667,
70,2,car,crv,243,759,447,742,516,295,0.9675998,20,,2,1.2916666666666667,
71,2,car,crv,122,1311,387,814,1189,427,0.36553156,20,,2,1.2916666666666667,
72,2,car,crv,250,757,444,744,507,300,0.9479286,20,,2,1.2916666666666667,
73,2,car,crv,115,1321,388,815,1206,427,0.3674716,20,,2,1.24,
74,2,car,crv,248,756,446,740,508,294,0.92142504,20,,2,1.24,
75,2,car,crv,109,1315,384,827,1206,443,0.2820505,20,,2,1.24,
76,2,car,crv,249,758,449,736,509,287,0.91024953,20,,2,1.24,
77,2,car,crv,122,1310,388,817,1188,429,0.29904467,20,,2,0.3611111111111111,
78,2,car,crv,250,760,448,741,510,293,0.927252,20,,2,0.3611111111111111,
79,2,car,crv,129,1303,389,814,1174,425,0.27334884,20,,2,1.28,
80,2,car,crv,247,760,448,741,513,293,0.9333165,20,,2,1.28,
81,2,car,crv,122,1311,385,813,1189,428,0.35830083,20,,2,1.24,
82,2,car,crv,246,757,442,746,511,304,0.9668414,20,,2,1.24,
83,2,car,crv,122,1312,391,808,1190,417,0.34383425,20,,2,1.28,
84,2,car,crv,248,755,446,741,507,295,0.90284395,20,,2,1.28,
85,2,car,crv,129,1303,386,819,1174,433,0.2341652,20,,2,0.368824531516184,
86,2,car,crv,252,756,447,744,504,297,0.9354642,20,,2,0.368824531516184,
87,2,car,crv,253,756,446,744,503,298,0.97629297,20,,2,1.24,
88,2,car,crv,128,1307,388,817,1179,429,0.32914877,20,,2,1.2916666666666667,
89,2,car,crv,247,762,447,741,515,294,0.9441378,20,,2,1.2916666666666667,
90,2,car,crv,117,1313,388,818,1196,430,0.27251616,20,,2,0.3595317725752508,
91,2,car,crv,247,762,449,740,515,291,0.96550846,20,,2,0.3595317725752508,
92,2,car,crv,124,1305,387,820,1181,433,0.27402008,20,,2,0.36663844199830653,
93,2,car,crv,252,750,447,746,498,299,0.9501165,20,,2,0.36663844199830653,
94,2,car,crv,111,1317,390,812,1206,422,0.27479288,20,,2,0.34991708126036486,
95,2,car,crv,251,753,447,740,502,293,0.9438285,20,,2,0.34991708126036486,
96,2,car,crv,126,1309,390,814,1183,424,0.30222148,20,,2,1.2916666666666667,
97,2,car,crv,249,757,448,740,508,292,0.91383094,20,,2,1.2916666666666667,
98,2,car,crv,111,1317,390,811,1206,421,0.2941505,20,,2,0.3490878938640133,
99,2,car,crv,247,756,446,741,509,295,0.96245986,20,,2,0.3490878938640133,
100,2,car,crv,134,1300,387,818,1166,431,0.35928637,20,,2,1.28,
101,2,car,crv,251,757,447,743,506,296,0.9412378,20,,2,1.28,
102,2,car,crv,126,1312,388,815,1186,427,0.3965622,20,,2,1.24,
103,2,car,crv,252,758,446,743,506,297,0.9420341,20,,2,1.24,
104,2,car,crv,121,1316,389,809,1195,420,0.4096516,20,,2,1.24,
105,2,car,crv,244,761,447,742,517,295,0.9289579,20,,2,1.24,
106,2,car,crv,125,1312,392,805,1187,413,0.30284005,20,,2,1.24,
107,2,car,crv,245,760,447,739,515,292,0.9596912,20,,2,1.24,
108,2,car,crv,131,1307,388,812,1176,424,0.43397242,20,,2,1.2916666666666667,
109,2,car,crv,247,764,447,744,517,297,0.9014591,20,,2,1.2916666666666667,
110,2,car,crv,123,1315,388,811,1192,423,0.4968379,20,,2,1.24,
111,2,car,crv,246,758,446,743,512,297,0.87933147,20,,2,1.24,
112,2,car,crv,118,1312,389,813,1194,424,0.25691053,20,,2,0.35510887772194305,
113,2,car,crv,249,756,447,742,507,295,0.96910256,20,,2,0.35510887772194305,
114,2,car,crv,118,1319,389,813,1201,424,0.4023961,20,,2,1.28,
115,2,car,crv,243,757,448,743,514,295,0.94143236,20,,2,1.28,
116,2,car,crv,119,1322,385,815,1203,430,0.42900166,20,,2,1.24,
117,2,car,crv,246,762,447,741,516,294,0.790523,20,,2,1.24,
118,2,car,crv,119,1319,386,815,1200,429,0.44753623,20,,2,1.28,
119,2,car,crv,248,759,450,741,511,291,0.8263495,20,,2,1.28,
120,2,car,crv,114,1318,387,813,1204,426,0.43434885,20,,2,1.2916666666666667,
121,2,car,crv,246,759,446,744,513,298,0.9186257,20,,2,1.2916666666666667,
122,2,car,crv,119,1325,389,808,1206,419,0.46840343,20,,2,1.24,
123,2,car,crv,244,759,447,741,515,294,0.83414143,20,,2,1.24,
124,2,car,crv,116,1322,388,811,1206,423,0.44209528,20,,2,1.28,
125,2,car,crv,241,764,450,741,523,291,0.8834957,20,,2,1.28,
126,2,car,crv,334,710,446,701,376,255,0.92716336,3,0,2,0.6781914893617021,
127,2,car,crv,336,711,446,700,375,254,0.9036748,3,0,2,0.6773333333333333,
128,2,car,crv,335,709,444,701,374,257,0.9452533,3,0,2,0.6871657754010695,
0,2,car,crv,131,1305,389,817,1174,428,0.29075116,20,,2,0.3645655877342419,
1,2,car,crv,252,754,448,743,502,295,0.94248277,20,,2,0.3645655877342419,
2,2,car,crv,130,1307,389,819,1177,430,0.2569041,20,,2,1.24,
3,2,car,crv,256,753,448,740,497,292,0.955823,20,,2,1.24,
4,2,car,crv,127,1305,390,811,1178,421,0.25976446,20,,2,0.35738539898132426,
5,2,car,crv,250,757,443,743,507,300,0.9547171,20,,2,0.35738539898132426,
6,2,car,crv,123,1309,392,810,1186,418,0.28978387,20,,2,1.24,
7,2,car,crv,248,758,446,738,510,292,0.96847486,20,,2,1.24,
8,2,car,crv,123,1304,388,814,1181,426,0.2588897,20,,2,0.3607112616426757,
9,2,car,crv,250,759,447,742,509,295,0.9416412,20,,2,0.3607112616426757,
10,2,car,crv,130,1306,391,810,1176,419,0.26097575,20,,2,0.3562925170068027,
11,2,car,crv,250,756,447,739,506,292,0.95065075,20,,2,0.3562925170068027,
12,2,car,crv,123,1309,389,813,1186,424,0.31858423,20,,2,1.24,
13,2,car,crv,248,758,447,745,510,298,0.9534346,20,,2,1.24,
14,2,car,crv,121,1305,386,819,1184,433,0.24762785,20,,2,0.3657094594594595,
15,2,car,crv,248,759,448,745,511,297,0.96054053,20,,2,0.3657094594594595,
16,2,car,crv,251,754,443,743,503,300,0.96310854,20,,2,1.24,
17,2,car,crv,117,1318,387,822,1201,435,0.42310923,20,,2,1.2916666666666667,
18,2,car,crv,248,763,450,742,515,292,0.92204607,20,,2,1.2916666666666667,
19,2,car,crv,119,1311,391,813,1192,422,0.25885653,20,,2,1.25,
20,2,car,crv,246,752,446,739,506,293,0.95473194,20,,2,1.25,
21,2,car,crv,128,1304,388,815,1176,427,0.30647025,20,,2,1.28,
22,2,car,crv,251,758,443,746,507,303,0.93285924,20,,2,1.28,
23,2,car,crv,250,754,447,738,504,291,0.9767751,20,,2,1.24,
24,2,car,crv,109,1318,388,813,1209,425,0.32027155,20,,2,1.28,
25,2,car,crv,245,760,445,741,515,296,0.9680706,20,,2,1.28,
26,2,car,crv,127,1308,391,816,1181,425,0.2964813,20,,2,1.2916666666666667,
27,2,car,crv,250,757,447,742,507,295,0.9490655,20,,2,1.2916666666666667,
28,2,car,crv,125,1314,388,816,1189,428,0.42268884,20,,2,1.28,
29,2,car,crv,248,760,449,737,512,288,0.90941703,20,,2,1.28,
30,2,car,crv,129,1304,390,814,1175,424,0.26254445,20,,2,1.2916666666666667,
31,2,car,crv,252,755,447,740,503,293,0.94612926,20,,2,1.2916666666666667,
32,2,car,crv,114,1320,387,815,1206,428,0.30274954,20,,2,1.24,
33,2,car,crv,248,753,446,740,505,294,0.8954264,20,,2,1.24,
34,2,car,crv,127,1307,391,814,1180,423,0.278648,20,,2,0.35847457627118645,
35,2,car,crv,250,755,447,744,505,297,0.95984495,20,,2,0.35847457627118645,
36,2,car,crv,127,1302,386,816,1175,430,0.37110242,20,,2,1.28,
37,2,car,crv,246,757,444,747,511,303,0.96607155,20,,2,1.28,
38,2,car,crv,119,1307,387,816,1188,429,0.28644451,20,,2,0.3611111111111111,
39,2,car,crv,248,759,443,747,511,304,0.9593547,20,,2,0.3611111111111111,
40,2,car,crv,127,1306,389,820,1179,431,0.37050778,20,,2,1.24,
41,2,car,crv,252,758,449,742,506,293,0.9203835,20,,2,1.24,
42,2,car,crv,126,1306,387,819,1180,432,0.24266188,20,,2,0.36610169491525424,
43,2,car,crv,247,754,449,740,507,291,0.94762105,20,,2,0.36610169491525424,
44,2,car,crv,113,1317,388,815,1204,427,0.36209753,20,,2,1.24,
45,2,car,crv,247,755,446,738,508,292,0.93217456,20,,2,1.24,
46,2,car,crv,116,1312,386,813,1196,427,0.26130736,20,,2,0.35702341137123744,
47,2,car,crv,249,755,445,740,506,295,0.95275867,20,,2,0.35702341137123744,
48,2,car,crv,250,753,445,746,503,301,0.97777426,20,,2,1.24,
49,2,car,crv,117,1316,390,813,1199,423,0.30318785,20,,2,0.35279399499582986,
50,2,car,crv,239,759,447,740,520,293,0.956478,20,,2,0.35279399499582986,
51,2,car,crv,126,1307,387,813,1181,426,0.3400013,20,,2,1.24,
52,2,car,crv,250,757,446,745,507,299,0.93553233,20,,2,1.24,
53,2,car,crv,118,1316,385,817,1198,432,0.46192503,20,,2,1.24,
54,2,car,crv,242,760,449,744,518,295,0.9251644,20,,2,1.24,
55,2,car,crv,125,1310,389,811,1185,422,0.32076746,20,,2,0.3561181434599156,
56,2,car,crv,250,758,446,739,508,293,0.9462212,20,,2,0.3561181434599156,
57,2,car,crv,250,754,444,740,504,296,0.96969557,20,,2,1.24,
58,2,car,crv,113,1313,388,814,1200,426,0.2754978,20,,2,1.24,
59,2,car,crv,244,756,445,743,512,298,0.96916515,20,,2,1.24,
60,2,car,crv,123,1309,388,814,1186,426,0.2760011,20,,2,1.24,
61,2,car,crv,249,758,446,740,509,294,0.950518,20,,2,1.24,
62,2,car,crv,253,754,447,737,501,290,0.94723046,20,,2,1.24,
63,2,car,crv,121,1308,387,817,1187,430,0.21458383,20,,2,0.36225779275484415,
64,2,car,crv,250,754,447,740,504,293,0.9610552,20,,2,0.36225779275484415,
65,2,car,crv,119,1317,388,814,1198,426,0.4732625,20,,2,1.24,
66,2,car,crv,245,758,448,742,513,294,0.94409996,20,,2,1.24,
67,2,car,crv,121,1308,388,815,1187,427,0.21448645,20,,2,0.35973041280539175,
68,2,car,crv,249,753,445,746,504,301,0.9724925,20,,2,0.35973041280539175,
69,2,car,crv,135,1302,387,821,1167,434,0.35179994,20,,2,1.2916666666666667,
70,2,car,crv,250,760,450,741,510,291,0.8736024,20,,2,1.2916666666666667,
71,2,car,crv,117,1313,390,812,1196,422,0.32242462,20,,2,1.2916666666666667,
72,2,car,crv,243,759,447,742,516,295,0.9675998,20,,2,1.2916666666666667,
73,2,car,crv,122,1311,387,814,1189,427,0.36553156,20,,2,1.2916666666666667,
74,2,car,crv,250,757,444,744,507,300,0.9479286,20,,2,1.2916666666666667,
75,2,car,crv,115,1321,388,815,1206,427,0.3674716,20,,2,1.24,
76,2,car,crv,248,756,446,740,508,294,0.92142504,20,,2,1.24,
77,2,car,crv,109,1315,384,827,1206,443,0.2820505,20,,2,1.24,
78,2,car,crv,249,758,449,736,509,287,0.91024953,20,,2,1.24,
79,2,car,crv,122,1310,388,817,1188,429,0.29904467,20,,2,0.3611111111111111,
80,2,car,crv,250,760,448,741,510,293,0.927252,20,,2,0.3611111111111111,
81,2,car,crv,129,1303,389,814,1174,425,0.27334884,20,,2,1.28,
82,2,car,crv,247,760,448,741,513,293,0.9333165,20,,2,1.28,
83,2,car,crv,122,1311,385,813,1189,428,0.35830083,20,,2,1.24,
84,2,car,crv,246,757,442,746,511,304,0.9668414,20,,2,1.24,
85,2,car,crv,122,1312,391,808,1190,417,0.34383425,20,,2,1.28,
86,2,car,crv,248,755,446,741,507,295,0.90284395,20,,2,1.28,
87,2,car,crv,129,1303,386,819,1174,433,0.2341652,20,,2,0.368824531516184,
88,2,car,crv,252,756,447,744,504,297,0.9354642,20,,2,0.368824531516184,
89,2,car,crv,253,756,446,744,503,298,0.97629297,20,,2,1.24,
90,2,car,crv,128,1307,388,817,1179,429,0.32914877,20,,2,1.2916666666666667,
91,2,car,crv,247,762,447,741,515,294,0.9441378,20,,2,1.2916666666666667,
92,2,car,crv,117,1313,388,818,1196,430,0.27251616,20,,2,0.3595317725752508,
93,2,car,crv,247,762,449,740,515,291,0.96550846,20,,2,0.3595317725752508,
94,2,car,crv,124,1305,387,820,1181,433,0.27402008,20,,2,0.36663844199830653,
95,2,car,crv,252,750,447,746,498,299,0.9501165,20,,2,0.36663844199830653,
96,2,car,crv,111,1317,390,812,1206,422,0.27479288,20,,2,0.34991708126036486,
97,2,car,crv,251,753,447,740,502,293,0.9438285,20,,2,0.34991708126036486,
98,2,car,crv,126,1309,390,814,1183,424,0.30222148,20,,2,1.2916666666666667,
99,2,car,crv,249,757,448,740,508,292,0.91383094,20,,2,1.2916666666666667,
100,2,car,crv,111,1317,390,811,1206,421,0.2941505,20,,2,0.3490878938640133,
101,2,car,crv,247,756,446,741,509,295,0.96245986,20,,2,0.3490878938640133,
102,2,car,crv,134,1300,387,818,1166,431,0.35928637,20,,2,1.28,
103,2,car,crv,251,757,447,743,506,296,0.9412378,20,,2,1.28,
104,2,car,crv,126,1312,388,815,1186,427,0.3965622,20,,2,1.24,
105,2,car,crv,252,758,446,743,506,297,0.9420341,20,,2,1.24,
106,2,car,crv,121,1316,389,809,1195,420,0.4096516,20,,2,1.24,
107,2,car,crv,244,761,447,742,517,295,0.9289579,20,,2,1.24,
108,2,car,crv,125,1312,392,805,1187,413,0.30284005,20,,2,1.24,
109,2,car,crv,245,760,447,739,515,292,0.9596912,20,,2,1.24,
110,2,car,crv,131,1307,388,812,1176,424,0.43397242,20,,2,1.2916666666666667,
111,2,car,crv,247,764,447,744,517,297,0.9014591,20,,2,1.2916666666666667,
112,2,car,crv,123,1315,388,811,1192,423,0.4968379,20,,2,1.24,
113,2,car,crv,246,758,446,743,512,297,0.87933147,20,,2,1.24,
114,2,car,crv,118,1312,389,813,1194,424,0.25691053,20,,2,0.35510887772194305,
115,2,car,crv,249,756,447,742,507,295,0.96910256,20,,2,0.35510887772194305,
116,2,car,crv,118,1319,389,813,1201,424,0.4023961,20,,2,1.28,
117,2,car,crv,243,757,448,743,514,295,0.94143236,20,,2,1.28,
118,2,car,crv,119,1322,385,815,1203,430,0.42900166,20,,2,1.24,
119,2,car,crv,246,762,447,741,516,294,0.790523,20,,2,1.24,
120,2,car,crv,119,1319,386,815,1200,429,0.44753623,20,,2,1.28,
121,2,car,crv,248,759,450,741,511,291,0.8263495,20,,2,1.28,
122,2,car,crv,114,1318,387,813,1204,426,0.43434885,20,,2,1.2916666666666667,
123,2,car,crv,246,759,446,744,513,298,0.9186257,20,,2,1.2916666666666667,
124,2,car,crv,119,1325,389,808,1206,419,0.46840343,20,,2,1.24,
125,2,car,crv,244,759,447,741,515,294,0.83414143,20,,2,1.24,
126,2,car,crv,116,1322,388,811,1206,423,0.44209528,20,,2,1.28,
127,2,car,crv,241,764,450,741,523,291,0.8834957,20,,2,1.28,
128,2,car,crv,334,710,446,701,376,255,0.92716336,3,0,2,0.6781914893617021,
129,2,car,crv,336,711,446,700,375,254,0.9036748,3,0,2,0.6773333333333333,
130,2,car,crv,335,709,444,701,374,257,0.9452533,3,0,2,0.6871657754010695,
0,2,car,crv,121,1313,387,820,1192,433,0.26400292,20,,2,1.24,
1,2,car,crv,246,754,446,742,508,296,0.95298326,20,,2,1.24,
2,2,car,crv,131,1305,389,817,1174,428,0.29075116,20,,2,0.3645655877342419,
3,2,car,crv,252,754,448,743,502,295,0.94248277,20,,2,0.3645655877342419,
4,2,car,crv,130,1307,389,819,1177,430,0.2569041,20,,2,1.24,
5,2,car,crv,256,753,448,740,497,292,0.955823,20,,2,1.24,
6,2,car,crv,127,1305,390,811,1178,421,0.25976446,20,,2,0.35738539898132426,
7,2,car,crv,250,757,443,743,507,300,0.9547171,20,,2,0.35738539898132426,
8,2,car,crv,123,1309,392,810,1186,418,0.28978387,20,,2,1.24,
9,2,car,crv,248,758,446,738,510,292,0.96847486,20,,2,1.24,
10,2,car,crv,123,1304,388,814,1181,426,0.2588897,20,,2,0.3607112616426757,
11,2,car,crv,250,759,447,742,509,295,0.9416412,20,,2,0.3607112616426757,
12,2,car,crv,130,1306,391,810,1176,419,0.26097575,20,,2,0.3562925170068027,
13,2,car,crv,250,756,447,739,506,292,0.95065075,20,,2,0.3562925170068027,
14,2,car,crv,123,1309,389,813,1186,424,0.31858423,20,,2,1.24,
15,2,car,crv,248,758,447,745,510,298,0.9534346,20,,2,1.24,
16,2,car,crv,121,1305,386,819,1184,433,0.24762785,20,,2,0.3657094594594595,
17,2,car,crv,248,759,448,745,511,297,0.96054053,20,,2,0.3657094594594595,
18,2,car,crv,251,754,443,743,503,300,0.96310854,20,,2,1.24,
19,2,car,crv,117,1318,387,822,1201,435,0.42310923,20,,2,1.2916666666666667,
20,2,car,crv,248,763,450,742,515,292,0.92204607,20,,2,1.2916666666666667,
21,2,car,crv,119,1311,391,813,1192,422,0.25885653,20,,2,1.25,
22,2,car,crv,246,752,446,739,506,293,0.95473194,20,,2,1.25,
23,2,car,crv,128,1304,388,815,1176,427,0.30647025,20,,2,1.28,
24,2,car,crv,251,758,443,746,507,303,0.93285924,20,,2,1.28,
25,2,car,crv,250,754,447,738,504,291,0.9767751,20,,2,1.24,
26,2,car,crv,109,1318,388,813,1209,425,0.32027155,20,,2,1.28,
27,2,car,crv,245,760,445,741,515,296,0.9680706,20,,2,1.28,
28,2,car,crv,127,1308,391,816,1181,425,0.2964813,20,,2,1.2916666666666667,
29,2,car,crv,250,757,447,742,507,295,0.9490655,20,,2,1.2916666666666667,
30,2,car,crv,125,1314,388,816,1189,428,0.42268884,20,,2,1.28,
31,2,car,crv,248,760,449,737,512,288,0.90941703,20,,2,1.28,
32,2,car,crv,129,1304,390,814,1175,424,0.26254445,20,,2,1.2916666666666667,
33,2,car,crv,252,755,447,740,503,293,0.94612926,20,,2,1.2916666666666667,
34,2,car,crv,114,1320,387,815,1206,428,0.30274954,20,,2,1.24,
35,2,car,crv,248,753,446,740,505,294,0.8954264,20,,2,1.24,
36,2,car,crv,127,1307,391,814,1180,423,0.278648,20,,2,0.35847457627118645,
37,2,car,crv,250,755,447,744,505,297,0.95984495,20,,2,0.35847457627118645,
38,2,car,crv,127,1302,386,816,1175,430,0.37110242,20,,2,1.28,
39,2,car,crv,246,757,444,747,511,303,0.96607155,20,,2,1.28,
40,2,car,crv,119,1307,387,816,1188,429,0.28644451,20,,2,0.3611111111111111,
41,2,car,crv,248,759,443,747,511,304,0.9593547,20,,2,0.3611111111111111,
42,2,car,crv,127,1306,389,820,1179,431,0.37050778,20,,2,1.24,
43,2,car,crv,252,758,449,742,506,293,0.9203835,20,,2,1.24,
44,2,car,crv,126,1306,387,819,1180,432,0.24266188,20,,2,0.36610169491525424,
45,2,car,crv,247,754,449,740,507,291,0.94762105,20,,2,0.36610169491525424,
46,2,car,crv,113,1317,388,815,1204,427,0.36209753,20,,2,1.24,
47,2,car,crv,247,755,446,738,508,292,0.93217456,20,,2,1.24,
48,2,car,crv,116,1312,386,813,1196,427,0.26130736,20,,2,0.35702341137123744,
49,2,car,crv,249,755,445,740,506,295,0.95275867,20,,2,0.35702341137123744,
50,2,car,crv,250,753,445,746,503,301,0.97777426,20,,2,1.24,
51,2,car,crv,117,1316,390,813,1199,423,0.30318785,20,,2,0.35279399499582986,
52,2,car,crv,239,759,447,740,520,293,0.956478,20,,2,0.35279399499582986,
53,2,car,crv,126,1307,387,813,1181,426,0.3400013,20,,2,1.24,
54,2,car,crv,250,757,446,745,507,299,0.93553233,20,,2,1.24,
55,2,car,crv,118,1316,385,817,1198,432,0.46192503,20,,2,1.24,
56,2,car,crv,242,760,449,744,518,295,0.9251644,20,,2,1.24,
57,2,car,crv,125,1310,389,811,1185,422,0.32076746,20,,2,0.3561181434599156,
58,2,car,crv,250,758,446,739,508,293,0.9462212,20,,2,0.3561181434599156,
59,2,car,crv,250,754,444,740,504,296,0.96969557,20,,2,1.24,
60,2,car,crv,113,1313,388,814,1200,426,0.2754978,20,,2,1.24,
61,2,car,crv,244,756,445,743,512,298,0.96916515,20,,2,1.24,
62,2,car,crv,123,1309,388,814,1186,426,0.2760011,20,,2,1.24,
63,2,car,crv,249,758,446,740,509,294,0.950518,20,,2,1.24,
64,2,car,crv,253,754,447,737,501,290,0.94723046,20,,2,1.24,
65,2,car,crv,121,1308,387,817,1187,430,0.21458383,20,,2,0.36225779275484415,
66,2,car,crv,250,754,447,740,504,293,0.9610552,20,,2,0.36225779275484415,
67,2,car,crv,119,1317,388,814,1198,426,0.4732625,20,,2,1.24,
68,2,car,crv,245,758,448,742,513,294,0.94409996,20,,2,1.24,
69,2,car,crv,121,1308,388,815,1187,427,0.21448645,20,,2,0.35973041280539175,
70,2,car,crv,249,753,445,746,504,301,0.9724925,20,,2,0.35973041280539175,
71,2,car,crv,135,1302,387,821,1167,434,0.35179994,20,,2,1.2916666666666667,
72,2,car,crv,250,760,450,741,510,291,0.8736024,20,,2,1.2916666666666667,
73,2,car,crv,117,1313,390,812,1196,422,0.32242462,20,,2,1.2916666666666667,
74,2,car,crv,243,759,447,742,516,295,0.9675998,20,,2,1.2916666666666667,
75,2,car,crv,122,1311,387,814,1189,427,0.36553156,20,,2,1.2916666666666667,
76,2,car,crv,250,757,444,744,507,300,0.9479286,20,,2,1.2916666666666667,
77,2,car,crv,115,1321,388,815,1206,427,0.3674716,20,,2,1.24,
78,2,car,crv,248,756,446,740,508,294,0.92142504,20,,2,1.24,
79,2,car,crv,109,1315,384,827,1206,443,0.2820505,20,,2,1.24,
80,2,car,crv,249,758,449,736,509,287,0.91024953,20,,2,1.24,
81,2,car,crv,122,1310,388,817,1188,429,0.29904467,20,,2,0.3611111111111111,
82,2,car,crv,250,760,448,741,510,293,0.927252,20,,2,0.3611111111111111,
83,2,car,crv,129,1303,389,814,1174,425,0.27334884,20,,2,1.28,
84,2,car,crv,247,760,448,741,513,293,0.9333165,20,,2,1.28,
85,2,car,crv,122,1311,385,813,1189,428,0.35830083,20,,2,1.24,
86,2,car,crv,246,757,442,746,511,304,0.9668414,20,,2,1.24,
87,2,car,crv,122,1312,391,808,1190,417,0.34383425,20,,2,1.28,
88,2,car,crv,248,755,446,741,507,295,0.90284395,20,,2,1.28,
89,2,car,crv,129,1303,386,819,1174,433,0.2341652,20,,2,0.368824531516184,
90,2,car,crv,252,756,447,744,504,297,0.9354642,20,,2,0.368824531516184,
91,2,car,crv,253,756,446,744,503,298,0.97629297,20,,2,1.24,
92,2,car,crv,128,1307,388,817,1179,429,0.32914877,20,,2,1.2916666666666667,
93,2,car,crv,247,762,447,741,515,294,0.9441378,20,,2,1.2916666666666667,
94,2,car,crv,117,1313,388,818,1196,430,0.27251616,20,,2,0.3595317725752508,
95,2,car,crv,247,762,449,740,515,291,0.96550846,20,,2,0.3595317725752508,
96,2,car,crv,124,1305,387,820,1181,433,0.27402008,20,,2,0.36663844199830653,
97,2,car,crv,252,750,447,746,498,299,0.9501165,20,,2,0.36663844199830653,
98,2,car,crv,111,1317,390,812,1206,422,0.27479288,20,,2,0.34991708126036486,
99,2,car,crv,251,753,447,740,502,293,0.9438285,20,,2,0.34991708126036486,
100,2,car,crv,126,1309,390,814,1183,424,0.30222148,20,,2,1.2916666666666667,
101,2,car,crv,249,757,448,740,508,292,0.91383094,20,,2,1.2916666666666667,
102,2,car,crv,111,1317,390,811,1206,421,0.2941505,20,,2,0.3490878938640133,
103,2,car,crv,247,756,446,741,509,295,0.96245986,20,,2,0.3490878938640133,
104,2,car,crv,134,1300,387,818,1166,431,0.35928637,20,,2,1.28,
105,2,car,crv,251,757,447,743,506,296,0.9412378,20,,2,1.28,
106,2,car,crv,126,1312,388,815,1186,427,0.3965622,20,,2,1.24,
107,2,car,crv,252,758,446,743,506,297,0.9420341,20,,2,1.24,
108,2,car,crv,121,1316,389,809,1195,420,0.4096516,20,,2,1.24,
109,2,car,crv,244,761,447,742,517,295,0.9289579,20,,2,1.24,
110,2,car,crv,125,1312,392,805,1187,413,0.30284005,20,,2,1.24,
111,2,car,crv,245,760,447,739,515,292,0.9596912,20,,2,1.24,
112,2,car,crv,131,1307,388,812,1176,424,0.43397242,20,,2,1.2916666666666667,
113,2,car,crv,247,764,447,744,517,297,0.9014591,20,,2,1.2916666666666667,
114,2,car,crv,123,1315,388,811,1192,423,0.4968379,20,,2,1.24,
115,2,car,crv,246,758,446,743,512,297,0.87933147,20,,2,1.24,
116,2,car,crv,118,1312,389,813,1194,424,0.25691053,20,,2,0.35510887772194305,
117,2,car,crv,249,756,447,742,507,295,0.96910256,20,,2,0.35510887772194305,
118,2,car,crv,118,1319,389,813,1201,424,0.4023961,20,,2,1.28,
119,2,car,crv,243,757,448,743,514,295,0.94143236,20,,2,1.28,
120,2,car,crv,119,1322,385,815,1203,430,0.42900166,20,,2,1.24,
121,2,car,crv,246,762,447,741,516,294,0.790523,20,,2,1.24,
122,2,car,crv,119,1319,386,815,1200,429,0.44753623,20,,2,1.28,
123,2,car,crv,248,759,450,741,511,291,0.8263495,20,,2,1.28,
124,2,car,crv,114,1318,387,813,1204,426,0.43434885,20,,2,1.2916666666666667,
125,2,car,crv,246,759,446,744,513,298,0.9186257,20,,2,1.2916666666666667,
126,2,car,crv,119,1325,389,808,1206,419,0.46840343,20,,2,1.24,
127,2,car,crv,244,759,447,741,515,294,0.83414143,20,,2,1.24,
128,2,car,crv,116,1322,388,811,1206,423,0.44209528,20,,2,1.28,
129,2,car,crv,241,764,450,741,523,291,0.8834957,20,,2,1.28,
130,2,car,crv,334,710,446,701,376,255,0.92716336,3,0,2,0.6781914893617021,
131,2,car,crv,336,711,446,700,375,254,0.9036748,3,0,2,0.6773333333333333,
132,2,car,crv,335,709,444,701,374,257,0.9452533,3,0,2,0.6871657754010695,
0,2,car,crv,114,1312,387,822,1198,435,0.2406673,20,,2,0.3631051752921536,
1,2,car,crv,253,758,447,739,505,292,0.9361756,20,,2,0.3631051752921536,
2,2,car,crv,121,1313,387,820,1192,433,0.26400292,20,,2,1.24,
3,2,car,crv,246,754,446,742,508,296,0.95298326,20,,2,1.24,
4,2,car,crv,131,1305,389,817,1174,428,0.29075116,20,,2,0.3645655877342419,
5,2,car,crv,252,754,448,743,502,295,0.94248277,20,,2,0.3645655877342419,
6,2,car,crv,130,1307,389,819,1177,430,0.2569041,20,,2,1.24,
7,2,car,crv,256,753,448,740,497,292,0.955823,20,,2,1.24,
8,2,car,crv,127,1305,390,811,1178,421,0.25976446,20,,2,0.35738539898132426,
9,2,car,crv,250,757,443,743,507,300,0.9547171,20,,2,0.35738539898132426,
10,2,car,crv,123,1309,392,810,1186,418,0.28978387,20,,2,1.24,
11,2,car,crv,248,758,446,738,510,292,0.96847486,20,,2,1.24,
12,2,car,crv,123,1304,388,814,1181,426,0.2588897,20,,2,0.3607112616426757,
13,2,car,crv,250,759,447,742,509,295,0.9416412,20,,2,0.3607112616426757,
14,2,car,crv,130,1306,391,810,1176,419,0.26097575,20,,2,0.3562925170068027,
15,2,car,crv,250,756,447,739,506,292,0.95065075,20,,2,0.3562925170068027,
16,2,car,crv,123,1309,389,813,1186,424,0.31858423,20,,2,1.24,
17,2,car,crv,248,758,447,745,510,298,0.9534346,20,,2,1.24,
18,2,car,crv,121,1305,386,819,1184,433,0.24762785,20,,2,0.3657094594594595,
19,2,car,crv,248,759,448,745,511,297,0.96054053,20,,2,0.3657094594594595,
20,2,car,crv,251,754,443,743,503,300,0.96310854,20,,2,1.24,
21,2,car,crv,117,1318,387,822,1201,435,0.42310923,20,,2,1.2916666666666667,
22,2,car,crv,248,763,450,742,515,292,0.92204607,20,,2,1.2916666666666667,
23,2,car,crv,119,1311,391,813,1192,422,0.25885653,20,,2,1.25,
24,2,car,crv,246,752,446,739,506,293,0.95473194,20,,2,1.25,
25,2,car,crv,128,1304,388,815,1176,427,0.30647025,20,,2,1.28,
26,2,car,crv,251,758,443,746,507,303,0.93285924,20,,2,1.28,
27,2,car,crv,250,754,447,738,504,291,0.9767751,20,,2,1.24,
28,2,car,crv,109,1318,388,813,1209,425,0.32027155,20,,2,1.28,
29,2,car,crv,245,760,445,741,515,296,0.9680706,20,,2,1.28,
30,2,car,crv,127,1308,391,816,1181,425,0.2964813,20,,2,1.2916666666666667,
31,2,car,crv,250,757,447,742,507,295,0.9490655,20,,2,1.2916666666666667,
32,2,car,crv,125,1314,388,816,1189,428,0.42268884,20,,2,1.28,
33,2,car,crv,248,760,449,737,512,288,0.90941703,20,,2,1.28,
34,2,car,crv,129,1304,390,814,1175,424,0.26254445,20,,2,1.2916666666666667,
35,2,car,crv,252,755,447,740,503,293,0.94612926,20,,2,1.2916666666666667,
36,2,car,crv,114,1320,387,815,1206,428,0.30274954,20,,2,1.24,
37,2,car,crv,248,753,446,740,505,294,0.8954264,20,,2,1.24,
38,2,car,crv,127,1307,391,814,1180,423,0.278648,20,,2,0.35847457627118645,
39,2,car,crv,250,755,447,744,505,297,0.95984495,20,,2,0.35847457627118645,
40,2,car,crv,127,1302,386,816,1175,430,0.37110242,20,,2,1.28,
41,2,car,crv,246,757,444,747,511,303,0.96607155,20,,2,1.28,
42,2,car,crv,119,1307,387,816,1188,429,0.28644451,20,,2,0.3611111111111111,
43,2,car,crv,248,759,443,747,511,304,0.9593547,20,,2,0.3611111111111111,
44,2,car,crv,127,1306,389,820,1179,431,0.37050778,20,,2,1.24,
45,2,car,crv,252,758,449,742,506,293,0.9203835,20,,2,1.24,
46,2,car,crv,126,1306,387,819,1180,432,0.24266188,20,,2,0.36610169491525424,
47,2,car,crv,247,754,449,740,507,291,0.94762105,20,,2,0.36610169491525424,
48,2,car,crv,113,1317,388,815,1204,427,0.36209753,20,,2,1.24,
49,2,car,crv,247,755,446,738,508,292,0.93217456,20,,2,1.24,
50,2,car,crv,116,1312,386,813,1196,427,0.26130736,20,,2,0.35702341137123744,
51,2,car,crv,249,755,445,740,506,295,0.95275867,20,,2,0.35702341137123744,
52,2,car,crv,250,753,445,746,503,301,0.97777426,20,,2,1.24,
53,2,car,crv,117,1316,390,813,1199,423,0.30318785,20,,2,0.35279399499582986,
54,2,car,crv,239,759,447,740,520,293,0.956478,20,,2,0.35279399499582986,
55,2,car,crv,126,1307,387,813,1181,426,0.3400013,20,,2,1.24,
56,2,car,crv,250,757,446,745,507,299,0.93553233,20,,2,1.24,
57,2,car,crv,118,1316,385,817,1198,432,0.46192503,20,,2,1.24,
58,2,car,crv,242,760,449,744,518,295,0.9251644,20,,2,1.24,
59,2,car,crv,125,1310,389,811,1185,422,0.32076746,20,,2,0.3561181434599156,
60,2,car,crv,250,758,446,739,508,293,0.9462212,20,,2,0.3561181434599156,
61,2,car,crv,250,754,444,740,504,296,0.96969557,20,,2,1.24,
62,2,car,crv,113,1313,388,814,1200,426,0.2754978,20,,2,1.24,
63,2,car,crv,244,756,445,743,512,298,0.96916515,20,,2,1.24,
64,2,car,crv,123,1309,388,814,1186,426,0.2760011,20,,2,1.24,
65,2,car,crv,249,758,446,740,509,294,0.950518,20,,2,1.24,
66,2,car,crv,253,754,447,737,501,290,0.94723046,20,,2,1.24,
67,2,car,crv,121,1308,387,817,1187,430,0.21458383,20,,2,0.36225779275484415,
68,2,car,crv,250,754,447,740,504,293,0.9610552,20,,2,0.36225779275484415,
69,2,car,crv,119,1317,388,814,1198,426,0.4732625,20,,2,1.24,
70,2,car,crv,245,758,448,742,513,294,0.94409996,20,,2,1.24,
71,2,car,crv,121,1308,388,815,1187,427,0.21448645,20,,2,0.35973041280539175,
72,2,car,crv,249,753,445,746,504,301,0.9724925,20,,2,0.35973041280539175,
73,2,car,crv,135,1302,387,821,1167,434,0.35179994,20,,2,1.2916666666666667,
74,2,car,crv,250,760,450,741,510,291,0.8736024,20,,2,1.2916666666666667,
75,2,car,crv,117,1313,390,812,1196,422,0.32242462,20,,2,1.2916666666666667,
76,2,car,crv,243,759,447,742,516,295,0.9675998,20,,2,1.2916666666666667,
77,2,car,crv,122,1311,387,814,1189,427,0.36553156,20,,2,1.2916666666666667,
78,2,car,crv,250,757,444,744,507,300,0.9479286,20,,2,1.2916666666666667,
79,2,car,crv,115,1321,388,815,1206,427,0.3674716,20,,2,1.24,
80,2,car,crv,248,756,446,740,508,294,0.92142504,20,,2,1.24,
81,2,car,crv,109,1315,384,827,1206,443,0.2820505,20,,2,1.24,
82,2,car,crv,249,758,449,736,509,287,0.91024953,20,,2,1.24,
83,2,car,crv,122,1310,388,817,1188,429,0.29904467,20,,2,0.3611111111111111,
84,2,car,crv,250,760,448,741,510,293,0.927252,20,,2,0.3611111111111111,
85,2,car,crv,129,1303,389,814,1174,425,0.27334884,20,,2,1.28,
86,2,car,crv,247,760,448,741,513,293,0.9333165,20,,2,1.28,
87,2,car,crv,122,1311,385,813,1189,428,0.35830083,20,,2,1.24,
88,2,car,crv,246,757,442,746,511,304,0.9668414,20,,2,1.24,
89,2,car,crv,122,1312,391,808,1190,417,0.34383425,20,,2,1.28,
90,2,car,crv,248,755,446,741,507,295,0.90284395,20,,2,1.28,
91,2,car,crv,129,1303,386,819,1174,433,0.2341652,20,,2,0.368824531516184,
92,2,car,crv,252,756,447,744,504,297,0.9354642,20,,2,0.368824531516184,
93,2,car,crv,253,756,446,744,503,298,0.97629297,20,,2,1.24,
94,2,car,crv,128,1307,388,817,1179,429,0.32914877,20,,2,1.2916666666666667,
95,2,car,crv,247,762,447,741,515,294,0.9441378,20,,2,1.2916666666666667,
96,2,car,crv,117,1313,388,818,1196,430,0.27251616,20,,2,0.3595317725752508,
97,2,car,crv,247,762,449,740,515,291,0.96550846,20,,2,0.3595317725752508,
98,2,car,crv,124,1305,387,820,1181,433,0.27402008,20,,2,0.36663844199830653,
99,2,car,crv,252,750,447,746,498,299,0.9501165,20,,2,0.36663844199830653,
100,2,car,crv,111,1317,390,812,1206,422,0.27479288,20,,2,0.34991708126036486,
101,2,car,crv,251,753,447,740,502,293,0.9438285,20,,2,0.34991708126036486,
102,2,car,crv,126,1309,390,814,1183,424,0.30222148,20,,2,1.2916666666666667,
103,2,car,crv,249,757,448,740,508,292,0.91383094,20,,2,1.2916666666666667,
104,2,car,crv,111,1317,390,811,1206,421,0.2941505,20,,2,0.3490878938640133,
105,2,car,crv,247,756,446,741,509,295,0.96245986,20,,2,0.3490878938640133,
106,2,car,crv,134,1300,387,818,1166,431,0.35928637,20,,2,1.28,
107,2,car,crv,251,757,447,743,506,296,0.9412378,20,,2,1.28,
108,2,car,crv,126,1312,388,815,1186,427,0.3965622,20,,2,1.24,
109,2,car,crv,252,758,446,743,506,297,0.9420341,20,,2,1.24,
110,2,car,crv,121,1316,389,809,1195,420,0.4096516,20,,2,1.24,
111,2,car,crv,244,761,447,742,517,295,0.9289579,20,,2,1.24,
112,2,car,crv,125,1312,392,805,1187,413,0.30284005,20,,2,1.24,
113,2,car,crv,245,760,447,739,515,292,0.9596912,20,,2,1.24,
114,2,car,crv,131,1307,388,812,1176,424,0.43397242,20,,2,1.2916666666666667,
115,2,car,crv,247,764,447,744,517,297,0.9014591,20,,2,1.2916666666666667,
116,2,car,crv,123,1315,388,811,1192,423,0.4968379,20,,2,1.24,
117,2,car,crv,246,758,446,743,512,297,0.87933147,20,,2,1.24,
118,2,car,crv,118,1312,389,813,1194,424,0.25691053,20,,2,0.35510887772194305,
119,2,car,crv,249,756,447,742,507,295,0.96910256,20,,2,0.35510887772194305,
120,2,car,crv,118,1319,389,813,1201,424,0.4023961,20,,2,1.28,
121,2,car,crv,243,757,448,743,514,295,0.94143236,20,,2,1.28,
122,2,car,crv,119,1322,385,815,1203,430,0.42900166,20,,2,1.24,
123,2,car,crv,246,762,447,741,516,294,0.790523,20,,2,1.24,
124,2,car,crv,119,1319,386,815,1200,429,0.44753623,20,,2,1.28,
125,2,car,crv,248,759,450,741,511,291,0.8263495,20,,2,1.28,
126,2,car,crv,114,1318,387,813,1204,426,0.43434885,20,,2,1.2916666666666667,
127,2,car,crv,246,759,446,744,513,298,0.9186257,20,,2,1.2916666666666667,
128,2,car,crv,119,1325,389,808,1206,419,0.46840343,20,,2,1.24,
129,2,car,crv,244,759,447,741,515,294,0.83414143,20,,2,1.24,
130,2,car,crv,116,1322,388,811,1206,423,0.44209528,20,,2,1.28,
131,2,car,crv,241,764,450,741,523,291,0.8834957,20,,2,1.28,
132,2,car,crv,334,710,446,701,376,255,0.92716336,3,0,2,0.6781914893617021,
133,2,car,crv,336,711,446,700,375,254,0.9036748,3,0,2,0.6773333333333333,
134,2,car,crv,335,709,444,701,374,257,0.9452533,3,0,2,0.6871657754010695,
0,2,car,crv,251,754,448,736,503,288,0.9627608,20,,2,1.28,
1,2,car,crv,114,1312,387,822,1198,435,0.2406673,20,,2,0.3631051752921536,
2,2,car,crv,253,758,447,739,505,292,0.9361756,20,,2,0.3631051752921536,
3,2,car,crv,121,1313,387,820,1192,433,0.26400292,20,,2,1.24,
4,2,car,crv,246,754,446,742,508,296,0.95298326,20,,2,1.24,
5,2,car,crv,131,1305,389,817,1174,428,0.29075116,20,,2,0.3645655877342419,
6,2,car,crv,252,754,448,743,502,295,0.94248277,20,,2,0.3645655877342419,
7,2,car,crv,130,1307,389,819,1177,430,0.2569041,20,,2,1.24,
8,2,car,crv,256,753,448,740,497,292,0.955823,20,,2,1.24,
9,2,car,crv,127,1305,390,811,1178,421,0.25976446,20,,2,0.35738539898132426,
10,2,car,crv,250,757,443,743,507,300,0.9547171,20,,2,0.35738539898132426,
11,2,car,crv,123,1309,392,810,1186,418,0.28978387,20,,2,1.24,
12,2,car,crv,248,758,446,738,510,292,0.96847486,20,,2,1.24,
13,2,car,crv,123,1304,388,814,1181,426,0.2588897,20,,2,0.3607112616426757,
14,2,car,crv,250,759,447,742,509,295,0.9416412,20,,2,0.3607112616426757,
15,2,car,crv,130,1306,391,810,1176,419,0.26097575,20,,2,0.3562925170068027,
16,2,car,crv,250,756,447,739,506,292,0.95065075,20,,2,0.3562925170068027,
17,2,car,crv,123,1309,389,813,1186,424,0.31858423,20,,2,1.24,
18,2,car,crv,248,758,447,745,510,298,0.9534346,20,,2,1.24,
19,2,car,crv,121,1305,386,819,1184,433,0.24762785,20,,2,0.3657094594594595,
20,2,car,crv,248,759,448,745,511,297,0.96054053,20,,2,0.3657094594594595,
21,2,car,crv,251,754,443,743,503,300,0.96310854,20,,2,1.24,
22,2,car,crv,117,1318,387,822,1201,435,0.42310923,20,,2,1.2916666666666667,
23,2,car,crv,248,763,450,742,515,292,0.92204607,20,,2,1.2916666666666667,
24,2,car,crv,119,1311,391,813,1192,422,0.25885653,20,,2,1.25,
25,2,car,crv,246,752,446,739,506,293,0.95473194,20,,2,1.25,
26,2,car,crv,128,1304,388,815,1176,427,0.30647025,20,,2,1.28,
27,2,car,crv,251,758,443,746,507,303,0.93285924,20,,2,1.28,
28,2,car,crv,250,754,447,738,504,291,0.9767751,20,,2,1.24,
29,2,car,crv,109,1318,388,813,1209,425,0.32027155,20,,2,1.28,
30,2,car,crv,245,760,445,741,515,296,0.9680706,20,,2,1.28,
31,2,car,crv,127,1308,391,816,1181,425,0.2964813,20,,2,1.2916666666666667,
32,2,car,crv,250,757,447,742,507,295,0.9490655,20,,2,1.2916666666666667,
33,2,car,crv,125,1314,388,816,1189,428,0.42268884,20,,2,1.28,
34,2,car,crv,248,760,449,737,512,288,0.90941703,20,,2,1.28,
35,2,car,crv,129,1304,390,814,1175,424,0.26254445,20,,2,1.2916666666666667,
36,2,car,crv,252,755,447,740,503,293,0.94612926,20,,2,1.2916666666666667,
37,2,car,crv,114,1320,387,815,1206,428,0.30274954,20,,2,1.24,
38,2,car,crv,248,753,446,740,505,294,0.8954264,20,,2,1.24,
39,2,car,crv,127,1307,391,814,1180,423,0.278648,20,,2,0.35847457627118645,
40,2,car,crv,250,755,447,744,505,297,0.95984495,20,,2,0.35847457627118645,
41,2,car,crv,127,1302,386,816,1175,430,0.37110242,20,,2,1.28,
42,2,car,crv,246,757,444,747,511,303,0.96607155,20,,2,1.28,
43,2,car,crv,119,1307,387,816,1188,429,0.28644451,20,,2,0.3611111111111111,
44,2,car,crv,248,759,443,747,511,304,0.9593547,20,,2,0.3611111111111111,
45,2,car,crv,127,1306,389,820,1179,431,0.37050778,20,,2,1.24,
46,2,car,crv,252,758,449,742,506,293,0.9203835,20,,2,1.24,
47,2,car,crv,126,1306,387,819,1180,432,0.24266188,20,,2,0.36610169491525424,
48,2,car,crv,247,754,449,740,507,291,0.94762105,20,,2,0.36610169491525424,
49,2,car,crv,113,1317,388,815,1204,427,0.36209753,20,,2,1.24,
50,2,car,crv,247,755,446,738,508,292,0.93217456,20,,2,1.24,
51,2,car,crv,116,1312,386,813,1196,427,0.26130736,20,,2,0.35702341137123744,
52,2,car,crv,249,755,445,740,506,295,0.95275867,20,,2,0.35702341137123744,
53,2,car,crv,250,753,445,746,503,301,0.97777426,20,,2,1.24,
54,2,car,crv,117,1316,390,813,1199,423,0.30318785,20,,2,0.35279399499582986,
55,2,car,crv,239,759,447,740,520,293,0.956478,20,,2,0.35279399499582986,
56,2,car,crv,126,1307,387,813,1181,426,0.3400013,20,,2,1.24,
57,2,car,crv,250,757,446,745,507,299,0.93553233,20,,2,1.24,
58,2,car,crv,118,1316,385,817,1198,432,0.46192503,20,,2,1.24,
59,2,car,crv,242,760,449,744,518,295,0.9251644,20,,2,1.24,
60,2,car,crv,125,1310,389,811,1185,422,0.32076746,20,,2,0.3561181434599156,
61,2,car,crv,250,758,446,739,508,293,0.9462212,20,,2,0.3561181434599156,
62,2,car,crv,250,754,444,740,504,296,0.96969557,20,,2,1.24,
63,2,car,crv,113,1313,388,814,1200,426,0.2754978,20,,2,1.24,
64,2,car,crv,244,756,445,743,512,298,0.96916515,20,,2,1.24,
65,2,car,crv,123,1309,388,814,1186,426,0.2760011,20,,2,1.24,
66,2,car,crv,249,758,446,740,509,294,0.950518,20,,2,1.24,
67,2,car,crv,253,754,447,737,501,290,0.94723046,20,,2,1.24,
68,2,car,crv,121,1308,387,817,1187,430,0.21458383,20,,2,0.36225779275484415,
69,2,car,crv,250,754,447,740,504,293,0.9610552,20,,2,0.36225779275484415,
70,2,car,crv,119,1317,388,814,1198,426,0.4732625,20,,2,1.24,
71,2,car,crv,245,758,448,742,513,294,0.94409996,20,,2,1.24,
72,2,car,crv,121,1308,388,815,1187,427,0.21448645,20,,2,0.35973041280539175,
73,2,car,crv,249,753,445,746,504,301,0.9724925,20,,2,0.35973041280539175,
74,2,car,crv,135,1302,387,821,1167,434,0.35179994,20,,2,1.2916666666666667,
75,2,car,crv,250,760,450,741,510,291,0.8736024,20,,2,1.2916666666666667,
76,2,car,crv,117,1313,390,812,1196,422,0.32242462,20,,2,1.2916666666666667,
77,2,car,crv,243,759,447,742,516,295,0.9675998,20,,2,1.2916666666666667,
78,2,car,crv,122,1311,387,814,1189,427,0.36553156,20,,2,1.2916666666666667,
79,2,car,crv,250,757,444,744,507,300,0.9479286,20,,2,1.2916666666666667,
80,2,car,crv,115,1321,388,815,1206,427,0.3674716,20,,2,1.24,
81,2,car,crv,248,756,446,740,508,294,0.92142504,20,,2,1.24,
82,2,car,crv,109,1315,384,827,1206,443,0.2820505,20,,2,1.24,
83,2,car,crv,249,758,449,736,509,287,0.91024953,20,,2,1.24,
84,2,car,crv,122,1310,388,817,1188,429,0.29904467,20,,2,0.3611111111111111,
85,2,car,crv,250,760,448,741,510,293,0.927252,20,,2,0.3611111111111111,
86,2,car,crv,129,1303,389,814,1174,425,0.27334884,20,,2,1.28,
87,2,car,crv,247,760,448,741,513,293,0.9333165,20,,2,1.28,
88,2,car,crv,122,1311,385,813,1189,428,0.35830083,20,,2,1.24,
89,2,car,crv,246,757,442,746,511,304,0.9668414,20,,2,1.24,
90,2,car,crv,122,1312,391,808,1190,417,0.34383425,20,,2,1.28,
91,2,car,crv,248,755,446,741,507,295,0.90284395,20,,2,1.28,
92,2,car,crv,129,1303,386,819,1174,433,0.2341652,20,,2,0.368824531516184,
93,2,car,crv,252,756,447,744,504,297,0.9354642,20,,2,0.368824531516184,
94,2,car,crv,253,756,446,744,503,298,0.97629297,20,,2,1.24,
95,2,car,crv,128,1307,388,817,1179,429,0.32914877,20,,2,1.2916666666666667,
96,2,car,crv,247,762,447,741,515,294,0.9441378,20,,2,1.2916666666666667,
97,2,car,crv,117,1313,388,818,1196,430,0.27251616,20,,2,0.3595317725752508,
98,2,car,crv,247,762,449,740,515,291,0.96550846,20,,2,0.3595317725752508,
99,2,car,crv,124,1305,387,820,1181,433,0.27402008,20,,2,0.36663844199830653,
100,2,car,crv,252,750,447,746,498,299,0.9501165,20,,2,0.36663844199830653,
101,2,car,crv,111,1317,390,812,1206,422,0.27479288,20,,2,0.34991708126036486,
102,2,car,crv,251,753,447,740,502,293,0.9438285,20,,2,0.34991708126036486,
103,2,car,crv,126,1309,390,814,1183,424,0.30222148,20,,2,1.2916666666666667,
104,2,car,crv,249,757,448,740,508,292,0.91383094,20,,2,1.2916666666666667,
105,2,car,crv,111,1317,390,811,1206,421,0.2941505,20,,2,0.3490878938640133,
106,2,car,crv,247,756,446,741,509,295,0.96245986,20,,2,0.3490878938640133,
107,2,car,crv,134,1300,387,818,1166,431,0.35928637,20,,2,1.28,
108,2,car,crv,251,757,447,743,506,296,0.9412378,20,,2,1.28,
109,2,car,crv,126,1312,388,815,1186,427,0.3965622,20,,2,1.24,
110,2,car,crv,252,758,446,743,506,297,0.9420341,20,,2,1.24,
111,2,car,crv,121,1316,389,809,1195,420,0.4096516,20,,2,1.24,
112,2,car,crv,244,761,447,742,517,295,0.9289579,20,,2,1.24,
113,2,car,crv,125,1312,392,805,1187,413,0.30284005,20,,2,1.24,
114,2,car,crv,245,760,447,739,515,292,0.9596912,20,,2,1.24,
115,2,car,crv,131,1307,388,812,1176,424,0.43397242,20,,2,1.2916666666666667,
116,2,car,crv,247,764,447,744,517,297,0.9014591,20,,2,1.2916666666666667,
117,2,car,crv,123,1315,388,811,1192,423,0.4968379,20,,2,1.24,
118,2,car,crv,246,758,446,743,512,297,0.87933147,20,,2,1.24,
119,2,car,crv,118,1312,389,813,1194,424,0.25691053,20,,2,0.35510887772194305,
120,2,car,crv,249,756,447,742,507,295,0.96910256,20,,2,0.35510887772194305,
121,2,car,crv,118,1319,389,813,1201,424,0.4023961,20,,2,1.28,
122,2,car,crv,243,757,448,743,514,295,0.94143236,20,,2,1.28,
123,2,car,crv,119,1322,385,815,1203,430,0.42900166,20,,2,1.24,
124,2,car,crv,246,762,447,741,516,294,0.790523,20,,2,1.24,
125,2,car,crv,119,1319,386,815,1200,429,0.44753623,20,,2,1.28,
126,2,car,crv,248,759,450,741,511,291,0.8263495,20,,2,1.28,
127,2,car,crv,114,1318,387,813,1204,426,0.43434885,20,,2,1.2916666666666667,
128,2,car,crv,246,759,446,744,513,298,0.9186257,20,,2,1.2916666666666667,
129,2,car,crv,119,1325,389,808,1206,419,0.46840343,20,,2,1.24,
130,2,car,crv,244,759,447,741,515,294,0.83414143,20,,2,1.24,
131,2,car,crv,116,1322,388,811,1206,423,0.44209528,20,,2,1.28,
132,2,car,crv,241,764,450,741,523,291,0.8834957,20,,2,1.28,
133,2,car,crv,334,710,446,701,376,255,0.92716336,3,0,2,0.6781914893617021,
134,2,car,crv,336,711,446,700,375,254,0.9036748,3,0,2,0.6773333333333333,
135,2,car,crv,335,709,444,701,374,257,0.9452533,3,0,2,0.6871657754010695,
0,2,car,crv,120,1319,389,808,1199,419,0.49123806,20,,2,1.24,
1,2,car,crv,241,764,446,743,523,297,0.8688812,20,,2,1.24,
2,2,car,crv,251,754,448,736,503,288,0.9627608,20,,2,1.28,
3,2,car,crv,114,1312,387,822,1198,435,0.2406673,20,,2,0.3631051752921536,
4,2,car,crv,253,758,447,739,505,292,0.9361756,20,,2,0.3631051752921536,
5,2,car,crv,121,1313,387,820,1192,433,0.26400292,20,,2,1.24,
6,2,car,crv,246,754,446,742,508,296,0.95298326,20,,2,1.24,
7,2,car,crv,131,1305,389,817,1174,428,0.29075116,20,,2,0.3645655877342419,
8,2,car,crv,252,754,448,743,502,295,0.94248277,20,,2,0.3645655877342419,
9,2,car,crv,130,1307,389,819,1177,430,0.2569041,20,,2,1.24,
10,2,car,crv,256,753,448,740,497,292,0.955823,20,,2,1.24,
11,2,car,crv,127,1305,390,811,1178,421,0.25976446,20,,2,0.35738539898132426,
12,2,car,crv,250,757,443,743,507,300,0.9547171,20,,2,0.35738539898132426,
13,2,car,crv,123,1309,392,810,1186,418,0.28978387,20,,2,1.24,
14,2,car,crv,248,758,446,738,510,292,0.96847486,20,,2,1.24,
15,2,car,crv,123,1304,388,814,1181,426,0.2588897,20,,2,0.3607112616426757,
16,2,car,crv,250,759,447,742,509,295,0.9416412,20,,2,0.3607112616426757,
17,2,car,crv,130,1306,391,810,1176,419,0.26097575,20,,2,0.3562925170068027,
18,2,car,crv,250,756,447,739,506,292,0.95065075,20,,2,0.3562925170068027,
19,2,car,crv,123,1309,389,813,1186,424,0.31858423,20,,2,1.24,
20,2,car,crv,248,758,447,745,510,298,0.9534346,20,,2,1.24,
21,2,car,crv,121,1305,386,819,1184,433,0.24762785,20,,2,0.3657094594594595,
22,2,car,crv,248,759,448,745,511,297,0.96054053,20,,2,0.3657094594594595,
23,2,car,crv,251,754,443,743,503,300,0.96310854,20,,2,1.24,
24,2,car,crv,117,1318,387,822,1201,435,0.42310923,20,,2,1.2916666666666667,
25,2,car,crv,248,763,450,742,515,292,0.92204607,20,,2,1.2916666666666667,
26,2,car,crv,119,1311,391,813,1192,422,0.25885653,20,,2,1.25,
27,2,car,crv,246,752,446,739,506,293,0.95473194,20,,2,1.25,
28,2,car,crv,128,1304,388,815,1176,427,0.30647025,20,,2,1.28,
29,2,car,crv,251,758,443,746,507,303,0.93285924,20,,2,1.28,
30,2,car,crv,250,754,447,738,504,291,0.9767751,20,,2,1.24,
31,2,car,crv,109,1318,388,813,1209,425,0.32027155,20,,2,1.28,
32,2,car,crv,245,760,445,741,515,296,0.9680706,20,,2,1.28,
33,2,car,crv,127,1308,391,816,1181,425,0.2964813,20,,2,1.2916666666666667,
34,2,car,crv,250,757,447,742,507,295,0.9490655,20,,2,1.2916666666666667,
35,2,car,crv,125,1314,388,816,1189,428,0.42268884,20,,2,1.28,
36,2,car,crv,248,760,449,737,512,288,0.90941703,20,,2,1.28,
37,2,car,crv,129,1304,390,814,1175,424,0.26254445,20,,2,1.2916666666666667,
38,2,car,crv,252,755,447,740,503,293,0.94612926,20,,2,1.2916666666666667,
39,2,car,crv,114,1320,387,815,1206,428,0.30274954,20,,2,1.24,
40,2,car,crv,248,753,446,740,505,294,0.8954264,20,,2,1.24,
41,2,car,crv,127,1307,391,814,1180,423,0.278648,20,,2,0.35847457627118645,
42,2,car,crv,250,755,447,744,505,297,0.95984495,20,,2,0.35847457627118645,
43,2,car,crv,127,1302,386,816,1175,430,0.37110242,20,,2,1.28,
44,2,car,crv,246,757,444,747,511,303,0.96607155,20,,2,1.28,
45,2,car,crv,119,1307,387,816,1188,429,0.28644451,20,,2,0.3611111111111111,
46,2,car,crv,248,759,443,747,511,304,0.9593547,20,,2,0.3611111111111111,
47,2,car,crv,127,1306,389,820,1179,431,0.37050778,20,,2,1.24,
48,2,car,crv,252,758,449,742,506,293,0.9203835,20,,2,1.24,
49,2,car,crv,126,1306,387,819,1180,432,0.24266188,20,,2,0.36610169491525424,
50,2,car,crv,247,754,449,740,507,291,0.94762105,20,,2,0.36610169491525424,
51,2,car,crv,113,1317,388,815,1204,427,0.36209753,20,,2,1.24,
52,2,car,crv,247,755,446,738,508,292,0.93217456,20,,2,1.24,
53,2,car,crv,116,1312,386,813,1196,427,0.26130736,20,,2,0.35702341137123744,
54,2,car,crv,249,755,445,740,506,295,0.95275867,20,,2,0.35702341137123744,
55,2,car,crv,250,753,445,746,503,301,0.97777426,20,,2,1.24,
56,2,car,crv,117,1316,390,813,1199,423,0.30318785,20,,2,0.35279399499582986,
57,2,car,crv,239,759,447,740,520,293,0.956478,20,,2,0.35279399499582986,
58,2,car,crv,126,1307,387,813,1181,426,0.3400013,20,,2,1.24,
59,2,car,crv,250,757,446,745,507,299,0.93553233,20,,2,1.24,
60,2,car,crv,118,1316,385,817,1198,432,0.46192503,20,,2,1.24,
61,2,car,crv,242,760,449,744,518,295,0.9251644,20,,2,1.24,
62,2,car,crv,125,1310,389,811,1185,422,0.32076746,20,,2,0.3561181434599156,
63,2,car,crv,250,758,446,739,508,293,0.9462212,20,,2,0.3561181434599156,
64,2,car,crv,250,754,444,740,504,296,0.96969557,20,,2,1.24,
65,2,car,crv,113,1313,388,814,1200,426,0.2754978,20,,2,1.24,
66,2,car,crv,244,756,445,743,512,298,0.96916515,20,,2,1.24,
67,2,car,crv,123,1309,388,814,1186,426,0.2760011,20,,2,1.24,
68,2,car,crv,249,758,446,740,509,294,0.950518,20,,2,1.24,
69,2,car,crv,253,754,447,737,501,290,0.94723046,20,,2,1.24,
70,2,car,crv,121,1308,387,817,1187,430,0.21458383,20,,2,0.36225779275484415,
71,2,car,crv,250,754,447,740,504,293,0.9610552,20,,2,0.36225779275484415,
72,2,car,crv,119,1317,388,814,1198,426,0.4732625,20,,2,1.24,
73,2,car,crv,245,758,448,742,513,294,0.94409996,20,,2,1.24,
74,2,car,crv,121,1308,388,815,1187,427,0.21448645,20,,2,0.35973041280539175,
75,2,car,crv,249,753,445,746,504,301,0.9724925,20,,2,0.35973041280539175,
76,2,car,crv,135,1302,387,821,1167,434,0.35179994,20,,2,1.2916666666666667,
77,2,car,crv,250,760,450,741,510,291,0.8736024,20,,2,1.2916666666666667,
78,2,car,crv,117,1313,390,812,1196,422,0.32242462,20,,2,1.2916666666666667,
79,2,car,crv,243,759,447,742,516,295,0.9675998,20,,2,1.2916666666666667,
80,2,car,crv,122,1311,387,814,1189,427,0.36553156,20,,2,1.2916666666666667,
81,2,car,crv,250,757,444,744,507,300,0.9479286,20,,2,1.2916666666666667,
82,2,car,crv,115,1321,388,815,1206,427,0.3674716,20,,2,1.24,
83,2,car,crv,248,756,446,740,508,294,0.92142504,20,,2,1.24,
84,2,car,crv,109,1315,384,827,1206,443,0.2820505,20,,2,1.24,
85,2,car,crv,249,758,449,736,509,287,0.91024953,20,,2,1.24,
86,2,car,crv,122,1310,388,817,1188,429,0.29904467,20,,2,0.3611111111111111,
87,2,car,crv,250,760,448,741,510,293,0.927252,20,,2,0.3611111111111111,
88,2,car,crv,129,1303,389,814,1174,425,0.27334884,20,,2,1.28,
89,2,car,crv,247,760,448,741,513,293,0.9333165,20,,2,1.28,
90,2,car,crv,122,1311,385,813,1189,428,0.35830083,20,,2,1.24,
91,2,car,crv,246,757,442,746,511,304,0.9668414,20,,2,1.24,
92,2,car,crv,122,1312,391,808,1190,417,0.34383425,20,,2,1.28,
93,2,car,crv,248,755,446,741,507,295,0.90284395,20,,2,1.28,
94,2,car,crv,129,1303,386,819,1174,433,0.2341652,20,,2,0.368824531516184,
95,2,car,crv,252,756,447,744,504,297,0.9354642,20,,2,0.368824531516184,
96,2,car,crv,253,756,446,744,503,298,0.97629297,20,,2,1.24,
97,2,car,crv,128,1307,388,817,1179,429,0.32914877,20,,2,1.2916666666666667,
98,2,car,crv,247,762,447,741,515,294,0.9441378,20,,2,1.2916666666666667,
99,2,car,crv,117,1313,388,818,1196,430,0.27251616,20,,2,0.3595317725752508,
100,2,car,crv,247,762,449,740,515,291,0.96550846,20,,2,0.3595317725752508,
101,2,car,crv,124,1305,387,820,1181,433,0.27402008,20,,2,0.36663844199830653,
102,2,car,crv,252,750,447,746,498,299,0.9501165,20,,2,0.36663844199830653,
103,2,car,crv,111,1317,390,812,1206,422,0.27479288,20,,2,0.34991708126036486,
104,2,car,crv,251,753,447,740,502,293,0.9438285,20,,2,0.34991708126036486,
105,2,car,crv,126,1309,390,814,1183,424,0.30222148,20,,2,1.2916666666666667,
106,2,car,crv,249,757,448,740,508,292,0.91383094,20,,2,1.2916666666666667,
107,2,car,crv,111,1317,390,811,1206,421,0.2941505,20,,2,0.3490878938640133,
108,2,car,crv,247,756,446,741,509,295,0.96245986,20,,2,0.3490878938640133,
109,2,car,crv,134,1300,387,818,1166,431,0.35928637,20,,2,1.28,
110,2,car,crv,251,757,447,743,506,296,0.9412378,20,,2,1.28,
111,2,car,crv,126,1312,388,815,1186,427,0.3965622,20,,2,1.24,
112,2,car,crv,252,758,446,743,506,297,0.9420341,20,,2,1.24,
113,2,car,crv,121,1316,389,809,1195,420,0.4096516,20,,2,1.24,
114,2,car,crv,244,761,447,742,517,295,0.9289579,20,,2,1.24,
115,2,car,crv,125,1312,392,805,1187,413,0.30284005,20,,2,1.24,
116,2,car,crv,245,760,447,739,515,292,0.9596912,20,,2,1.24,
117,2,car,crv,131,1307,388,812,1176,424,0.43397242,20,,2,1.2916666666666667,
118,2,car,crv,247,764,447,744,517,297,0.9014591,20,,2,1.2916666666666667,
119,2,car,crv,123,1315,388,811,1192,423,0.4968379,20,,2,1.24,
120,2,car,crv,246,758,446,743,512,297,0.87933147,20,,2,1.24,
121,2,car,crv,118,1312,389,813,1194,424,0.25691053,20,,2,0.35510887772194305,
122,2,car,crv,249,756,447,742,507,295,0.96910256,20,,2,0.35510887772194305,
123,2,car,crv,118,1319,389,813,1201,424,0.4023961,20,,2,1.28,
124,2,car,crv,243,757,448,743,514,295,0.94143236,20,,2,1.28,
125,2,car,crv,119,1322,385,815,1203,430,0.42900166,20,,2,1.24,
126,2,car,crv,246,762,447,741,516,294,0.790523,20,,2,1.24,
127,2,car,crv,119,1319,386,815,1200,429,0.44753623,20,,2,1.28,
128,2,car,crv,248,759,450,741,511,291,0.8263495,20,,2,1.28,
129,2,car,crv,114,1318,387,813,1204,426,0.43434885,20,,2,1.2916666666666667,
130,2,car,crv,246,759,446,744,513,298,0.9186257,20,,2,1.2916666666666667,
131,2,car,crv,119,1325,389,808,1206,419,0.46840343,20,,2,1.24,
132,2,car,crv,244,759,447,741,515,294,0.83414143,20,,2,1.24,
133,2,car,crv,116,1322,388,811,1206,423,0.44209528,20,,2,1.28,
134,2,car,crv,241,764,450,741,523,291,0.8834957,20,,2,1.28,
135,2,car,crv,334,710,446,701,376,255,0.92716336,3,0,2,0.6781914893617021,
136,2,car,crv,336,711,446,700,375,254,0.9036748,3,0,2,0.6773333333333333,
137,2,car,crv,335,709,444,701,374,257,0.9452533,3,0,2,0.6871657754010695,
0,2,car,crv,122,1317,387,818,1195,431,0.38155946,20,,2,1.24,
1,2,car,crv,248,756,447,743,508,296,0.9098617,20,,2,1.24,
2,2,car,crv,120,1319,389,808,1199,419,0.49123806,20,,2,1.24,
3,2,car,crv,241,764,446,743,523,297,0.8688812,20,,2,1.24,
4,2,car,crv,251,754,448,736,503,288,0.9627608,20,,2,1.28,
5,2,car,crv,114,1312,387,822,1198,435,0.2406673,20,,2,0.3631051752921536,
6,2,car,crv,253,758,447,739,505,292,0.9361756,20,,2,0.3631051752921536,
7,2,car,crv,121,1313,387,820,1192,433,0.26400292,20,,2,1.24,
8,2,car,crv,246,754,446,742,508,296,0.95298326,20,,2,1.24,
9,2,car,crv,131,1305,389,817,1174,428,0.29075116,20,,2,0.3645655877342419,
10,2,car,crv,252,754,448,743,502,295,0.94248277,20,,2,0.3645655877342419,
11,2,car,crv,130,1307,389,819,1177,430,0.2569041,20,,2,1.24,
12,2,car,crv,256,753,448,740,497,292,0.955823,20,,2,1.24,
13,2,car,crv,127,1305,390,811,1178,421,0.25976446,20,,2,0.35738539898132426,
14,2,car,crv,250,757,443,743,507,300,0.9547171,20,,2,0.35738539898132426,
15,2,car,crv,123,1309,392,810,1186,418,0.28978387,20,,2,1.24,
16,2,car,crv,248,758,446,738,510,292,0.96847486,20,,2,1.24,
17,2,car,crv,123,1304,388,814,1181,426,0.2588897,20,,2,0.3607112616426757,
18,2,car,crv,250,759,447,742,509,295,0.9416412,20,,2,0.3607112616426757,
19,2,car,crv,130,1306,391,810,1176,419,0.26097575,20,,2,0.3562925170068027,
20,2,car,crv,250,756,447,739,506,292,0.95065075,20,,2,0.3562925170068027,
21,2,car,crv,123,1309,389,813,1186,424,0.31858423,20,,2,1.24,
22,2,car,crv,248,758,447,745,510,298,0.9534346,20,,2,1.24,
23,2,car,crv,121,1305,386,819,1184,433,0.24762785,20,,2,0.3657094594594595,
24,2,car,crv,248,759,448,745,511,297,0.96054053,20,,2,0.3657094594594595,
25,2,car,crv,251,754,443,743,503,300,0.96310854,20,,2,1.24,
26,2,car,crv,117,1318,387,822,1201,435,0.42310923,20,,2,1.2916666666666667,
27,2,car,crv,248,763,450,742,515,292,0.92204607,20,,2,1.2916666666666667,
28,2,car,crv,119,1311,391,813,1192,422,0.25885653,20,,2,1.25,
29,2,car,crv,246,752,446,739,506,293,0.95473194,20,,2,1.25,
30,2,car,crv,128,1304,388,815,1176,427,0.30647025,20,,2,1.28,
31,2,car,crv,251,758,443,746,507,303,0.93285924,20,,2,1.28,
32,2,car,crv,250,754,447,738,504,291,0.9767751,20,,2,1.24,
33,2,car,crv,109,1318,388,813,1209,425,0.32027155,20,,2,1.28,
34,2,car,crv,245,760,445,741,515,296,0.9680706,20,,2,1.28,
35,2,car,crv,127,1308,391,816,1181,425,0.2964813,20,,2,1.2916666666666667,
36,2,car,crv,250,757,447,742,507,295,0.9490655,20,,2,1.2916666666666667,
37,2,car,crv,125,1314,388,816,1189,428,0.42268884,20,,2,1.28,
38,2,car,crv,248,760,449,737,512,288,0.90941703,20,,2,1.28,
39,2,car,crv,129,1304,390,814,1175,424,0.26254445,20,,2,1.2916666666666667,
40,2,car,crv,252,755,447,740,503,293,0.94612926,20,,2,1.2916666666666667,
41,2,car,crv,114,1320,387,815,1206,428,0.30274954,20,,2,1.24,
42,2,car,crv,248,753,446,740,505,294,0.8954264,20,,2,1.24,
43,2,car,crv,127,1307,391,814,1180,423,0.278648,20,,2,0.35847457627118645,
44,2,car,crv,250,755,447,744,505,297,0.95984495,20,,2,0.35847457627118645,
45,2,car,crv,127,1302,386,816,1175,430,0.37110242,20,,2,1.28,
46,2,car,crv,246,757,444,747,511,303,0.96607155,20,,2,1.28,
47,2,car,crv,119,1307,387,816,1188,429,0.28644451,20,,2,0.3611111111111111,
48,2,car,crv,248,759,443,747,511,304,0.9593547,20,,2,0.3611111111111111,
49,2,car,crv,127,1306,389,820,1179,431,0.37050778,20,,2,1.24,
50,2,car,crv,252,758,449,742,506,293,0.9203835,20,,2,1.24,
51,2,car,crv,126,1306,387,819,1180,432,0.24266188,20,,2,0.36610169491525424,
52,2,car,crv,247,754,449,740,507,291,0.94762105,20,,2,0.36610169491525424,
53,2,car,crv,113,1317,388,815,1204,427,0.36209753,20,,2,1.24,
54,2,car,crv,247,755,446,738,508,292,0.93217456,20,,2,1.24,
55,2,car,crv,116,1312,386,813,1196,427,0.26130736,20,,2,0.35702341137123744,
56,2,car,crv,249,755,445,740,506,295,0.95275867,20,,2,0.35702341137123744,
57,2,car,crv,250,753,445,746,503,301,0.97777426,20,,2,1.24,
58,2,car,crv,117,1316,390,813,1199,423,0.30318785,20,,2,0.35279399499582986,
59,2,car,crv,239,759,447,740,520,293,0.956478,20,,2,0.35279399499582986,
60,2,car,crv,126,1307,387,813,1181,426,0.3400013,20,,2,1.24,
61,2,car,crv,250,757,446,745,507,299,0.93553233,20,,2,1.24,
62,2,car,crv,118,1316,385,817,1198,432,0.46192503,20,,2,1.24,
63,2,car,crv,242,760,449,744,518,295,0.9251644,20,,2,1.24,
64,2,car,crv,125,1310,389,811,1185,422,0.32076746,20,,2,0.3561181434599156,
65,2,car,crv,250,758,446,739,508,293,0.9462212,20,,2,0.3561181434599156,
66,2,car,crv,250,754,444,740,504,296,0.96969557,20,,2,1.24,
67,2,car,crv,113,1313,388,814,1200,426,0.2754978,20,,2,1.24,
68,2,car,crv,244,756,445,743,512,298,0.96916515,20,,2,1.24,
69,2,car,crv,123,1309,388,814,1186,426,0.2760011,20,,2,1.24,
70,2,car,crv,249,758,446,740,509,294,0.950518,20,,2,1.24,
71,2,car,crv,253,754,447,737,501,290,0.94723046,20,,2,1.24,
72,2,car,crv,121,1308,387,817,1187,430,0.21458383,20,,2,0.36225779275484415,
73,2,car,crv,250,754,447,740,504,293,0.9610552,20,,2,0.36225779275484415,
74,2,car,crv,119,1317,388,814,1198,426,0.4732625,20,,2,1.24,
75,2,car,crv,245,758,448,742,513,294,0.94409996,20,,2,1.24,
76,2,car,crv,121,1308,388,815,1187,427,0.21448645,20,,2,0.35973041280539175,
77,2,car,crv,249,753,445,746,504,301,0.9724925,20,,2,0.35973041280539175,
78,2,car,crv,135,1302,387,821,1167,434,0.35179994,20,,2,1.2916666666666667,
79,2,car,crv,250,760,450,741,510,291,0.8736024,20,,2,1.2916666666666667,
80,2,car,crv,117,1313,390,812,1196,422,0.32242462,20,,2,1.2916666666666667,
81,2,car,crv,243,759,447,742,516,295,0.9675998,20,,2,1.2916666666666667,
82,2,car,crv,122,1311,387,814,1189,427,0.36553156,20,,2,1.2916666666666667,
83,2,car,crv,250,757,444,744,507,300,0.9479286,20,,2,1.2916666666666667,
84,2,car,crv,115,1321,388,815,1206,427,0.3674716,20,,2,1.24,
85,2,car,crv,248,756,446,740,508,294,0.92142504,20,,2,1.24,
86,2,car,crv,109,1315,384,827,1206,443,0.2820505,20,,2,1.24,
87,2,car,crv,249,758,449,736,509,287,0.91024953,20,,2,1.24,
88,2,car,crv,122,1310,388,817,1188,429,0.29904467,20,,2,0.3611111111111111,
89,2,car,crv,250,760,448,741,510,293,0.927252,20,,2,0.3611111111111111,
90,2,car,crv,129,1303,389,814,1174,425,0.27334884,20,,2,1.28,
91,2,car,crv,247,760,448,741,513,293,0.9333165,20,,2,1.28,
92,2,car,crv,122,1311,385,813,1189,428,0.35830083,20,,2,1.24,
93,2,car,crv,246,757,442,746,511,304,0.9668414,20,,2,1.24,
94,2,car,crv,122,1312,391,808,1190,417,0.34383425,20,,2,1.28,
95,2,car,crv,248,755,446,741,507,295,0.90284395,20,,2,1.28,
96,2,car,crv,129,1303,386,819,1174,433,0.2341652,20,,2,0.368824531516184,
97,2,car,crv,252,756,447,744,504,297,0.9354642,20,,2,0.368824531516184,
98,2,car,crv,253,756,446,744,503,298,0.97629297,20,,2,1.24,
99,2,car,crv,128,1307,388,817,1179,429,0.32914877,20,,2,1.2916666666666667,
100,2,car,crv,247,762,447,741,515,294,0.9441378,20,,2,1.2916666666666667,
101,2,car,crv,117,1313,388,818,1196,430,0.27251616,20,,2,0.3595317725752508,
102,2,car,crv,247,762,449,740,515,291,0.96550846,20,,2,0.3595317725752508,
103,2,car,crv,124,1305,387,820,1181,433,0.27402008,20,,2,0.36663844199830653,
104,2,car,crv,252,750,447,746,498,299,0.9501165,20,,2,0.36663844199830653,
105,2,car,crv,111,1317,390,812,1206,422,0.27479288,20,,2,0.34991708126036486,
106,2,car,crv,251,753,447,740,502,293,0.9438285,20,,2,0.34991708126036486,
107,2,car,crv,126,1309,390,814,1183,424,0.30222148,20,,2,1.2916666666666667,
108,2,car,crv,249,757,448,740,508,292,0.91383094,20,,2,1.2916666666666667,
109,2,car,crv,111,1317,390,811,1206,421,0.2941505,20,,2,0.3490878938640133,
110,2,car,crv,247,756,446,741,509,295,0.96245986,20,,2,0.3490878938640133,
111,2,car,crv,134,1300,387,818,1166,431,0.35928637,20,,2,1.28,
112,2,car,crv,251,757,447,743,506,296,0.9412378,20,,2,1.28,
113,2,car,crv,126,1312,388,815,1186,427,0.3965622,20,,2,1.24,
114,2,car,crv,252,758,446,743,506,297,0.9420341,20,,2,1.24,
115,2,car,crv,121,1316,389,809,1195,420,0.4096516,20,,2,1.24,
116,2,car,crv,244,761,447,742,517,295,0.9289579,20,,2,1.24,
117,2,car,crv,125,1312,392,805,1187,413,0.30284005,20,,2,1.24,
118,2,car,crv,245,760,447,739,515,292,0.9596912,20,,2,1.24,
119,2,car,crv,131,1307,388,812,1176,424,0.43397242,20,,2,1.2916666666666667,
120,2,car,crv,247,764,447,744,517,297,0.9014591,20,,2,1.2916666666666667,
121,2,car,crv,123,1315,388,811,1192,423,0.4968379,20,,2,1.24,
122,2,car,crv,246,758,446,743,512,297,0.87933147,20,,2,1.24,
123,2,car,crv,118,1312,389,813,1194,424,0.25691053,20,,2,0.35510887772194305,
124,2,car,crv,249,756,447,742,507,295,0.96910256,20,,2,0.35510887772194305,
125,2,car,crv,118,1319,389,813,1201,424,0.4023961,20,,2,1.28,
126,2,car,crv,243,757,448,743,514,295,0.94143236,20,,2,1.28,
127,2,car,crv,119,1322,385,815,1203,430,0.42900166,20,,2,1.24,
128,2,car,crv,246,762,447,741,516,294,0.790523,20,,2,1.24,
129,2,car,crv,119,1319,386,815,1200,429,0.44753623,20,,2,1.28,
130,2,car,crv,248,759,450,741,511,291,0.8263495,20,,2,1.28,
131,2,car,crv,114,1318,387,813,1204,426,0.43434885,20,,2,1.2916666666666667,
132,2,car,crv,246,759,446,744,513,298,0.9186257,20,,2,1.2916666666666667,
133,2,car,crv,119,1325,389,808,1206,419,0.46840343,20,,2,1.24,
134,2,car,crv,244,759,447,741,515,294,0.83414143,20,,2,1.24,
135,2,car,crv,116,1322,388,811,1206,423,0.44209528,20,,2,1.28,
136,2,car,crv,241,764,450,741,523,291,0.8834957,20,,2,1.28,
137,2,car,crv,334,710,446,701,376,255,0.92716336,3,0,2,0.6781914893617021,
138,2,car,crv,336,711,446,700,375,254,0.9036748,3,0,2,0.6773333333333333,
139,2,car,crv,335,709,444,701,374,257,0.9452533,3,0,2,0.6871657754010695,
0,2,car,crv,126,1304,388,820,1178,432,0.2519957,20,,2,0.366723259762309,
1,2,car,crv,253,757,448,737,504,289,0.9349736,20,,2,0.366723259762309,
2,2,car,crv,122,1317,387,818,1195,431,0.38155946,20,,2,1.24,
3,2,car,crv,248,756,447,743,508,296,0.9098617,20,,2,1.24,
4,2,car,crv,120,1319,389,808,1199,419,0.49123806,20,,2,1.24,
5,2,car,crv,241,764,446,743,523,297,0.8688812,20,,2,1.24,
6,2,car,crv,251,754,448,736,503,288,0.9627608,20,,2,1.28,
7,2,car,crv,114,1312,387,822,1198,435,0.2406673,20,,2,0.3631051752921536,
8,2,car,crv,253,758,447,739,505,292,0.9361756,20,,2,0.3631051752921536,
9,2,car,crv,121,1313,387,820,1192,433,0.26400292,20,,2,1.24,
10,2,car,crv,246,754,446,742,508,296,0.95298326,20,,2,1.24,
11,2,car,crv,131,1305,389,817,1174,428,0.29075116,20,,2,0.3645655877342419,
12,2,car,crv,252,754,448,743,502,295,0.94248277,20,,2,0.3645655877342419,
13,2,car,crv,130,1307,389,819,1177,430,0.2569041,20,,2,1.24,
14,2,car,crv,256,753,448,740,497,292,0.955823,20,,2,1.24,
15,2,car,crv,127,1305,390,811,1178,421,0.25976446,20,,2,0.35738539898132426,
16,2,car,crv,250,757,443,743,507,300,0.9547171,20,,2,0.35738539898132426,
17,2,car,crv,123,1309,392,810,1186,418,0.28978387,20,,2,1.24,
18,2,car,crv,248,758,446,738,510,292,0.96847486,20,,2,1.24,
19,2,car,crv,123,1304,388,814,1181,426,0.2588897,20,,2,0.3607112616426757,
20,2,car,crv,250,759,447,742,509,295,0.9416412,20,,2,0.3607112616426757,
21,2,car,crv,130,1306,391,810,1176,419,0.26097575,20,,2,0.3562925170068027,
22,2,car,crv,250,756,447,739,506,292,0.95065075,20,,2,0.3562925170068027,
23,2,car,crv,123,1309,389,813,1186,424,0.31858423,20,,2,1.24,
24,2,car,crv,248,758,447,745,510,298,0.9534346,20,,2,1.24,
25,2,car,crv,121,1305,386,819,1184,433,0.24762785,20,,2,0.3657094594594595,
26,2,car,crv,248,759,448,745,511,297,0.96054053,20,,2,0.3657094594594595,
27,2,car,crv,251,754,443,743,503,300,0.96310854,20,,2,1.24,
28,2,car,crv,117,1318,387,822,1201,435,0.42310923,20,,2,1.2916666666666667,
29,2,car,crv,248,763,450,742,515,292,0.92204607,20,,2,1.2916666666666667,
30,2,car,crv,119,1311,391,813,1192,422,0.25885653,20,,2,1.25,
31,2,car,crv,246,752,446,739,506,293,0.95473194,20,,2,1.25,
32,2,car,crv,128,1304,388,815,1176,427,0.30647025,20,,2,1.28,
33,2,car,crv,251,758,443,746,507,303,0.93285924,20,,2,1.28,
34,2,car,crv,250,754,447,738,504,291,0.9767751,20,,2,1.24,
35,2,car,crv,109,1318,388,813,1209,425,0.32027155,20,,2,1.28,
36,2,car,crv,245,760,445,741,515,296,0.9680706,20,,2,1.28,
37,2,car,crv,127,1308,391,816,1181,425,0.2964813,20,,2,1.2916666666666667,
38,2,car,crv,250,757,447,742,507,295,0.9490655,20,,2,1.2916666666666667,
39,2,car,crv,125,1314,388,816,1189,428,0.42268884,20,,2,1.28,
40,2,car,crv,248,760,449,737,512,288,0.90941703,20,,2,1.28,
41,2,car,crv,129,1304,390,814,1175,424,0.26254445,20,,2,1.2916666666666667,
42,2,car,crv,252,755,447,740,503,293,0.94612926,20,,2,1.2916666666666667,
43,2,car,crv,114,1320,387,815,1206,428,0.30274954,20,,2,1.24,
44,2,car,crv,248,753,446,740,505,294,0.8954264,20,,2,1.24,
45,2,car,crv,127,1307,391,814,1180,423,0.278648,20,,2,0.35847457627118645,
46,2,car,crv,250,755,447,744,505,297,0.95984495,20,,2,0.35847457627118645,
47,2,car,crv,127,1302,386,816,1175,430,0.37110242,20,,2,1.28,
48,2,car,crv,246,757,444,747,511,303,0.96607155,20,,2,1.28,
49,2,car,crv,119,1307,387,816,1188,429,0.28644451,20,,2,0.3611111111111111,
50,2,car,crv,248,759,443,747,511,304,0.9593547,20,,2,0.3611111111111111,
51,2,car,crv,127,1306,389,820,1179,431,0.37050778,20,,2,1.24,
52,2,car,crv,252,758,449,742,506,293,0.9203835,20,,2,1.24,
53,2,car,crv,126,1306,387,819,1180,432,0.24266188,20,,2,0.36610169491525424,
54,2,car,crv,247,754,449,740,507,291,0.94762105,20,,2,0.36610169491525424,
55,2,car,crv,113,1317,388,815,1204,427,0.36209753,20,,2,1.24,
56,2,car,crv,247,755,446,738,508,292,0.93217456,20,,2,1.24,
57,2,car,crv,116,1312,386,813,1196,427,0.26130736,20,,2,0.35702341137123744,
58,2,car,crv,249,755,445,740,506,295,0.95275867,20,,2,0.35702341137123744,
59,2,car,crv,250,753,445,746,503,301,0.97777426,20,,2,1.24,
60,2,car,crv,117,1316,390,813,1199,423,0.30318785,20,,2,0.35279399499582986,
61,2,car,crv,239,759,447,740,520,293,0.956478,20,,2,0.35279399499582986,
62,2,car,crv,126,1307,387,813,1181,426,0.3400013,20,,2,1.24,
63,2,car,crv,250,757,446,745,507,299,0.93553233,20,,2,1.24,
64,2,car,crv,118,1316,385,817,1198,432,0.46192503,20,,2,1.24,
65,2,car,crv,242,760,449,744,518,295,0.9251644,20,,2,1.24,
66,2,car,crv,125,1310,389,811,1185,422,0.32076746,20,,2,0.3561181434599156,
67,2,car,crv,250,758,446,739,508,293,0.9462212,20,,2,0.3561181434599156,
68,2,car,crv,250,754,444,740,504,296,0.96969557,20,,2,1.24,
69,2,car,crv,113,1313,388,814,1200,426,0.2754978,20,,2,1.24,
70,2,car,crv,244,756,445,743,512,298,0.96916515,20,,2,1.24,
71,2,car,crv,123,1309,388,814,1186,426,0.2760011,20,,2,1.24,
72,2,car,crv,249,758,446,740,509,294,0.950518,20,,2,1.24,
73,2,car,crv,253,754,447,737,501,290,0.94723046,20,,2,1.24,
74,2,car,crv,121,1308,387,817,1187,430,0.21458383,20,,2,0.36225779275484415,
75,2,car,crv,250,754,447,740,504,293,0.9610552,20,,2,0.36225779275484415,
76,2,car,crv,119,1317,388,814,1198,426,0.4732625,20,,2,1.24,
77,2,car,crv,245,758,448,742,513,294,0.94409996,20,,2,1.24,
78,2,car,crv,121,1308,388,815,1187,427,0.21448645,20,,2,0.35973041280539175,
79,2,car,crv,249,753,445,746,504,301,0.9724925,20,,2,0.35973041280539175,
80,2,car,crv,135,1302,387,821,1167,434,0.35179994,20,,2,1.2916666666666667,
81,2,car,crv,250,760,450,741,510,291,0.8736024,20,,2,1.2916666666666667,
82,2,car,crv,117,1313,390,812,1196,422,0.32242462,20,,2,1.2916666666666667,
83,2,car,crv,243,759,447,742,516,295,0.9675998,20,,2,1.2916666666666667,
84,2,car,crv,122,1311,387,814,1189,427,0.36553156,20,,2,1.2916666666666667,
85,2,car,crv,250,757,444,744,507,300,0.9479286,20,,2,1.2916666666666667,
86,2,car,crv,115,1321,388,815,1206,427,0.3674716,20,,2,1.24,
87,2,car,crv,248,756,446,740,508,294,0.92142504,20,,2,1.24,
88,2,car,crv,109,1315,384,827,1206,443,0.2820505,20,,2,1.24,
89,2,car,crv,249,758,449,736,509,287,0.91024953,20,,2,1.24,
90,2,car,crv,122,1310,388,817,1188,429,0.29904467,20,,2,0.3611111111111111,
91,2,car,crv,250,760,448,741,510,293,0.927252,20,,2,0.3611111111111111,
92,2,car,crv,129,1303,389,814,1174,425,0.27334884,20,,2,1.28,
93,2,car,crv,247,760,448,741,513,293,0.9333165,20,,2,1.28,
94,2,car,crv,122,1311,385,813,1189,428,0.35830083,20,,2,1.24,
95,2,car,crv,246,757,442,746,511,304,0.9668414,20,,2,1.24,
96,2,car,crv,122,1312,391,808,1190,417,0.34383425,20,,2,1.28,
97,2,car,crv,248,755,446,741,507,295,0.90284395,20,,2,1.28,
98,2,car,crv,129,1303,386,819,1174,433,0.2341652,20,,2,0.368824531516184,
99,2,car,crv,252,756,447,744,504,297,0.9354642,20,,2,0.368824531516184,
100,2,car,crv,253,756,446,744,503,298,0.97629297,20,,2,1.24,
101,2,car,crv,128,1307,388,817,1179,429,0.32914877,20,,2,1.2916666666666667,
102,2,car,crv,247,762,447,741,515,294,0.9441378,20,,2,1.2916666666666667,
103,2,car,crv,117,1313,388,818,1196,430,0.27251616,20,,2,0.3595317725752508,
104,2,car,crv,247,762,449,740,515,291,0.96550846,20,,2,0.3595317725752508,
105,2,car,crv,124,1305,387,820,1181,433,0.27402008,20,,2,0.36663844199830653,
106,2,car,crv,252,750,447,746,498,299,0.9501165,20,,2,0.36663844199830653,
107,2,car,crv,111,1317,390,812,1206,422,0.27479288,20,,2,0.34991708126036486,
108,2,car,crv,251,753,447,740,502,293,0.9438285,20,,2,0.34991708126036486,
109,2,car,crv,126,1309,390,814,1183,424,0.30222148,20,,2,1.2916666666666667,
110,2,car,crv,249,757,448,740,508,292,0.91383094,20,,2,1.2916666666666667,
111,2,car,crv,111,1317,390,811,1206,421,0.2941505,20,,2,0.3490878938640133,
112,2,car,crv,247,756,446,741,509,295,0.96245986,20,,2,0.3490878938640133,
113,2,car,crv,134,1300,387,818,1166,431,0.35928637,20,,2,1.28,
114,2,car,crv,251,757,447,743,506,296,0.9412378,20,,2,1.28,
115,2,car,crv,126,1312,388,815,1186,427,0.3965622,20,,2,1.24,
116,2,car,crv,252,758,446,743,506,297,0.9420341,20,,2,1.24,
117,2,car,crv,121,1316,389,809,1195,420,0.4096516,20,,2,1.24,
118,2,car,crv,244,761,447,742,517,295,0.9289579,20,,2,1.24,
119,2,car,crv,125,1312,392,805,1187,413,0.30284005,20,,2,1.24,
120,2,car,crv,245,760,447,739,515,292,0.9596912,20,,2,1.24,
121,2,car,crv,131,1307,388,812,1176,424,0.43397242,20,,2,1.2916666666666667,
122,2,car,crv,247,764,447,744,517,297,0.9014591,20,,2,1.2916666666666667,
123,2,car,crv,123,1315,388,811,1192,423,0.4968379,20,,2,1.24,
124,2,car,crv,246,758,446,743,512,297,0.87933147,20,,2,1.24,
125,2,car,crv,118,1312,389,813,1194,424,0.25691053,20,,2,0.35510887772194305,
126,2,car,crv,249,756,447,742,507,295,0.96910256,20,,2,0.35510887772194305,
127,2,car,crv,118,1319,389,813,1201,424,0.4023961,20,,2,1.28,
128,2,car,crv,243,757,448,743,514,295,0.94143236,20,,2,1.28,
129,2,car,crv,119,1322,385,815,1203,430,0.42900166,20,,2,1.24,
130,2,car,crv,246,762,447,741,516,294,0.790523,20,,2,1.24,
131,2,car,crv,119,1319,386,815,1200,429,0.44753623,20,,2,1.28,
132,2,car,crv,248,759,450,741,511,291,0.8263495,20,,2,1.28,
133,2,car,crv,114,1318,387,813,1204,426,0.43434885,20,,2,1.2916666666666667,
134,2,car,crv,246,759,446,744,513,298,0.9186257,20,,2,1.2916666666666667,
135,2,car,crv,119,1325,389,808,1206,419,0.46840343,20,,2,1.24,
136,2,car,crv,244,759,447,741,515,294,0.83414143,20,,2,1.24,
137,2,car,crv,116,1322,388,811,1206,423,0.44209528,20,,2,1.28,
138,2,car,crv,241,764,450,741,523,291,0.8834957,20,,2,1.28,
139,2,car,crv,334,710,446,701,376,255,0.92716336,3,0,2,0.6781914893617021,
140,2,car,crv,336,711,446,700,375,254,0.9036748,3,0,2,0.6773333333333333,
141,2,car,crv,335,709,444,701,374,257,0.9452533,3,0,2,0.6871657754010695,
0,2,car,crv,119,1314,386,816,1195,430,0.45291424,20,,2,1.2916666666666667,
1,2,car,crv,250,759,449,744,509,295,0.90196574,20,,2,1.2916666666666667,
2,2,car,crv,126,1304,388,820,1178,432,0.2519957,20,,2,0.366723259762309,
3,2,car,crv,253,757,448,737,504,289,0.9349736,20,,2,0.366723259762309,
4,2,car,crv,122,1317,387,818,1195,431,0.38155946,20,,2,1.24,
5,2,car,crv,248,756,447,743,508,296,0.9098617,20,,2,1.24,
6,2,car,crv,120,1319,389,808,1199,419,0.49123806,20,,2,1.24,
7,2,car,crv,241,764,446,743,523,297,0.8688812,20,,2,1.24,
8,2,car,crv,251,754,448,736,503,288,0.9627608,20,,2,1.28,
9,2,car,crv,114,1312,387,822,1198,435,0.2406673,20,,2,0.3631051752921536,
10,2,car,crv,253,758,447,739,505,292,0.9361756,20,,2,0.3631051752921536,
11,2,car,crv,121,1313,387,820,1192,433,0.26400292,20,,2,1.24,
12,2,car,crv,246,754,446,742,508,296,0.95298326,20,,2,1.24,
13,2,car,crv,131,1305,389,817,1174,428,0.29075116,20,,2,0.3645655877342419,
14,2,car,crv,252,754,448,743,502,295,0.94248277,20,,2,0.3645655877342419,
15,2,car,crv,130,1307,389,819,1177,430,0.2569041,20,,2,1.24,
16,2,car,crv,256,753,448,740,497,292,0.955823,20,,2,1.24,
17,2,car,crv,127,1305,390,811,1178,421,0.25976446,20,,2,0.35738539898132426,
18,2,car,crv,250,757,443,743,507,300,0.9547171,20,,2,0.35738539898132426,
19,2,car,crv,123,1309,392,810,1186,418,0.28978387,20,,2,1.24,
20,2,car,crv,248,758,446,738,510,292,0.96847486,20,,2,1.24,
21,2,car,crv,123,1304,388,814,1181,426,0.2588897,20,,2,0.3607112616426757,
22,2,car,crv,250,759,447,742,509,295,0.9416412,20,,2,0.3607112616426757,
23,2,car,crv,130,1306,391,810,1176,419,0.26097575,20,,2,0.3562925170068027,
24,2,car,crv,250,756,447,739,506,292,0.95065075,20,,2,0.3562925170068027,
25,2,car,crv,123,1309,389,813,1186,424,0.31858423,20,,2,1.24,
26,2,car,crv,248,758,447,745,510,298,0.9534346,20,,2,1.24,
27,2,car,crv,121,1305,386,819,1184,433,0.24762785,20,,2,0.3657094594594595,
28,2,car,crv,248,759,448,745,511,297,0.96054053,20,,2,0.3657094594594595,
29,2,car,crv,251,754,443,743,503,300,0.96310854,20,,2,1.24,
30,2,car,crv,117,1318,387,822,1201,435,0.42310923,20,,2,1.2916666666666667,
31,2,car,crv,248,763,450,742,515,292,0.92204607,20,,2,1.2916666666666667,
32,2,car,crv,119,1311,391,813,1192,422,0.25885653,20,,2,1.25,
33,2,car,crv,246,752,446,739,506,293,0.95473194,20,,2,1.25,
34,2,car,crv,128,1304,388,815,1176,427,0.30647025,20,,2,1.28,
35,2,car,crv,251,758,443,746,507,303,0.93285924,20,,2,1.28,
36,2,car,crv,250,754,447,738,504,291,0.9767751,20,,2,1.24,
37,2,car,crv,109,1318,388,813,1209,425,0.32027155,20,,2,1.28,
38,2,car,crv,245,760,445,741,515,296,0.9680706,20,,2,1.28,
39,2,car,crv,127,1308,391,816,1181,425,0.2964813,20,,2,1.2916666666666667,
40,2,car,crv,250,757,447,742,507,295,0.9490655,20,,2,1.2916666666666667,
41,2,car,crv,125,1314,388,816,1189,428,0.42268884,20,,2,1.28,
42,2,car,crv,248,760,449,737,512,288,0.90941703,20,,2,1.28,
43,2,car,crv,129,1304,390,814,1175,424,0.26254445,20,,2,1.2916666666666667,
44,2,car,crv,252,755,447,740,503,293,0.94612926,20,,2,1.2916666666666667,
45,2,car,crv,114,1320,387,815,1206,428,0.30274954,20,,2,1.24,
46,2,car,crv,248,753,446,740,505,294,0.8954264,20,,2,1.24,
47,2,car,crv,127,1307,391,814,1180,423,0.278648,20,,2,0.35847457627118645,
48,2,car,crv,250,755,447,744,505,297,0.95984495,20,,2,0.35847457627118645,
49,2,car,crv,127,1302,386,816,1175,430,0.37110242,20,,2,1.28,
50,2,car,crv,246,757,444,747,511,303,0.96607155,20,,2,1.28,
51,2,car,crv,119,1307,387,816,1188,429,0.28644451,20,,2,0.3611111111111111,
52,2,car,crv,248,759,443,747,511,304,0.9593547,20,,2,0.3611111111111111,
53,2,car,crv,127,1306,389,820,1179,431,0.37050778,20,,2,1.24,
54,2,car,crv,252,758,449,742,506,293,0.9203835,20,,2,1.24,
55,2,car,crv,126,1306,387,819,1180,432,0.24266188,20,,2,0.36610169491525424,
56,2,car,crv,247,754,449,740,507,291,0.94762105,20,,2,0.36610169491525424,
57,2,car,crv,113,1317,388,815,1204,427,0.36209753,20,,2,1.24,
58,2,car,crv,247,755,446,738,508,292,0.93217456,20,,2,1.24,
59,2,car,crv,116,1312,386,813,1196,427,0.26130736,20,,2,0.35702341137123744,
60,2,car,crv,249,755,445,740,506,295,0.95275867,20,,2,0.35702341137123744,
61,2,car,crv,250,753,445,746,503,301,0.97777426,20,,2,1.24,
62,2,car,crv,117,1316,390,813,1199,423,0.30318785,20,,2,0.35279399499582986,
63,2,car,crv,239,759,447,740,520,293,0.956478,20,,2,0.35279399499582986,
64,2,car,crv,126,1307,387,813,1181,426,0.3400013,20,,2,1.24,
65,2,car,crv,250,757,446,745,507,299,0.93553233,20,,2,1.24,
66,2,car,crv,118,1316,385,817,1198,432,0.46192503,20,,2,1.24,
67,2,car,crv,242,760,449,744,518,295,0.9251644,20,,2,1.24,
68,2,car,crv,125,1310,389,811,1185,422,0.32076746,20,,2,0.3561181434599156,
69,2,car,crv,250,758,446,739,508,293,0.9462212,20,,2,0.3561181434599156,
70,2,car,crv,250,754,444,740,504,296,0.96969557,20,,2,1.24,
71,2,car,crv,113,1313,388,814,1200,426,0.2754978,20,,2,1.24,
72,2,car,crv,244,756,445,743,512,298,0.96916515,20,,2,1.24,
73,2,car,crv,123,1309,388,814,1186,426,0.2760011,20,,2,1.24,
74,2,car,crv,249,758,446,740,509,294,0.950518,20,,2,1.24,
75,2,car,crv,253,754,447,737,501,290,0.94723046,20,,2,1.24,
76,2,car,crv,121,1308,387,817,1187,430,0.21458383,20,,2,0.36225779275484415,
77,2,car,crv,250,754,447,740,504,293,0.9610552,20,,2,0.36225779275484415,
78,2,car,crv,119,1317,388,814,1198,426,0.4732625,20,,2,1.24,
79,2,car,crv,245,758,448,742,513,294,0.94409996,20,,2,1.24,
80,2,car,crv,121,1308,388,815,1187,427,0.21448645,20,,2,0.35973041280539175,
81,2,car,crv,249,753,445,746,504,301,0.9724925,20,,2,0.35973041280539175,
82,2,car,crv,135,1302,387,821,1167,434,0.35179994,20,,2,1.2916666666666667,
83,2,car,crv,250,760,450,741,510,291,0.8736024,20,,2,1.2916666666666667,
84,2,car,crv,117,1313,390,812,1196,422,0.32242462,20,,2,1.2916666666666667,
85,2,car,crv,243,759,447,742,516,295,0.9675998,20,,2,1.2916666666666667,
86,2,car,crv,122,1311,387,814,1189,427,0.36553156,20,,2,1.2916666666666667,
87,2,car,crv,250,757,444,744,507,300,0.9479286,20,,2,1.2916666666666667,
88,2,car,crv,115,1321,388,815,1206,427,0.3674716,20,,2,1.24,
89,2,car,crv,248,756,446,740,508,294,0.92142504,20,,2,1.24,
90,2,car,crv,109,1315,384,827,1206,443,0.2820505,20,,2,1.24,
91,2,car,crv,249,758,449,736,509,287,0.91024953,20,,2,1.24,
92,2,car,crv,122,1310,388,817,1188,429,0.29904467,20,,2,0.3611111111111111,
93,2,car,crv,250,760,448,741,510,293,0.927252,20,,2,0.3611111111111111,
94,2,car,crv,129,1303,389,814,1174,425,0.27334884,20,,2,1.28,
95,2,car,crv,247,760,448,741,513,293,0.9333165,20,,2,1.28,
96,2,car,crv,122,1311,385,813,1189,428,0.35830083,20,,2,1.24,
97,2,car,crv,246,757,442,746,511,304,0.9668414,20,,2,1.24,
98,2,car,crv,122,1312,391,808,1190,417,0.34383425,20,,2,1.28,
99,2,car,crv,248,755,446,741,507,295,0.90284395,20,,2,1.28,
100,2,car,crv,129,1303,386,819,1174,433,0.2341652,20,,2,0.368824531516184,
101,2,car,crv,252,756,447,744,504,297,0.9354642,20,,2,0.368824531516184,
102,2,car,crv,253,756,446,744,503,298,0.97629297,20,,2,1.24,
103,2,car,crv,128,1307,388,817,1179,429,0.32914877,20,,2,1.2916666666666667,
104,2,car,crv,247,762,447,741,515,294,0.9441378,20,,2,1.2916666666666667,
105,2,car,crv,117,1313,388,818,1196,430,0.27251616,20,,2,0.3595317725752508,
106,2,car,crv,247,762,449,740,515,291,0.96550846,20,,2,0.3595317725752508,
107,2,car,crv,124,1305,387,820,1181,433,0.27402008,20,,2,0.36663844199830653,
108,2,car,crv,252,750,447,746,498,299,0.9501165,20,,2,0.36663844199830653,
109,2,car,crv,111,1317,390,812,1206,422,0.27479288,20,,2,0.34991708126036486,
110,2,car,crv,251,753,447,740,502,293,0.9438285,20,,2,0.34991708126036486,
111,2,car,crv,126,1309,390,814,1183,424,0.30222148,20,,2,1.2916666666666667,
112,2,car,crv,249,757,448,740,508,292,0.91383094,20,,2,1.2916666666666667,
113,2,car,crv,111,1317,390,811,1206,421,0.2941505,20,,2,0.3490878938640133,
114,2,car,crv,247,756,446,741,509,295,0.96245986,20,,2,0.3490878938640133,
115,2,car,crv,134,1300,387,818,1166,431,0.35928637,20,,2,1.28,
116,2,car,crv,251,757,447,743,506,296,0.9412378,20,,2,1.28,
117,2,car,crv,126,1312,388,815,1186,427,0.3965622,20,,2,1.24,
118,2,car,crv,252,758,446,743,506,297,0.9420341,20,,2,1.24,
119,2,car,crv,121,1316,389,809,1195,420,0.4096516,20,,2,1.24,
120,2,car,crv,244,761,447,742,517,295,0.9289579,20,,2,1.24,
121,2,car,crv,125,1312,392,805,1187,413,0.30284005,20,,2,1.24,
122,2,car,crv,245,760,447,739,515,292,0.9596912,20,,2,1.24,
123,2,car,crv,131,1307,388,812,1176,424,0.43397242,20,,2,1.2916666666666667,
124,2,car,crv,247,764,447,744,517,297,0.9014591,20,,2,1.2916666666666667,
125,2,car,crv,123,1315,388,811,1192,423,0.4968379,20,,2,1.24,
126,2,car,crv,246,758,446,743,512,297,0.87933147,20,,2,1.24,
127,2,car,crv,118,1312,389,813,1194,424,0.25691053,20,,2,0.35510887772194305,
128,2,car,crv,249,756,447,742,507,295,0.96910256,20,,2,0.35510887772194305,
129,2,car,crv,118,1319,389,813,1201,424,0.4023961,20,,2,1.28,
130,2,car,crv,243,757,448,743,514,295,0.94143236,20,,2,1.28,
131,2,car,crv,119,1322,385,815,1203,430,0.42900166,20,,2,1.24,
132,2,car,crv,246,762,447,741,516,294,0.790523,20,,2,1.24,
133,2,car,crv,119,1319,386,815,1200,429,0.44753623,20,,2,1.28,
134,2,car,crv,248,759,450,741,511,291,0.8263495,20,,2,1.28,
135,2,car,crv,114,1318,387,813,1204,426,0.43434885,20,,2,1.2916666666666667,
136,2,car,crv,246,759,446,744,513,298,0.9186257,20,,2,1.2916666666666667,
137,2,car,crv,119,1325,389,808,1206,419,0.46840343,20,,2,1.24,
138,2,car,crv,244,759,447,741,515,294,0.83414143,20,,2,1.24,
139,2,car,crv,116,1322,388,811,1206,423,0.44209528,20,,2,1.28,
140,2,car,crv,241,764,450,741,523,291,0.8834957,20,,2,1.28,
141,2,car,crv,334,710,446,701,376,255,0.92716336,3,0,2,0.6781914893617021,
142,2,car,crv,336,711,446,700,375,254,0.9036748,3,0,2,0.6773333333333333,
143,2,car,crv,335,709,444,701,374,257,0.9452533,3,0,2,0.6871657754010695,
0,2,car,crv,128,1307,392,813,1179,421,0.25620303,20,,2,0.3570822731128075,
1,2,car,crv,251,756,447,741,505,294,0.9512551,20,,2,0.3570822731128075,
2,2,car,crv,119,1314,386,816,1195,430,0.45291424,20,,2,1.2916666666666667,
3,2,car,crv,250,759,449,744,509,295,0.90196574,20,,2,1.2916666666666667,
4,2,car,crv,126,1304,388,820,1178,432,0.2519957,20,,2,0.366723259762309,
5,2,car,crv,253,757,448,737,504,289,0.9349736,20,,2,0.366723259762309,
6,2,car,crv,122,1317,387,818,1195,431,0.38155946,20,,2,1.24,
7,2,car,crv,248,756,447,743,508,296,0.9098617,20,,2,1.24,
8,2,car,crv,120,1319,389,808,1199,419,0.49123806,20,,2,1.24,
9,2,car,crv,241,764,446,743,523,297,0.8688812,20,,2,1.24,
10,2,car,crv,251,754,448,736,503,288,0.9627608,20,,2,1.28,
11,2,car,crv,114,1312,387,822,1198,435,0.2406673,20,,2,0.3631051752921536,
12,2,car,crv,253,758,447,739,505,292,0.9361756,20,,2,0.3631051752921536,
13,2,car,crv,121,1313,387,820,1192,433,0.26400292,20,,2,1.24,
14,2,car,crv,246,754,446,742,508,296,0.95298326,20,,2,1.24,
15,2,car,crv,131,1305,389,817,1174,428,0.29075116,20,,2,0.3645655877342419,
16,2,car,crv,252,754,448,743,502,295,0.94248277,20,,2,0.3645655877342419,
17,2,car,crv,130,1307,389,819,1177,430,0.2569041,20,,2,1.24,
18,2,car,crv,256,753,448,740,497,292,0.955823,20,,2,1.24,
19,2,car,crv,127,1305,390,811,1178,421,0.25976446,20,,2,0.35738539898132426,
20,2,car,crv,250,757,443,743,507,300,0.9547171,20,,2,0.35738539898132426,
21,2,car,crv,123,1309,392,810,1186,418,0.28978387,20,,2,1.24,
22,2,car,crv,248,758,446,738,510,292,0.96847486,20,,2,1.24,
23,2,car,crv,123,1304,388,814,1181,426,0.2588897,20,,2,0.3607112616426757,
24,2,car,crv,250,759,447,742,509,295,0.9416412,20,,2,0.3607112616426757,
25,2,car,crv,130,1306,391,810,1176,419,0.26097575,20,,2,0.3562925170068027,
26,2,car,crv,250,756,447,739,506,292,0.95065075,20,,2,0.3562925170068027,
27,2,car,crv,123,1309,389,813,1186,424,0.31858423,20,,2,1.24,
28,2,car,crv,248,758,447,745,510,298,0.9534346,20,,2,1.24,
29,2,car,crv,121,1305,386,819,1184,433,0.24762785,20,,2,0.3657094594594595,
30,2,car,crv,248,759,448,745,511,297,0.96054053,20,,2,0.3657094594594595,
31,2,car,crv,251,754,443,743,503,300,0.96310854,20,,2,1.24,
32,2,car,crv,117,1318,387,822,1201,435,0.42310923,20,,2,1.2916666666666667,
33,2,car,crv,248,763,450,742,515,292,0.92204607,20,,2,1.2916666666666667,
34,2,car,crv,119,1311,391,813,1192,422,0.25885653,20,,2,1.25,
35,2,car,crv,246,752,446,739,506,293,0.95473194,20,,2,1.25,
36,2,car,crv,128,1304,388,815,1176,427,0.30647025,20,,2,1.28,
37,2,car,crv,251,758,443,746,507,303,0.93285924,20,,2,1.28,
38,2,car,crv,250,754,447,738,504,291,0.9767751,20,,2,1.24,
39,2,car,crv,109,1318,388,813,1209,425,0.32027155,20,,2,1.28,
40,2,car,crv,245,760,445,741,515,296,0.9680706,20,,2,1.28,
41,2,car,crv,127,1308,391,816,1181,425,0.2964813,20,,2,1.2916666666666667,
42,2,car,crv,250,757,447,742,507,295,0.9490655,20,,2,1.2916666666666667,
43,2,car,crv,125,1314,388,816,1189,428,0.42268884,20,,2,1.28,
44,2,car,crv,248,760,449,737,512,288,0.90941703,20,,2,1.28,
45,2,car,crv,129,1304,390,814,1175,424,0.26254445,20,,2,1.2916666666666667,
46,2,car,crv,252,755,447,740,503,293,0.94612926,20,,2,1.2916666666666667,
47,2,car,crv,114,1320,387,815,1206,428,0.30274954,20,,2,1.24,
48,2,car,crv,248,753,446,740,505,294,0.8954264,20,,2,1.24,
49,2,car,crv,127,1307,391,814,1180,423,0.278648,20,,2,0.35847457627118645,
50,2,car,crv,250,755,447,744,505,297,0.95984495,20,,2,0.35847457627118645,
51,2,car,crv,127,1302,386,816,1175,430,0.37110242,20,,2,1.28,
52,2,car,crv,246,757,444,747,511,303,0.96607155,20,,2,1.28,
53,2,car,crv,119,1307,387,816,1188,429,0.28644451,20,,2,0.3611111111111111,
54,2,car,crv,248,759,443,747,511,304,0.9593547,20,,2,0.3611111111111111,
55,2,car,crv,127,1306,389,820,1179,431,0.37050778,20,,2,1.24,
56,2,car,crv,252,758,449,742,506,293,0.9203835,20,,2,1.24,
57,2,car,crv,126,1306,387,819,1180,432,0.24266188,20,,2,0.36610169491525424,
58,2,car,crv,247,754,449,740,507,291,0.94762105,20,,2,0.36610169491525424,
59,2,car,crv,113,1317,388,815,1204,427,0.36209753,20,,2,1.24,
60,2,car,crv,247,755,446,738,508,292,0.93217456,20,,2,1.24,
61,2,car,crv,116,1312,386,813,1196,427,0.26130736,20,,2,0.35702341137123744,
62,2,car,crv,249,755,445,740,506,295,0.95275867,20,,2,0.35702341137123744,
63,2,car,crv,250,753,445,746,503,301,0.97777426,20,,2,1.24,
64,2,car,crv,117,1316,390,813,1199,423,0.30318785,20,,2,0.35279399499582986,
65,2,car,crv,239,759,447,740,520,293,0.956478,20,,2,0.35279399499582986,
66,2,car,crv,126,1307,387,813,1181,426,0.3400013,20,,2,1.24,
67,2,car,crv,250,757,446,745,507,299,0.93553233,20,,2,1.24,
68,2,car,crv,118,1316,385,817,1198,432,0.46192503,20,,2,1.24,
69,2,car,crv,242,760,449,744,518,295,0.9251644,20,,2,1.24,
70,2,car,crv,125,1310,389,811,1185,422,0.32076746,20,,2,0.3561181434599156,
71,2,car,crv,250,758,446,739,508,293,0.9462212,20,,2,0.3561181434599156,
72,2,car,crv,250,754,444,740,504,296,0.96969557,20,,2,1.24,
73,2,car,crv,113,1313,388,814,1200,426,0.2754978,20,,2,1.24,
74,2,car,crv,244,756,445,743,512,298,0.96916515,20,,2,1.24,
75,2,car,crv,123,1309,388,814,1186,426,0.2760011,20,,2,1.24,
76,2,car,crv,249,758,446,740,509,294,0.950518,20,,2,1.24,
77,2,car,crv,253,754,447,737,501,290,0.94723046,20,,2,1.24,
78,2,car,crv,121,1308,387,817,1187,430,0.21458383,20,,2,0.36225779275484415,
79,2,car,crv,250,754,447,740,504,293,0.9610552,20,,2,0.36225779275484415,
80,2,car,crv,119,1317,388,814,1198,426,0.4732625,20,,2,1.24,
81,2,car,crv,245,758,448,742,513,294,0.94409996,20,,2,1.24,
82,2,car,crv,121,1308,388,815,1187,427,0.21448645,20,,2,0.35973041280539175,
83,2,car,crv,249,753,445,746,504,301,0.9724925,20,,2,0.35973041280539175,
84,2,car,crv,135,1302,387,821,1167,434,0.35179994,20,,2,1.2916666666666667,
85,2,car,crv,250,760,450,741,510,291,0.8736024,20,,2,1.2916666666666667,
86,2,car,crv,117,1313,390,812,1196,422,0.32242462,20,,2,1.2916666666666667,
87,2,car,crv,243,759,447,742,516,295,0.9675998,20,,2,1.2916666666666667,
88,2,car,crv,122,1311,387,814,1189,427,0.36553156,20,,2,1.2916666666666667,
89,2,car,crv,250,757,444,744,507,300,0.9479286,20,,2,1.2916666666666667,
90,2,car,crv,115,1321,388,815,1206,427,0.3674716,20,,2,1.24,
91,2,car,crv,248,756,446,740,508,294,0.92142504,20,,2,1.24,
92,2,car,crv,109,1315,384,827,1206,443,0.2820505,20,,2,1.24,
93,2,car,crv,249,758,449,736,509,287,0.91024953,20,,2,1.24,
94,2,car,crv,122,1310,388,817,1188,429,0.29904467,20,,2,0.3611111111111111,
95,2,car,crv,250,760,448,741,510,293,0.927252,20,,2,0.3611111111111111,
96,2,car,crv,129,1303,389,814,1174,425,0.27334884,20,,2,1.28,
97,2,car,crv,247,760,448,741,513,293,0.9333165,20,,2,1.28,
98,2,car,crv,122,1311,385,813,1189,428,0.35830083,20,,2,1.24,
99,2,car,crv,246,757,442,746,511,304,0.9668414,20,,2,1.24,
100,2,car,crv,122,1312,391,808,1190,417,0.34383425,20,,2,1.28,
101,2,car,crv,248,755,446,741,507,295,0.90284395,20,,2,1.28,
102,2,car,crv,129,1303,386,819,1174,433,0.2341652,20,,2,0.368824531516184,
103,2,car,crv,252,756,447,744,504,297,0.9354642,20,,2,0.368824531516184,
104,2,car,crv,253,756,446,744,503,298,0.97629297,20,,2,1.24,
105,2,car,crv,128,1307,388,817,1179,429,0.32914877,20,,2,1.2916666666666667,
106,2,car,crv,247,762,447,741,515,294,0.9441378,20,,2,1.2916666666666667,
107,2,car,crv,117,1313,388,818,1196,430,0.27251616,20,,2,0.3595317725752508,
108,2,car,crv,247,762,449,740,515,291,0.96550846,20,,2,0.3595317725752508,
109,2,car,crv,124,1305,387,820,1181,433,0.27402008,20,,2,0.36663844199830653,
110,2,car,crv,252,750,447,746,498,299,0.9501165,20,,2,0.36663844199830653,
111,2,car,crv,111,1317,390,812,1206,422,0.27479288,20,,2,0.34991708126036486,
112,2,car,crv,251,753,447,740,502,293,0.9438285,20,,2,0.34991708126036486,
113,2,car,crv,126,1309,390,814,1183,424,0.30222148,20,,2,1.2916666666666667,
114,2,car,crv,249,757,448,740,508,292,0.91383094,20,,2,1.2916666666666667,
115,2,car,crv,111,1317,390,811,1206,421,0.2941505,20,,2,0.3490878938640133,
116,2,car,crv,247,756,446,741,509,295,0.96245986,20,,2,0.3490878938640133,
117,2,car,crv,134,1300,387,818,1166,431,0.35928637,20,,2,1.28,
118,2,car,crv,251,757,447,743,506,296,0.9412378,20,,2,1.28,
119,2,car,crv,126,1312,388,815,1186,427,0.3965622,20,,2,1.24,
120,2,car,crv,252,758,446,743,506,297,0.9420341,20,,2,1.24,
121,2,car,crv,121,1316,389,809,1195,420,0.4096516,20,,2,1.24,
122,2,car,crv,244,761,447,742,517,295,0.9289579,20,,2,1.24,
123,2,car,crv,125,1312,392,805,1187,413,0.30284005,20,,2,1.24,
124,2,car,crv,245,760,447,739,515,292,0.9596912,20,,2,1.24,
125,2,car,crv,131,1307,388,812,1176,424,0.43397242,20,,2,1.2916666666666667,
126,2,car,crv,247,764,447,744,517,297,0.9014591,20,,2,1.2916666666666667,
127,2,car,crv,123,1315,388,811,1192,423,0.4968379,20,,2,1.24,
128,2,car,crv,246,758,446,743,512,297,0.87933147,20,,2,1.24,
129,2,car,crv,118,1312,389,813,1194,424,0.25691053,20,,2,0.35510887772194305,
130,2,car,crv,249,756,447,742,507,295,0.96910256,20,,2,0.35510887772194305,
131,2,car,crv,118,1319,389,813,1201,424,0.4023961,20,,2,1.28,
132,2,car,crv,243,757,448,743,514,295,0.94143236,20,,2,1.28,
133,2,car,crv,119,1322,385,815,1203,430,0.42900166,20,,2,1.24,
134,2,car,crv,246,762,447,741,516,294,0.790523,20,,2,1.24,
135,2,car,crv,119,1319,386,815,1200,429,0.44753623,20,,2,1.28,
136,2,car,crv,248,759,450,741,511,291,0.8263495,20,,2,1.28,
137,2,car,crv,114,1318,387,813,1204,426,0.43434885,20,,2,1.2916666666666667,
138,2,car,crv,246,759,446,744,513,298,0.9186257,20,,2,1.2916666666666667,
139,2,car,crv,119,1325,389,808,1206,419,0.46840343,20,,2,1.24,
140,2,car,crv,244,759,447,741,515,294,0.83414143,20,,2,1.24,
141,2,car,crv,116,1322,388,811,1206,423,0.44209528,20,,2,1.28,
142,2,car,crv,241,764,450,741,523,291,0.8834957,20,,2,1.28,
143,2,car,crv,334,710,446,701,376,255,0.92716336,3,0,2,0.6781914893617021,
144,2,car,crv,336,711,446,700,375,254,0.9036748,3,0,2,0.6773333333333333,
145,2,car,crv,335,709,444,701,374,257,0.9452533,3,0,2,0.6871657754010695,
0,2,car,crv,119,1318,391,816,1199,425,0.41724253,20,,2,1.3333333333333333,
1,2,car,crv,247,759,447,741,512,294,0.9398525,20,,2,1.3333333333333333,
2,2,car,crv,128,1307,392,813,1179,421,0.25620303,20,,2,0.3570822731128075,
3,2,car,crv,251,756,447,741,505,294,0.9512551,20,,2,0.3570822731128075,
4,2,car,crv,119,1314,386,816,1195,430,0.45291424,20,,2,1.2916666666666667,
5,2,car,crv,250,759,449,744,509,295,0.90196574,20,,2,1.2916666666666667,
6,2,car,crv,126,1304,388,820,1178,432,0.2519957,20,,2,0.366723259762309,
7,2,car,crv,253,757,448,737,504,289,0.9349736,20,,2,0.366723259762309,
8,2,car,crv,122,1317,387,818,1195,431,0.38155946,20,,2,1.24,
9,2,car,crv,248,756,447,743,508,296,0.9098617,20,,2,1.24,
10,2,car,crv,120,1319,389,808,1199,419,0.49123806,20,,2,1.24,
11,2,car,crv,241,764,446,743,523,297,0.8688812,20,,2,1.24,
12,2,car,crv,251,754,448,736,503,288,0.9627608,20,,2,1.28,
13,2,car,crv,114,1312,387,822,1198,435,0.2406673,20,,2,0.3631051752921536,
14,2,car,crv,253,758,447,739,505,292,0.9361756,20,,2,0.3631051752921536,
15,2,car,crv,121,1313,387,820,1192,433,0.26400292,20,,2,1.24,
16,2,car,crv,246,754,446,742,508,296,0.95298326,20,,2,1.24,
17,2,car,crv,131,1305,389,817,1174,428,0.29075116,20,,2,0.3645655877342419,
18,2,car,crv,252,754,448,743,502,295,0.94248277,20,,2,0.3645655877342419,
19,2,car,crv,130,1307,389,819,1177,430,0.2569041,20,,2,1.24,
20,2,car,crv,256,753,448,740,497,292,0.955823,20,,2,1.24,
21,2,car,crv,127,1305,390,811,1178,421,0.25976446,20,,2,0.35738539898132426,
22,2,car,crv,250,757,443,743,507,300,0.9547171,20,,2,0.35738539898132426,
23,2,car,crv,123,1309,392,810,1186,418,0.28978387,20,,2,1.24,
24,2,car,crv,248,758,446,738,510,292,0.96847486,20,,2,1.24,
25,2,car,crv,123,1304,388,814,1181,426,0.2588897,20,,2,0.3607112616426757,
26,2,car,crv,250,759,447,742,509,295,0.9416412,20,,2,0.3607112616426757,
27,2,car,crv,130,1306,391,810,1176,419,0.26097575,20,,2,0.3562925170068027,
28,2,car,crv,250,756,447,739,506,292,0.95065075,20,,2,0.3562925170068027,
29,2,car,crv,123,1309,389,813,1186,424,0.31858423,20,,2,1.24,
30,2,car,crv,248,758,447,745,510,298,0.9534346,20,,2,1.24,
31,2,car,crv,121,1305,386,819,1184,433,0.24762785,20,,2,0.3657094594594595,
32,2,car,crv,248,759,448,745,511,297,0.96054053,20,,2,0.3657094594594595,
33,2,car,crv,251,754,443,743,503,300,0.96310854,20,,2,1.24,
34,2,car,crv,117,1318,387,822,1201,435,0.42310923,20,,2,1.2916666666666667,
35,2,car,crv,248,763,450,742,515,292,0.92204607,20,,2,1.2916666666666667,
36,2,car,crv,119,1311,391,813,1192,422,0.25885653,20,,2,1.25,
37,2,car,crv,246,752,446,739,506,293,0.95473194,20,,2,1.25,
38,2,car,crv,128,1304,388,815,1176,427,0.30647025,20,,2,1.28,
39,2,car,crv,251,758,443,746,507,303,0.93285924,20,,2,1.28,
40,2,car,crv,250,754,447,738,504,291,0.9767751,20,,2,1.24,
41,2,car,crv,109,1318,388,813,1209,425,0.32027155,20,,2,1.28,
42,2,car,crv,245,760,445,741,515,296,0.9680706,20,,2,1.28,
43,2,car,crv,127,1308,391,816,1181,425,0.2964813,20,,2,1.2916666666666667,
44,2,car,crv,250,757,447,742,507,295,0.9490655,20,,2,1.2916666666666667,
45,2,car,crv,125,1314,388,816,1189,428,0.42268884,20,,2,1.28,
46,2,car,crv,248,760,449,737,512,288,0.90941703,20,,2,1.28,
47,2,car,crv,129,1304,390,814,1175,424,0.26254445,20,,2,1.2916666666666667,
48,2,car,crv,252,755,447,740,503,293,0.94612926,20,,2,1.2916666666666667,
49,2,car,crv,114,1320,387,815,1206,428,0.30274954,20,,2,1.24,
50,2,car,crv,248,753,446,740,505,294,0.8954264,20,,2,1.24,
51,2,car,crv,127,1307,391,814,1180,423,0.278648,20,,2,0.35847457627118645,
52,2,car,crv,250,755,447,744,505,297,0.95984495,20,,2,0.35847457627118645,
53,2,car,crv,127,1302,386,816,1175,430,0.37110242,20,,2,1.28,
54,2,car,crv,246,757,444,747,511,303,0.96607155,20,,2,1.28,
55,2,car,crv,119,1307,387,816,1188,429,0.28644451,20,,2,0.3611111111111111,
56,2,car,crv,248,759,443,747,511,304,0.9593547,20,,2,0.3611111111111111,
57,2,car,crv,127,1306,389,820,1179,431,0.37050778,20,,2,1.24,
58,2,car,crv,252,758,449,742,506,293,0.9203835,20,,2,1.24,
59,2,car,crv,126,1306,387,819,1180,432,0.24266188,20,,2,0.36610169491525424,
60,2,car,crv,247,754,449,740,507,291,0.94762105,20,,2,0.36610169491525424,
61,2,car,crv,113,1317,388,815,1204,427,0.36209753,20,,2,1.24,
62,2,car,crv,247,755,446,738,508,292,0.93217456,20,,2,1.24,
63,2,car,crv,116,1312,386,813,1196,427,0.26130736,20,,2,0.35702341137123744,
64,2,car,crv,249,755,445,740,506,295,0.95275867,20,,2,0.35702341137123744,
65,2,car,crv,250,753,445,746,503,301,0.97777426,20,,2,1.24,
66,2,car,crv,117,1316,390,813,1199,423,0.30318785,20,,2,0.35279399499582986,
67,2,car,crv,239,759,447,740,520,293,0.956478,20,,2,0.35279399499582986,
68,2,car,crv,126,1307,387,813,1181,426,0.3400013,20,,2,1.24,
69,2,car,crv,250,757,446,745,507,299,0.93553233,20,,2,1.24,
70,2,car,crv,118,1316,385,817,1198,432,0.46192503,20,,2,1.24,
71,2,car,crv,242,760,449,744,518,295,0.9251644,20,,2,1.24,
72,2,car,crv,125,1310,389,811,1185,422,0.32076746,20,,2,0.3561181434599156,
73,2,car,crv,250,758,446,739,508,293,0.9462212,20,,2,0.3561181434599156,
74,2,car,crv,250,754,444,740,504,296,0.96969557,20,,2,1.24,
75,2,car,crv,113,1313,388,814,1200,426,0.2754978,20,,2,1.24,
76,2,car,crv,244,756,445,743,512,298,0.96916515,20,,2,1.24,
77,2,car,crv,123,1309,388,814,1186,426,0.2760011,20,,2,1.24,
78,2,car,crv,249,758,446,740,509,294,0.950518,20,,2,1.24,
79,2,car,crv,253,754,447,737,501,290,0.94723046,20,,2,1.24,
80,2,car,crv,121,1308,387,817,1187,430,0.21458383,20,,2,0.36225779275484415,
81,2,car,crv,250,754,447,740,504,293,0.9610552,20,,2,0.36225779275484415,
82,2,car,crv,119,1317,388,814,1198,426,0.4732625,20,,2,1.24,
83,2,car,crv,245,758,448,742,513,294,0.94409996,20,,2,1.24,
84,2,car,crv,121,1308,388,815,1187,427,0.21448645,20,,2,0.35973041280539175,
85,2,car,crv,249,753,445,746,504,301,0.9724925,20,,2,0.35973041280539175,
86,2,car,crv,135,1302,387,821,1167,434,0.35179994,20,,2,1.2916666666666667,
87,2,car,crv,250,760,450,741,510,291,0.8736024,20,,2,1.2916666666666667,
88,2,car,crv,117,1313,390,812,1196,422,0.32242462,20,,2,1.2916666666666667,
89,2,car,crv,243,759,447,742,516,295,0.9675998,20,,2,1.2916666666666667,
90,2,car,crv,122,1311,387,814,1189,427,0.36553156,20,,2,1.2916666666666667,
91,2,car,crv,250,757,444,744,507,300,0.9479286,20,,2,1.2916666666666667,
92,2,car,crv,115,1321,388,815,1206,427,0.3674716,20,,2,1.24,
93,2,car,crv,248,756,446,740,508,294,0.92142504,20,,2,1.24,
94,2,car,crv,109,1315,384,827,1206,443,0.2820505,20,,2,1.24,
95,2,car,crv,249,758,449,736,509,287,0.91024953,20,,2,1.24,
96,2,car,crv,122,1310,388,817,1188,429,0.29904467,20,,2,0.3611111111111111,
97,2,car,crv,250,760,448,741,510,293,0.927252,20,,2,0.3611111111111111,
98,2,car,crv,129,1303,389,814,1174,425,0.27334884,20,,2,1.28,
99,2,car,crv,247,760,448,741,513,293,0.9333165,20,,2,1.28,
100,2,car,crv,122,1311,385,813,1189,428,0.35830083,20,,2,1.24,
101,2,car,crv,246,757,442,746,511,304,0.9668414,20,,2,1.24,
102,2,car,crv,122,1312,391,808,1190,417,0.34383425,20,,2,1.28,
103,2,car,crv,248,755,446,741,507,295,0.90284395,20,,2,1.28,
104,2,car,crv,129,1303,386,819,1174,433,0.2341652,20,,2,0.368824531516184,
105,2,car,crv,252,756,447,744,504,297,0.9354642,20,,2,0.368824531516184,
106,2,car,crv,253,756,446,744,503,298,0.97629297,20,,2,1.24,
107,2,car,crv,128,1307,388,817,1179,429,0.32914877,20,,2,1.2916666666666667,
108,2,car,crv,247,762,447,741,515,294,0.9441378,20,,2,1.2916666666666667,
109,2,car,crv,117,1313,388,818,1196,430,0.27251616,20,,2,0.3595317725752508,
110,2,car,crv,247,762,449,740,515,291,0.96550846,20,,2,0.3595317725752508,
111,2,car,crv,124,1305,387,820,1181,433,0.27402008,20,,2,0.36663844199830653,
112,2,car,crv,252,750,447,746,498,299,0.9501165,20,,2,0.36663844199830653,
113,2,car,crv,111,1317,390,812,1206,422,0.27479288,20,,2,0.34991708126036486,
114,2,car,crv,251,753,447,740,502,293,0.9438285,20,,2,0.34991708126036486,
115,2,car,crv,126,1309,390,814,1183,424,0.30222148,20,,2,1.2916666666666667,
116,2,car,crv,249,757,448,740,508,292,0.91383094,20,,2,1.2916666666666667,
117,2,car,crv,111,1317,390,811,1206,421,0.2941505,20,,2,0.3490878938640133,
118,2,car,crv,247,756,446,741,509,295,0.96245986,20,,2,0.3490878938640133,
119,2,car,crv,134,1300,387,818,1166,431,0.35928637,20,,2,1.28,
120,2,car,crv,251,757,447,743,506,296,0.9412378,20,,2,1.28,
121,2,car,crv,126,1312,388,815,1186,427,0.3965622,20,,2,1.24,
122,2,car,crv,252,758,446,743,506,297,0.9420341,20,,2,1.24,
123,2,car,crv,121,1316,389,809,1195,420,0.4096516,20,,2,1.24,
124,2,car,crv,244,761,447,742,517,295,0.9289579,20,,2,1.24,
125,2,car,crv,125,1312,392,805,1187,413,0.30284005,20,,2,1.24,
126,2,car,crv,245,760,447,739,515,292,0.9596912,20,,2,1.24,
127,2,car,crv,131,1307,388,812,1176,424,0.43397242,20,,2,1.2916666666666667,
128,2,car,crv,247,764,447,744,517,297,0.9014591,20,,2,1.2916666666666667,
129,2,car,crv,123,1315,388,811,1192,423,0.4968379,20,,2,1.24,
130,2,car,crv,246,758,446,743,512,297,0.87933147,20,,2,1.24,
131,2,car,crv,118,1312,389,813,1194,424,0.25691053,20,,2,0.35510887772194305,
132,2,car,crv,249,756,447,742,507,295,0.96910256,20,,2,0.35510887772194305,
133,2,car,crv,118,1319,389,813,1201,424,0.4023961,20,,2,1.28,
134,2,car,crv,243,757,448,743,514,295,0.94143236,20,,2,1.28,
135,2,car,crv,119,1322,385,815,1203,430,0.42900166,20,,2,1.24,
136,2,car,crv,246,762,447,741,516,294,0.790523,20,,2,1.24,
137,2,car,crv,119,1319,386,815,1200,429,0.44753623,20,,2,1.28,
138,2,car,crv,248,759,450,741,511,291,0.8263495,20,,2,1.28,
139,2,car,crv,114,1318,387,813,1204,426,0.43434885,20,,2,1.2916666666666667,
140,2,car,crv,246,759,446,744,513,298,0.9186257,20,,2,1.2916666666666667,
141,2,car,crv,119,1325,389,808,1206,419,0.46840343,20,,2,1.24,
142,2,car,crv,244,759,447,741,515,294,0.83414143,20,,2,1.24,
143,2,car,crv,116,1322,388,811,1206,423,0.44209528,20,,2,1.28,
144,2,car,crv,241,764,450,741,523,291,0.8834957,20,,2,1.28,
145,2,car,crv,334,710,446,701,376,255,0.92716336,3,0,2,0.6781914893617021,
146,2,car,crv,336,711,446,700,375,254,0.9036748,3,0,2,0.6773333333333333,
147,2,car,crv,335,709,444,701,374,257,0.9452533,3,0,2,0.6871657754010695,
0,2,car,crv,117,1315,387,816,1198,429,0.4219676,20,,2,1.2307692307692308,
1,2,car,crv,251,757,449,740,506,291,0.9306962,20,,2,1.2307692307692308,
2,2,car,crv,119,1318,391,816,1199,425,0.41724253,20,,2,1.3333333333333333,
3,2,car,crv,247,759,447,741,512,294,0.9398525,20,,2,1.3333333333333333,
4,2,car,crv,128,1307,392,813,1179,421,0.25620303,20,,2,0.3570822731128075,
5,2,car,crv,251,756,447,741,505,294,0.9512551,20,,2,0.3570822731128075,
6,2,car,crv,119,1314,386,816,1195,430,0.45291424,20,,2,1.2916666666666667,
7,2,car,crv,250,759,449,744,509,295,0.90196574,20,,2,1.2916666666666667,
8,2,car,crv,126,1304,388,820,1178,432,0.2519957,20,,2,0.366723259762309,
9,2,car,crv,253,757,448,737,504,289,0.9349736,20,,2,0.366723259762309,
10,2,car,crv,122,1317,387,818,1195,431,0.38155946,20,,2,1.24,
11,2,car,crv,248,756,447,743,508,296,0.9098617,20,,2,1.24,
12,2,car,crv,120,1319,389,808,1199,419,0.49123806,20,,2,1.24,
13,2,car,crv,241,764,446,743,523,297,0.8688812,20,,2,1.24,
14,2,car,crv,251,754,448,736,503,288,0.9627608,20,,2,1.28,
15,2,car,crv,114,1312,387,822,1198,435,0.2406673,20,,2,0.3631051752921536,
16,2,car,crv,253,758,447,739,505,292,0.9361756,20,,2,0.3631051752921536,
17,2,car,crv,121,1313,387,820,1192,433,0.26400292,20,,2,1.24,
18,2,car,crv,246,754,446,742,508,296,0.95298326,20,,2,1.24,
19,2,car,crv,131,1305,389,817,1174,428,0.29075116,20,,2,0.3645655877342419,
20,2,car,crv,252,754,448,743,502,295,0.94248277,20,,2,0.3645655877342419,
21,2,car,crv,130,1307,389,819,1177,430,0.2569041,20,,2,1.24,
22,2,car,crv,256,753,448,740,497,292,0.955823,20,,2,1.24,
23,2,car,crv,127,1305,390,811,1178,421,0.25976446,20,,2,0.35738539898132426,
24,2,car,crv,250,757,443,743,507,300,0.9547171,20,,2,0.35738539898132426,
25,2,car,crv,123,1309,392,810,1186,418,0.28978387,20,,2,1.24,
26,2,car,crv,248,758,446,738,510,292,0.96847486,20,,2,1.24,
27,2,car,crv,123,1304,388,814,1181,426,0.2588897,20,,2,0.3607112616426757,
28,2,car,crv,250,759,447,742,509,295,0.9416412,20,,2,0.3607112616426757,
29,2,car,crv,130,1306,391,810,1176,419,0.26097575,20,,2,0.3562925170068027,
30,2,car,crv,250,756,447,739,506,292,0.95065075,20,,2,0.3562925170068027,
31,2,car,crv,123,1309,389,813,1186,424,0.31858423,20,,2,1.24,
32,2,car,crv,248,758,447,745,510,298,0.9534346,20,,2,1.24,
33,2,car,crv,121,1305,386,819,1184,433,0.24762785,20,,2,0.3657094594594595,
34,2,car,crv,248,759,448,745,511,297,0.96054053,20,,2,0.3657094594594595,
35,2,car,crv,251,754,443,743,503,300,0.96310854,20,,2,1.24,
36,2,car,crv,117,1318,387,822,1201,435,0.42310923,20,,2,1.2916666666666667,
37,2,car,crv,248,763,450,742,515,292,0.92204607,20,,2,1.2916666666666667,
38,2,car,crv,119,1311,391,813,1192,422,0.25885653,20,,2,1.25,
39,2,car,crv,246,752,446,739,506,293,0.95473194,20,,2,1.25,
40,2,car,crv,128,1304,388,815,1176,427,0.30647025,20,,2,1.28,
41,2,car,crv,251,758,443,746,507,303,0.93285924,20,,2,1.28,
42,2,car,crv,250,754,447,738,504,291,0.9767751,20,,2,1.24,
43,2,car,crv,109,1318,388,813,1209,425,0.32027155,20,,2,1.28,
44,2,car,crv,245,760,445,741,515,296,0.9680706,20,,2,1.28,
45,2,car,crv,127,1308,391,816,1181,425,0.2964813,20,,2,1.2916666666666667,
46,2,car,crv,250,757,447,742,507,295,0.9490655,20,,2,1.2916666666666667,
47,2,car,crv,125,1314,388,816,1189,428,0.42268884,20,,2,1.28,
48,2,car,crv,248,760,449,737,512,288,0.90941703,20,,2,1.28,
49,2,car,crv,129,1304,390,814,1175,424,0.26254445,20,,2,1.2916666666666667,
50,2,car,crv,252,755,447,740,503,293,0.94612926,20,,2,1.2916666666666667,
51,2,car,crv,114,1320,387,815,1206,428,0.30274954,20,,2,1.24,
52,2,car,crv,248,753,446,740,505,294,0.8954264,20,,2,1.24,
53,2,car,crv,127,1307,391,814,1180,423,0.278648,20,,2,0.35847457627118645,
54,2,car,crv,250,755,447,744,505,297,0.95984495,20,,2,0.35847457627118645,
55,2,car,crv,127,1302,386,816,1175,430,0.37110242,20,,2,1.28,
56,2,car,crv,246,757,444,747,511,303,0.96607155,20,,2,1.28,
57,2,car,crv,119,1307,387,816,1188,429,0.28644451,20,,2,0.3611111111111111,
58,2,car,crv,248,759,443,747,511,304,0.9593547,20,,2,0.3611111111111111,
59,2,car,crv,127,1306,389,820,1179,431,0.37050778,20,,2,1.24,
60,2,car,crv,252,758,449,742,506,293,0.9203835,20,,2,1.24,
61,2,car,crv,126,1306,387,819,1180,432,0.24266188,20,,2,0.36610169491525424,
62,2,car,crv,247,754,449,740,507,291,0.94762105,20,,2,0.36610169491525424,
63,2,car,crv,113,1317,388,815,1204,427,0.36209753,20,,2,1.24,
64,2,car,crv,247,755,446,738,508,292,0.93217456,20,,2,1.24,
65,2,car,crv,116,1312,386,813,1196,427,0.26130736,20,,2,0.35702341137123744,
66,2,car,crv,249,755,445,740,506,295,0.95275867,20,,2,0.35702341137123744,
67,2,car,crv,250,753,445,746,503,301,0.97777426,20,,2,1.24,
68,2,car,crv,117,1316,390,813,1199,423,0.30318785,20,,2,0.35279399499582986,
69,2,car,crv,239,759,447,740,520,293,0.956478,20,,2,0.35279399499582986,
70,2,car,crv,126,1307,387,813,1181,426,0.3400013,20,,2,1.24,
71,2,car,crv,250,757,446,745,507,299,0.93553233,20,,2,1.24,
72,2,car,crv,118,1316,385,817,1198,432,0.46192503,20,,2,1.24,
73,2,car,crv,242,760,449,744,518,295,0.9251644,20,,2,1.24,
74,2,car,crv,125,1310,389,811,1185,422,0.32076746,20,,2,0.3561181434599156,
75,2,car,crv,250,758,446,739,508,293,0.9462212,20,,2,0.3561181434599156,
76,2,car,crv,250,754,444,740,504,296,0.96969557,20,,2,1.24,
77,2,car,crv,113,1313,388,814,1200,426,0.2754978,20,,2,1.24,
78,2,car,crv,244,756,445,743,512,298,0.96916515,20,,2,1.24,
79,2,car,crv,123,1309,388,814,1186,426,0.2760011,20,,2,1.24,
80,2,car,crv,249,758,446,740,509,294,0.950518,20,,2,1.24,
81,2,car,crv,253,754,447,737,501,290,0.94723046,20,,2,1.24,
82,2,car,crv,121,1308,387,817,1187,430,0.21458383,20,,2,0.36225779275484415,
83,2,car,crv,250,754,447,740,504,293,0.9610552,20,,2,0.36225779275484415,
84,2,car,crv,119,1317,388,814,1198,426,0.4732625,20,,2,1.24,
85,2,car,crv,245,758,448,742,513,294,0.94409996,20,,2,1.24,
86,2,car,crv,121,1308,388,815,1187,427,0.21448645,20,,2,0.35973041280539175,
87,2,car,crv,249,753,445,746,504,301,0.9724925,20,,2,0.35973041280539175,
88,2,car,crv,135,1302,387,821,1167,434,0.35179994,20,,2,1.2916666666666667,
89,2,car,crv,250,760,450,741,510,291,0.8736024,20,,2,1.2916666666666667,
90,2,car,crv,117,1313,390,812,1196,422,0.32242462,20,,2,1.2916666666666667,
91,2,car,crv,243,759,447,742,516,295,0.9675998,20,,2,1.2916666666666667,
92,2,car,crv,122,1311,387,814,1189,427,0.36553156,20,,2,1.2916666666666667,
93,2,car,crv,250,757,444,744,507,300,0.9479286,20,,2,1.2916666666666667,
94,2,car,crv,115,1321,388,815,1206,427,0.3674716,20,,2,1.24,
95,2,car,crv,248,756,446,740,508,294,0.92142504,20,,2,1.24,
96,2,car,crv,109,1315,384,827,1206,443,0.2820505,20,,2,1.24,
97,2,car,crv,249,758,449,736,509,287,0.91024953,20,,2,1.24,
98,2,car,crv,122,1310,388,817,1188,429,0.29904467,20,,2,0.3611111111111111,
99,2,car,crv,250,760,448,741,510,293,0.927252,20,,2,0.3611111111111111,
100,2,car,crv,129,1303,389,814,1174,425,0.27334884,20,,2,1.28,
101,2,car,crv,247,760,448,741,513,293,0.9333165,20,,2,1.28,
102,2,car,crv,122,1311,385,813,1189,428,0.35830083,20,,2,1.24,
103,2,car,crv,246,757,442,746,511,304,0.9668414,20,,2,1.24,
104,2,car,crv,122,1312,391,808,1190,417,0.34383425,20,,2,1.28,
105,2,car,crv,248,755,446,741,507,295,0.90284395,20,,2,1.28,
106,2,car,crv,129,1303,386,819,1174,433,0.2341652,20,,2,0.368824531516184,
107,2,car,crv,252,756,447,744,504,297,0.9354642,20,,2,0.368824531516184,
108,2,car,crv,253,756,446,744,503,298,0.97629297,20,,2,1.24,
109,2,car,crv,128,1307,388,817,1179,429,0.32914877,20,,2,1.2916666666666667,
110,2,car,crv,247,762,447,741,515,294,0.9441378,20,,2,1.2916666666666667,
111,2,car,crv,117,1313,388,818,1196,430,0.27251616,20,,2,0.3595317725752508,
112,2,car,crv,247,762,449,740,515,291,0.96550846,20,,2,0.3595317725752508,
113,2,car,crv,124,1305,387,820,1181,433,0.27402008,20,,2,0.36663844199830653,
114,2,car,crv,252,750,447,746,498,299,0.9501165,20,,2,0.36663844199830653,
115,2,car,crv,111,1317,390,812,1206,422,0.27479288,20,,2,0.34991708126036486,
116,2,car,crv,251,753,447,740,502,293,0.9438285,20,,2,0.34991708126036486,
117,2,car,crv,126,1309,390,814,1183,424,0.30222148,20,,2,1.2916666666666667,
118,2,car,crv,249,757,448,740,508,292,0.91383094,20,,2,1.2916666666666667,
119,2,car,crv,111,1317,390,811,1206,421,0.2941505,20,,2,0.3490878938640133,
120,2,car,crv,247,756,446,741,509,295,0.96245986,20,,2,0.3490878938640133,
121,2,car,crv,134,1300,387,818,1166,431,0.35928637,20,,2,1.28,
122,2,car,crv,251,757,447,743,506,296,0.9412378,20,,2,1.28,
123,2,car,crv,126,1312,388,815,1186,427,0.3965622,20,,2,1.24,
124,2,car,crv,252,758,446,743,506,297,0.9420341,20,,2,1.24,
125,2,car,crv,121,1316,389,809,1195,420,0.4096516,20,,2,1.24,
126,2,car,crv,244,761,447,742,517,295,0.9289579,20,,2,1.24,
127,2,car,crv,125,1312,392,805,1187,413,0.30284005,20,,2,1.24,
128,2,car,crv,245,760,447,739,515,292,0.9596912,20,,2,1.24,
129,2,car,crv,131,1307,388,812,1176,424,0.43397242,20,,2,1.2916666666666667,
130,2,car,crv,247,764,447,744,517,297,0.9014591,20,,2,1.2916666666666667,
131,2,car,crv,123,1315,388,811,1192,423,0.4968379,20,,2,1.24,
132,2,car,crv,246,758,446,743,512,297,0.87933147,20,,2,1.24,
133,2,car,crv,118,1312,389,813,1194,424,0.25691053,20,,2,0.35510887772194305,
134,2,car,crv,249,756,447,742,507,295,0.96910256,20,,2,0.35510887772194305,
135,2,car,crv,118,1319,389,813,1201,424,0.4023961,20,,2,1.28,
136,2,car,crv,243,757,448,743,514,295,0.94143236,20,,2,1.28,
137,2,car,crv,119,1322,385,815,1203,430,0.42900166,20,,2,1.24,
138,2,car,crv,246,762,447,741,516,294,0.790523,20,,2,1.24,
139,2,car,crv,119,1319,386,815,1200,429,0.44753623,20,,2,1.28,
140,2,car,crv,248,759,450,741,511,291,0.8263495,20,,2,1.28,
141,2,car,crv,114,1318,387,813,1204,426,0.43434885,20,,2,1.2916666666666667,
142,2,car,crv,246,759,446,744,513,298,0.9186257,20,,2,1.2916666666666667,
143,2,car,crv,119,1325,389,808,1206,419,0.46840343,20,,2,1.24,
144,2,car,crv,244,759,447,741,515,294,0.83414143,20,,2,1.24,
145,2,car,crv,116,1322,388,811,1206,423,0.44209528,20,,2,1.28,
146,2,car,crv,241,764,450,741,523,291,0.8834957,20,,2,1.28,
147,2,car,crv,334,710,446,701,376,255,0.92716336,3,0,2,0.6781914893617021,
148,2,car,crv,336,711,446,700,375,254,0.9036748,3,0,2,0.6773333333333333,
149,2,car,crv,335,709,444,701,374,257,0.9452533,3,0,2,0.6871657754010695,
0,2,car,crv,123,1313,389,813,1190,424,0.38111085,20,,2,1.24,
1,2,car,crv,247,755,446,744,508,298,0.8986612,20,,2,1.24,
2,2,car,crv,117,1315,387,816,1198,429,0.4219676,20,,2,1.2307692307692308,
3,2,car,crv,251,757,449,740,506,291,0.9306962,20,,2,1.2307692307692308,
4,2,car,crv,119,1318,391,816,1199,425,0.41724253,20,,2,1.3333333333333333,
5,2,car,crv,247,759,447,741,512,294,0.9398525,20,,2,1.3333333333333333,
6,2,car,crv,128,1307,392,813,1179,421,0.25620303,20,,2,0.3570822731128075,
7,2,car,crv,251,756,447,741,505,294,0.9512551,20,,2,0.3570822731128075,
8,2,car,crv,119,1314,386,816,1195,430,0.45291424,20,,2,1.2916666666666667,
9,2,car,crv,250,759,449,744,509,295,0.90196574,20,,2,1.2916666666666667,
10,2,car,crv,126,1304,388,820,1178,432,0.2519957,20,,2,0.366723259762309,
11,2,car,crv,253,757,448,737,504,289,0.9349736,20,,2,0.366723259762309,
12,2,car,crv,122,1317,387,818,1195,431,0.38155946,20,,2,1.24,
13,2,car,crv,248,756,447,743,508,296,0.9098617,20,,2,1.24,
14,2,car,crv,120,1319,389,808,1199,419,0.49123806,20,,2,1.24,
15,2,car,crv,241,764,446,743,523,297,0.8688812,20,,2,1.24,
16,2,car,crv,251,754,448,736,503,288,0.9627608,20,,2,1.28,
17,2,car,crv,114,1312,387,822,1198,435,0.2406673,20,,2,0.3631051752921536,
18,2,car,crv,253,758,447,739,505,292,0.9361756,20,,2,0.3631051752921536,
19,2,car,crv,121,1313,387,820,1192,433,0.26400292,20,,2,1.24,
20,2,car,crv,246,754,446,742,508,296,0.95298326,20,,2,1.24,
21,2,car,crv,131,1305,389,817,1174,428,0.29075116,20,,2,0.3645655877342419,
22,2,car,crv,252,754,448,743,502,295,0.94248277,20,,2,0.3645655877342419,
23,2,car,crv,130,1307,389,819,1177,430,0.2569041,20,,2,1.24,
24,2,car,crv,256,753,448,740,497,292,0.955823,20,,2,1.24,
25,2,car,crv,127,1305,390,811,1178,421,0.25976446,20,,2,0.35738539898132426,
26,2,car,crv,250,757,443,743,507,300,0.9547171,20,,2,0.35738539898132426,
27,2,car,crv,123,1309,392,810,1186,418,0.28978387,20,,2,1.24,
28,2,car,crv,248,758,446,738,510,292,0.96847486,20,,2,1.24,
29,2,car,crv,123,1304,388,814,1181,426,0.2588897,20,,2,0.3607112616426757,
30,2,car,crv,250,759,447,742,509,295,0.9416412,20,,2,0.3607112616426757,
31,2,car,crv,130,1306,391,810,1176,419,0.26097575,20,,2,0.3562925170068027,
32,2,car,crv,250,756,447,739,506,292,0.95065075,20,,2,0.3562925170068027,
33,2,car,crv,123,1309,389,813,1186,424,0.31858423,20,,2,1.24,
34,2,car,crv,248,758,447,745,510,298,0.9534346,20,,2,1.24,
35,2,car,crv,121,1305,386,819,1184,433,0.24762785,20,,2,0.3657094594594595,
36,2,car,crv,248,759,448,745,511,297,0.96054053,20,,2,0.3657094594594595,
37,2,car,crv,251,754,443,743,503,300,0.96310854,20,,2,1.24,
38,2,car,crv,117,1318,387,822,1201,435,0.42310923,20,,2,1.2916666666666667,
39,2,car,crv,248,763,450,742,515,292,0.92204607,20,,2,1.2916666666666667,
40,2,car,crv,119,1311,391,813,1192,422,0.25885653,20,,2,1.25,
41,2,car,crv,246,752,446,739,506,293,0.95473194,20,,2,1.25,
42,2,car,crv,128,1304,388,815,1176,427,0.30647025,20,,2,1.28,
43,2,car,crv,251,758,443,746,507,303,0.93285924,20,,2,1.28,
44,2,car,crv,250,754,447,738,504,291,0.9767751,20,,2,1.24,
45,2,car,crv,109,1318,388,813,1209,425,0.32027155,20,,2,1.28,
46,2,car,crv,245,760,445,741,515,296,0.9680706,20,,2,1.28,
47,2,car,crv,127,1308,391,816,1181,425,0.2964813,20,,2,1.2916666666666667,
48,2,car,crv,250,757,447,742,507,295,0.9490655,20,,2,1.2916666666666667,
49,2,car,crv,125,1314,388,816,1189,428,0.42268884,20,,2,1.28,
50,2,car,crv,248,760,449,737,512,288,0.90941703,20,,2,1.28,
51,2,car,crv,129,1304,390,814,1175,424,0.26254445,20,,2,1.2916666666666667,
52,2,car,crv,252,755,447,740,503,293,0.94612926,20,,2,1.2916666666666667,
53,2,car,crv,114,1320,387,815,1206,428,0.30274954,20,,2,1.24,
54,2,car,crv,248,753,446,740,505,294,0.8954264,20,,2,1.24,
55,2,car,crv,127,1307,391,814,1180,423,0.278648,20,,2,0.35847457627118645,
56,2,car,crv,250,755,447,744,505,297,0.95984495,20,,2,0.35847457627118645,
57,2,car,crv,127,1302,386,816,1175,430,0.37110242,20,,2,1.28,
58,2,car,crv,246,757,444,747,511,303,0.96607155,20,,2,1.28,
59,2,car,crv,119,1307,387,816,1188,429,0.28644451,20,,2,0.3611111111111111,
60,2,car,crv,248,759,443,747,511,304,0.9593547,20,,2,0.3611111111111111,
61,2,car,crv,127,1306,389,820,1179,431,0.37050778,20,,2,1.24,
62,2,car,crv,252,758,449,742,506,293,0.9203835,20,,2,1.24,
63,2,car,crv,126,1306,387,819,1180,432,0.24266188,20,,2,0.36610169491525424,
64,2,car,crv,247,754,449,740,507,291,0.94762105,20,,2,0.36610169491525424,
65,2,car,crv,113,1317,388,815,1204,427,0.36209753,20,,2,1.24,
66,2,car,crv,247,755,446,738,508,292,0.93217456,20,,2,1.24,
67,2,car,crv,116,1312,386,813,1196,427,0.26130736,20,,2,0.35702341137123744,
68,2,car,crv,249,755,445,740,506,295,0.95275867,20,,2,0.35702341137123744,
69,2,car,crv,250,753,445,746,503,301,0.97777426,20,,2,1.24,
70,2,car,crv,117,1316,390,813,1199,423,0.30318785,20,,2,0.35279399499582986,
71,2,car,crv,239,759,447,740,520,293,0.956478,20,,2,0.35279399499582986,
72,2,car,crv,126,1307,387,813,1181,426,0.3400013,20,,2,1.24,
73,2,car,crv,250,757,446,745,507,299,0.93553233,20,,2,1.24,
74,2,car,crv,118,1316,385,817,1198,432,0.46192503,20,,2,1.24,
75,2,car,crv,242,760,449,744,518,295,0.9251644,20,,2,1.24,
76,2,car,crv,125,1310,389,811,1185,422,0.32076746,20,,2,0.3561181434599156,
77,2,car,crv,250,758,446,739,508,293,0.9462212,20,,2,0.3561181434599156,
78,2,car,crv,250,754,444,740,504,296,0.96969557,20,,2,1.24,
79,2,car,crv,113,1313,388,814,1200,426,0.2754978,20,,2,1.24,
80,2,car,crv,244,756,445,743,512,298,0.96916515,20,,2,1.24,
81,2,car,crv,123,1309,388,814,1186,426,0.2760011,20,,2,1.24,
82,2,car,crv,249,758,446,740,509,294,0.950518,20,,2,1.24,
83,2,car,crv,253,754,447,737,501,290,0.94723046,20,,2,1.24,
84,2,car,crv,121,1308,387,817,1187,430,0.21458383,20,,2,0.36225779275484415,
85,2,car,crv,250,754,447,740,504,293,0.9610552,20,,2,0.36225779275484415,
86,2,car,crv,119,1317,388,814,1198,426,0.4732625,20,,2,1.24,
87,2,car,crv,245,758,448,742,513,294,0.94409996,20,,2,1.24,
88,2,car,crv,121,1308,388,815,1187,427,0.21448645,20,,2,0.35973041280539175,
89,2,car,crv,249,753,445,746,504,301,0.9724925,20,,2,0.35973041280539175,
90,2,car,crv,135,1302,387,821,1167,434,0.35179994,20,,2,1.2916666666666667,
91,2,car,crv,250,760,450,741,510,291,0.8736024,20,,2,1.2916666666666667,
92,2,car,crv,117,1313,390,812,1196,422,0.32242462,20,,2,1.2916666666666667,
93,2,car,crv,243,759,447,742,516,295,0.9675998,20,,2,1.2916666666666667,
94,2,car,crv,122,1311,387,814,1189,427,0.36553156,20,,2,1.2916666666666667,
95,2,car,crv,250,757,444,744,507,300,0.9479286,20,,2,1.2916666666666667,
96,2,car,crv,115,1321,388,815,1206,427,0.3674716,20,,2,1.24,
97,2,car,crv,248,756,446,740,508,294,0.92142504,20,,2,1.24,
98,2,car,crv,109,1315,384,827,1206,443,0.2820505,20,,2,1.24,
99,2,car,crv,249,758,449,736,509,287,0.91024953,20,,2,1.24,
100,2,car,crv,122,1310,388,817,1188,429,0.29904467,20,,2,0.3611111111111111,
101,2,car,crv,250,760,448,741,510,293,0.927252,20,,2,0.3611111111111111,
102,2,car,crv,129,1303,389,814,1174,425,0.27334884,20,,2,1.28,
103,2,car,crv,247,760,448,741,513,293,0.9333165,20,,2,1.28,
104,2,car,crv,122,1311,385,813,1189,428,0.35830083,20,,2,1.24,
105,2,car,crv,246,757,442,746,511,304,0.9668414,20,,2,1.24,
106,2,car,crv,122,1312,391,808,1190,417,0.34383425,20,,2,1.28,
107,2,car,crv,248,755,446,741,507,295,0.90284395,20,,2,1.28,
108,2,car,crv,129,1303,386,819,1174,433,0.2341652,20,,2,0.368824531516184,
109,2,car,crv,252,756,447,744,504,297,0.9354642,20,,2,0.368824531516184,
110,2,car,crv,253,756,446,744,503,298,0.97629297,20,,2,1.24,
111,2,car,crv,128,1307,388,817,1179,429,0.32914877,20,,2,1.2916666666666667,
112,2,car,crv,247,762,447,741,515,294,0.9441378,20,,2,1.2916666666666667,
113,2,car,crv,117,1313,388,818,1196,430,0.27251616,20,,2,0.3595317725752508,
114,2,car,crv,247,762,449,740,515,291,0.96550846,20,,2,0.3595317725752508,
115,2,car,crv,124,1305,387,820,1181,433,0.27402008,20,,2,0.36663844199830653,
116,2,car,crv,252,750,447,746,498,299,0.9501165,20,,2,0.36663844199830653,
117,2,car,crv,111,1317,390,812,1206,422,0.27479288,20,,2,0.34991708126036486,
118,2,car,crv,251,753,447,740,502,293,0.9438285,20,,2,0.34991708126036486,
119,2,car,crv,126,1309,390,814,1183,424,0.30222148,20,,2,1.2916666666666667,
120,2,car,crv,249,757,448,740,508,292,0.91383094,20,,2,1.2916666666666667,
121,2,car,crv,111,1317,390,811,1206,421,0.2941505,20,,2,0.3490878938640133,
122,2,car,crv,247,756,446,741,509,295,0.96245986,20,,2,0.3490878938640133,
123,2,car,crv,134,1300,387,818,1166,431,0.35928637,20,,2,1.28,
124,2,car,crv,251,757,447,743,506,296,0.9412378,20,,2,1.28,
125,2,car,crv,126,1312,388,815,1186,427,0.3965622,20,,2,1.24,
126,2,car,crv,252,758,446,743,506,297,0.9420341,20,,2,1.24,
127,2,car,crv,121,1316,389,809,1195,420,0.4096516,20,,2,1.24,
128,2,car,crv,244,761,447,742,517,295,0.9289579,20,,2,1.24,
129,2,car,crv,125,1312,392,805,1187,413,0.30284005,20,,2,1.24,
130,2,car,crv,245,760,447,739,515,292,0.9596912,20,,2,1.24,
131,2,car,crv,131,1307,388,812,1176,424,0.43397242,20,,2,1.2916666666666667,
132,2,car,crv,247,764,447,744,517,297,0.9014591,20,,2,1.2916666666666667,
133,2,car,crv,123,1315,388,811,1192,423,0.4968379,20,,2,1.24,
134,2,car,crv,246,758,446,743,512,297,0.87933147,20,,2,1.24,
135,2,car,crv,118,1312,389,813,1194,424,0.25691053,20,,2,0.35510887772194305,
136,2,car,crv,249,756,447,742,507,295,0.96910256,20,,2,0.35510887772194305,
137,2,car,crv,118,1319,389,813,1201,424,0.4023961,20,,2,1.28,
138,2,car,crv,243,757,448,743,514,295,0.94143236,20,,2,1.28,
139,2,car,crv,119,1322,385,815,1203,430,0.42900166,20,,2,1.24,
140,2,car,crv,246,762,447,741,516,294,0.790523,20,,2,1.24,
141,2,car,crv,119,1319,386,815,1200,429,0.44753623,20,,2,1.28,
142,2,car,crv,248,759,450,741,511,291,0.8263495,20,,2,1.28,
143,2,car,crv,114,1318,387,813,1204,426,0.43434885,20,,2,1.2916666666666667,
144,2,car,crv,246,759,446,744,513,298,0.9186257,20,,2,1.2916666666666667,
145,2,car,crv,119,1325,389,808,1206,419,0.46840343,20,,2,1.24,
146,2,car,crv,244,759,447,741,515,294,0.83414143,20,,2,1.24,
147,2,car,crv,116,1322,388,811,1206,423,0.44209528,20,,2,1.28,
148,2,car,crv,241,764,450,741,523,291,0.8834957,20,,2,1.28,
149,2,car,crv,334,710,446,701,376,255,0.92716336,3,0,2,0.6781914893617021,
150,2,car,crv,336,711,446,700,375,254,0.9036748,3,0,2,0.6773333333333333,
151,2,car,crv,335,709,444,701,374,257,0.9452533,3,0,2,0.6871657754010695,
0,2,car,crv,120,1318,389,815,1198,426,0.37832162,20,,2,1.24,
1,2,car,crv,248,758,449,738,510,289,0.9015974,20,,2,1.24,
2,2,car,crv,123,1313,389,813,1190,424,0.38111085,20,,2,1.24,
3,2,car,crv,247,755,446,744,508,298,0.8986612,20,,2,1.24,
4,2,car,crv,117,1315,387,816,1198,429,0.4219676,20,,2,1.2307692307692308,
5,2,car,crv,251,757,449,740,506,291,0.9306962,20,,2,1.2307692307692308,
6,2,car,crv,119,1318,391,816,1199,425,0.41724253,20,,2,1.3333333333333333,
7,2,car,crv,247,759,447,741,512,294,0.9398525,20,,2,1.3333333333333333,
8,2,car,crv,128,1307,392,813,1179,421,0.25620303,20,,2,0.3570822731128075,
9,2,car,crv,251,756,447,741,505,294,0.9512551,20,,2,0.3570822731128075,
10,2,car,crv,119,1314,386,816,1195,430,0.45291424,20,,2,1.2916666666666667,
11,2,car,crv,250,759,449,744,509,295,0.90196574,20,,2,1.2916666666666667,
12,2,car,crv,126,1304,388,820,1178,432,0.2519957,20,,2,0.366723259762309,
13,2,car,crv,253,757,448,737,504,289,0.9349736,20,,2,0.366723259762309,
14,2,car,crv,122,1317,387,818,1195,431,0.38155946,20,,2,1.24,
15,2,car,crv,248,756,447,743,508,296,0.9098617,20,,2,1.24,
16,2,car,crv,120,1319,389,808,1199,419,0.49123806,20,,2,1.24,
17,2,car,crv,241,764,446,743,523,297,0.8688812,20,,2,1.24,
18,2,car,crv,251,754,448,736,503,288,0.9627608,20,,2,1.28,
19,2,car,crv,114,1312,387,822,1198,435,0.2406673,20,,2,0.3631051752921536,
20,2,car,crv,253,758,447,739,505,292,0.9361756,20,,2,0.3631051752921536,
21,2,car,crv,121,1313,387,820,1192,433,0.26400292,20,,2,1.24,
22,2,car,crv,246,754,446,742,508,296,0.95298326,20,,2,1.24,
23,2,car,crv,131,1305,389,817,1174,428,0.29075116,20,,2,0.3645655877342419,
24,2,car,crv,252,754,448,743,502,295,0.94248277,20,,2,0.3645655877342419,
25,2,car,crv,130,1307,389,819,1177,430,0.2569041,20,,2,1.24,
26,2,car,crv,256,753,448,740,497,292,0.955823,20,,2,1.24,
27,2,car,crv,127,1305,390,811,1178,421,0.25976446,20,,2,0.35738539898132426,
28,2,car,crv,250,757,443,743,507,300,0.9547171,20,,2,0.35738539898132426,
29,2,car,crv,123,1309,392,810,1186,418,0.28978387,20,,2,1.24,
30,2,car,crv,248,758,446,738,510,292,0.96847486,20,,2,1.24,
31,2,car,crv,123,1304,388,814,1181,426,0.2588897,20,,2,0.3607112616426757,
32,2,car,crv,250,759,447,742,509,295,0.9416412,20,,2,0.3607112616426757,
33,2,car,crv,130,1306,391,810,1176,419,0.26097575,20,,2,0.3562925170068027,
34,2,car,crv,250,756,447,739,506,292,0.95065075,20,,2,0.3562925170068027,
35,2,car,crv,123,1309,389,813,1186,424,0.31858423,20,,2,1.24,
36,2,car,crv,248,758,447,745,510,298,0.9534346,20,,2,1.24,
37,2,car,crv,121,1305,386,819,1184,433,0.24762785,20,,2,0.3657094594594595,
38,2,car,crv,248,759,448,745,511,297,0.96054053,20,,2,0.3657094594594595,
39,2,car,crv,251,754,443,743,503,300,0.96310854,20,,2,1.24,
40,2,car,crv,117,1318,387,822,1201,435,0.42310923,20,,2,1.2916666666666667,
41,2,car,crv,248,763,450,742,515,292,0.92204607,20,,2,1.2916666666666667,
42,2,car,crv,119,1311,391,813,1192,422,0.25885653,20,,2,1.25,
43,2,car,crv,246,752,446,739,506,293,0.95473194,20,,2,1.25,
44,2,car,crv,128,1304,388,815,1176,427,0.30647025,20,,2,1.28,
45,2,car,crv,251,758,443,746,507,303,0.93285924,20,,2,1.28,
46,2,car,crv,250,754,447,738,504,291,0.9767751,20,,2,1.24,
47,2,car,crv,109,1318,388,813,1209,425,0.32027155,20,,2,1.28,
48,2,car,crv,245,760,445,741,515,296,0.9680706,20,,2,1.28,
49,2,car,crv,127,1308,391,816,1181,425,0.2964813,20,,2,1.2916666666666667,
50,2,car,crv,250,757,447,742,507,295,0.9490655,20,,2,1.2916666666666667,
51,2,car,crv,125,1314,388,816,1189,428,0.42268884,20,,2,1.28,
52,2,car,crv,248,760,449,737,512,288,0.90941703,20,,2,1.28,
53,2,car,crv,129,1304,390,814,1175,424,0.26254445,20,,2,1.2916666666666667,
54,2,car,crv,252,755,447,740,503,293,0.94612926,20,,2,1.2916666666666667,
55,2,car,crv,114,1320,387,815,1206,428,0.30274954,20,,2,1.24,
56,2,car,crv,248,753,446,740,505,294,0.8954264,20,,2,1.24,
57,2,car,crv,127,1307,391,814,1180,423,0.278648,20,,2,0.35847457627118645,
58,2,car,crv,250,755,447,744,505,297,0.95984495,20,,2,0.35847457627118645,
59,2,car,crv,127,1302,386,816,1175,430,0.37110242,20,,2,1.28,
60,2,car,crv,246,757,444,747,511,303,0.96607155,20,,2,1.28,
61,2,car,crv,119,1307,387,816,1188,429,0.28644451,20,,2,0.3611111111111111,
62,2,car,crv,248,759,443,747,511,304,0.9593547,20,,2,0.3611111111111111,
63,2,car,crv,127,1306,389,820,1179,431,0.37050778,20,,2,1.24,
64,2,car,crv,252,758,449,742,506,293,0.9203835,20,,2,1.24,
65,2,car,crv,126,1306,387,819,1180,432,0.24266188,20,,2,0.36610169491525424,
66,2,car,crv,247,754,449,740,507,291,0.94762105,20,,2,0.36610169491525424,
67,2,car,crv,113,1317,388,815,1204,427,0.36209753,20,,2,1.24,
68,2,car,crv,247,755,446,738,508,292,0.93217456,20,,2,1.24,
69,2,car,crv,116,1312,386,813,1196,427,0.26130736,20,,2,0.35702341137123744,
70,2,car,crv,249,755,445,740,506,295,0.95275867,20,,2,0.35702341137123744,
71,2,car,crv,250,753,445,746,503,301,0.97777426,20,,2,1.24,
72,2,car,crv,117,1316,390,813,1199,423,0.30318785,20,,2,0.35279399499582986,
73,2,car,crv,239,759,447,740,520,293,0.956478,20,,2,0.35279399499582986,
74,2,car,crv,126,1307,387,813,1181,426,0.3400013,20,,2,1.24,
75,2,car,crv,250,757,446,745,507,299,0.93553233,20,,2,1.24,
76,2,car,crv,118,1316,385,817,1198,432,0.46192503,20,,2,1.24,
77,2,car,crv,242,760,449,744,518,295,0.9251644,20,,2,1.24,
78,2,car,crv,125,1310,389,811,1185,422,0.32076746,20,,2,0.3561181434599156,
79,2,car,crv,250,758,446,739,508,293,0.9462212,20,,2,0.3561181434599156,
80,2,car,crv,250,754,444,740,504,296,0.96969557,20,,2,1.24,
81,2,car,crv,113,1313,388,814,1200,426,0.2754978,20,,2,1.24,
82,2,car,crv,244,756,445,743,512,298,0.96916515,20,,2,1.24,
83,2,car,crv,123,1309,388,814,1186,426,0.2760011,20,,2,1.24,
84,2,car,crv,249,758,446,740,509,294,0.950518,20,,2,1.24,
85,2,car,crv,253,754,447,737,501,290,0.94723046,20,,2,1.24,
86,2,car,crv,121,1308,387,817,1187,430,0.21458383,20,,2,0.36225779275484415,
87,2,car,crv,250,754,447,740,504,293,0.9610552,20,,2,0.36225779275484415,
88,2,car,crv,119,1317,388,814,1198,426,0.4732625,20,,2,1.24,
89,2,car,crv,245,758,448,742,513,294,0.94409996,20,,2,1.24,
90,2,car,crv,121,1308,388,815,1187,427,0.21448645,20,,2,0.35973041280539175,
91,2,car,crv,249,753,445,746,504,301,0.9724925,20,,2,0.35973041280539175,
92,2,car,crv,135,1302,387,821,1167,434,0.35179994,20,,2,1.2916666666666667,
93,2,car,crv,250,760,450,741,510,291,0.8736024,20,,2,1.2916666666666667,
94,2,car,crv,117,1313,390,812,1196,422,0.32242462,20,,2,1.2916666666666667,
95,2,car,crv,243,759,447,742,516,295,0.9675998,20,,2,1.2916666666666667,
96,2,car,crv,122,1311,387,814,1189,427,0.36553156,20,,2,1.2916666666666667,
97,2,car,crv,250,757,444,744,507,300,0.9479286,20,,2,1.2916666666666667,
98,2,car,crv,115,1321,388,815,1206,427,0.3674716,20,,2,1.24,
99,2,car,crv,248,756,446,740,508,294,0.92142504,20,,2,1.24,
100,2,car,crv,109,1315,384,827,1206,443,0.2820505,20,,2,1.24,
101,2,car,crv,249,758,449,736,509,287,0.91024953,20,,2,1.24,
102,2,car,crv,122,1310,388,817,1188,429,0.29904467,20,,2,0.3611111111111111,
103,2,car,crv,250,760,448,741,510,293,0.927252,20,,2,0.3611111111111111,
104,2,car,crv,129,1303,389,814,1174,425,0.27334884,20,,2,1.28,
105,2,car,crv,247,760,448,741,513,293,0.9333165,20,,2,1.28,
106,2,car,crv,122,1311,385,813,1189,428,0.35830083,20,,2,1.24,
107,2,car,crv,246,757,442,746,511,304,0.9668414,20,,2,1.24,
108,2,car,crv,122,1312,391,808,1190,417,0.34383425,20,,2,1.28,
109,2,car,crv,248,755,446,741,507,295,0.90284395,20,,2,1.28,
110,2,car,crv,129,1303,386,819,1174,433,0.2341652,20,,2,0.368824531516184,
111,2,car,crv,252,756,447,744,504,297,0.9354642,20,,2,0.368824531516184,
112,2,car,crv,253,756,446,744,503,298,0.97629297,20,,2,1.24,
113,2,car,crv,128,1307,388,817,1179,429,0.32914877,20,,2,1.2916666666666667,
114,2,car,crv,247,762,447,741,515,294,0.9441378,20,,2,1.2916666666666667,
115,2,car,crv,117,1313,388,818,1196,430,0.27251616,20,,2,0.3595317725752508,
116,2,car,crv,247,762,449,740,515,291,0.96550846,20,,2,0.3595317725752508,
117,2,car,crv,124,1305,387,820,1181,433,0.27402008,20,,2,0.36663844199830653,
118,2,car,crv,252,750,447,746,498,299,0.9501165,20,,2,0.36663844199830653,
119,2,car,crv,111,1317,390,812,1206,422,0.27479288,20,,2,0.34991708126036486,
120,2,car,crv,251,753,447,740,502,293,0.9438285,20,,2,0.34991708126036486,
121,2,car,crv,126,1309,390,814,1183,424,0.30222148,20,,2,1.2916666666666667,
122,2,car,crv,249,757,448,740,508,292,0.91383094,20,,2,1.2916666666666667,
123,2,car,crv,111,1317,390,811,1206,421,0.2941505,20,,2,0.3490878938640133,
124,2,car,crv,247,756,446,741,509,295,0.96245986,20,,2,0.3490878938640133,
125,2,car,crv,134,1300,387,818,1166,431,0.35928637,20,,2,1.28,
126,2,car,crv,251,757,447,743,506,296,0.9412378,20,,2,1.28,
127,2,car,crv,126,1312,388,815,1186,427,0.3965622,20,,2,1.24,
128,2,car,crv,252,758,446,743,506,297,0.9420341,20,,2,1.24,
129,2,car,crv,121,1316,389,809,1195,420,0.4096516,20,,2,1.24,
130,2,car,crv,244,761,447,742,517,295,0.9289579,20,,2,1.24,
131,2,car,crv,125,1312,392,805,1187,413,0.30284005,20,,2,1.24,
132,2,car,crv,245,760,447,739,515,292,0.9596912,20,,2,1.24,
133,2,car,crv,131,1307,388,812,1176,424,0.43397242,20,,2,1.2916666666666667,
134,2,car,crv,247,764,447,744,517,297,0.9014591,20,,2,1.2916666666666667,
135,2,car,crv,123,1315,388,811,1192,423,0.4968379,20,,2,1.24,
136,2,car,crv,246,758,446,743,512,297,0.87933147,20,,2,1.24,
137,2,car,crv,118,1312,389,813,1194,424,0.25691053,20,,2,0.35510887772194305,
138,2,car,crv,249,756,447,742,507,295,0.96910256,20,,2,0.35510887772194305,
139,2,car,crv,118,1319,389,813,1201,424,0.4023961,20,,2,1.28,
140,2,car,crv,243,757,448,743,514,295,0.94143236,20,,2,1.28,
141,2,car,crv,119,1322,385,815,1203,430,0.42900166,20,,2,1.24,
142,2,car,crv,246,762,447,741,516,294,0.790523,20,,2,1.24,
143,2,car,crv,119,1319,386,815,1200,429,0.44753623,20,,2,1.28,
144,2,car,crv,248,759,450,741,511,291,0.8263495,20,,2,1.28,
145,2,car,crv,114,1318,387,813,1204,426,0.43434885,20,,2,1.2916666666666667,
146,2,car,crv,246,759,446,744,513,298,0.9186257,20,,2,1.2916666666666667,
147,2,car,crv,119,1325,389,808,1206,419,0.46840343,20,,2,1.24,
148,2,car,crv,244,759,447,741,515,294,0.83414143,20,,2,1.24,
149,2,car,crv,116,1322,388,811,1206,423,0.44209528,20,,2,1.28,
150,2,car,crv,241,764,450,741,523,291,0.8834957,20,,2,1.28,
151,2,car,crv,334,710,446,701,376,255,0.92716336,3,0,2,0.6781914893617021,
152,2,car,crv,336,711,446,700,375,254,0.9036748,3,0,2,0.6773333333333333,
153,2,car,crv,335,709,444,701,374,257,0.9452533,3,0,2,0.6871657754010695,
0,2,car,crv,124,1302,388,819,1178,431,0.20558608,20,,2,0.36587436332767403,
1,2,car,crv,252,759,447,740,507,293,0.971343,20,,2,0.36587436332767403,
2,2,car,crv,120,1318,389,815,1198,426,0.37832162,20,,2,1.24,
3,2,car,crv,248,758,449,738,510,289,0.9015974,20,,2,1.24,
4,2,car,crv,123,1313,389,813,1190,424,0.38111085,20,,2,1.24,
5,2,car,crv,247,755,446,744,508,298,0.8986612,20,,2,1.24,
6,2,car,crv,117,1315,387,816,1198,429,0.4219676,20,,2,1.2307692307692308,
7,2,car,crv,251,757,449,740,506,291,0.9306962,20,,2,1.2307692307692308,
8,2,car,crv,119,1318,391,816,1199,425,0.41724253,20,,2,1.3333333333333333,
9,2,car,crv,247,759,447,741,512,294,0.9398525,20,,2,1.3333333333333333,
10,2,car,crv,128,1307,392,813,1179,421,0.25620303,20,,2,0.3570822731128075,
11,2,car,crv,251,756,447,741,505,294,0.9512551,20,,2,0.3570822731128075,
12,2,car,crv,119,1314,386,816,1195,430,0.45291424,20,,2,1.2916666666666667,
13,2,car,crv,250,759,449,744,509,295,0.90196574,20,,2,1.2916666666666667,
14,2,car,crv,126,1304,388,820,1178,432,0.2519957,20,,2,0.366723259762309,
15,2,car,crv,253,757,448,737,504,289,0.9349736,20,,2,0.366723259762309,
16,2,car,crv,122,1317,387,818,1195,431,0.38155946,20,,2,1.24,
17,2,car,crv,248,756,447,743,508,296,0.9098617,20,,2,1.24,
18,2,car,crv,120,1319,389,808,1199,419,0.49123806,20,,2,1.24,
19,2,car,crv,241,764,446,743,523,297,0.8688812,20,,2,1.24,
20,2,car,crv,251,754,448,736,503,288,0.9627608,20,,2,1.28,
21,2,car,crv,114,1312,387,822,1198,435,0.2406673,20,,2,0.3631051752921536,
22,2,car,crv,253,758,447,739,505,292,0.9361756,20,,2,0.3631051752921536,
23,2,car,crv,121,1313,387,820,1192,433,0.26400292,20,,2,1.24,
24,2,car,crv,246,754,446,742,508,296,0.95298326,20,,2,1.24,
25,2,car,crv,131,1305,389,817,1174,428,0.29075116,20,,2,0.3645655877342419,
26,2,car,crv,252,754,448,743,502,295,0.94248277,20,,2,0.3645655877342419,
27,2,car,crv,130,1307,389,819,1177,430,0.2569041,20,,2,1.24,
28,2,car,crv,256,753,448,740,497,292,0.955823,20,,2,1.24,
29,2,car,crv,127,1305,390,811,1178,421,0.25976446,20,,2,0.35738539898132426,
30,2,car,crv,250,757,443,743,507,300,0.9547171,20,,2,0.35738539898132426,
31,2,car,crv,123,1309,392,810,1186,418,0.28978387,20,,2,1.24,
32,2,car,crv,248,758,446,738,510,292,0.96847486,20,,2,1.24,
33,2,car,crv,123,1304,388,814,1181,426,0.2588897,20,,2,0.3607112616426757,
34,2,car,crv,250,759,447,742,509,295,0.9416412,20,,2,0.3607112616426757,
35,2,car,crv,130,1306,391,810,1176,419,0.26097575,20,,2,0.3562925170068027,
36,2,car,crv,250,756,447,739,506,292,0.95065075,20,,2,0.3562925170068027,
37,2,car,crv,123,1309,389,813,1186,424,0.31858423,20,,2,1.24,
38,2,car,crv,248,758,447,745,510,298,0.9534346,20,,2,1.24,
39,2,car,crv,121,1305,386,819,1184,433,0.24762785,20,,2,0.3657094594594595,
40,2,car,crv,248,759,448,745,511,297,0.96054053,20,,2,0.3657094594594595,
41,2,car,crv,251,754,443,743,503,300,0.96310854,20,,2,1.24,
42,2,car,crv,117,1318,387,822,1201,435,0.42310923,20,,2,1.2916666666666667,
43,2,car,crv,248,763,450,742,515,292,0.92204607,20,,2,1.2916666666666667,
44,2,car,crv,119,1311,391,813,1192,422,0.25885653,20,,2,1.25,
45,2,car,crv,246,752,446,739,506,293,0.95473194,20,,2,1.25,
46,2,car,crv,128,1304,388,815,1176,427,0.30647025,20,,2,1.28,
47,2,car,crv,251,758,443,746,507,303,0.93285924,20,,2,1.28,
48,2,car,crv,250,754,447,738,504,291,0.9767751,20,,2,1.24,
49,2,car,crv,109,1318,388,813,1209,425,0.32027155,20,,2,1.28,
50,2,car,crv,245,760,445,741,515,296,0.9680706,20,,2,1.28,
51,2,car,crv,127,1308,391,816,1181,425,0.2964813,20,,2,1.2916666666666667,
52,2,car,crv,250,757,447,742,507,295,0.9490655,20,,2,1.2916666666666667,
53,2,car,crv,125,1314,388,816,1189,428,0.42268884,20,,2,1.28,
54,2,car,crv,248,760,449,737,512,288,0.90941703,20,,2,1.28,
55,2,car,crv,129,1304,390,814,1175,424,0.26254445,20,,2,1.2916666666666667,
56,2,car,crv,252,755,447,740,503,293,0.94612926,20,,2,1.2916666666666667,
57,2,car,crv,114,1320,387,815,1206,428,0.30274954,20,,2,1.24,
58,2,car,crv,248,753,446,740,505,294,0.8954264,20,,2,1.24,
59,2,car,crv,127,1307,391,814,1180,423,0.278648,20,,2,0.35847457627118645,
60,2,car,crv,250,755,447,744,505,297,0.95984495,20,,2,0.35847457627118645,
61,2,car,crv,127,1302,386,816,1175,430,0.37110242,20,,2,1.28,
62,2,car,crv,246,757,444,747,511,303,0.96607155,20,,2,1.28,
63,2,car,crv,119,1307,387,816,1188,429,0.28644451,20,,2,0.3611111111111111,
64,2,car,crv,248,759,443,747,511,304,0.9593547,20,,2,0.3611111111111111,
65,2,car,crv,127,1306,389,820,1179,431,0.37050778,20,,2,1.24,
66,2,car,crv,252,758,449,742,506,293,0.9203835,20,,2,1.24,
67,2,car,crv,126,1306,387,819,1180,432,0.24266188,20,,2,0.36610169491525424,
68,2,car,crv,247,754,449,740,507,291,0.94762105,20,,2,0.36610169491525424,
69,2,car,crv,113,1317,388,815,1204,427,0.36209753,20,,2,1.24,
70,2,car,crv,247,755,446,738,508,292,0.93217456,20,,2,1.24,
71,2,car,crv,116,1312,386,813,1196,427,0.26130736,20,,2,0.35702341137123744,
72,2,car,crv,249,755,445,740,506,295,0.95275867,20,,2,0.35702341137123744,
73,2,car,crv,250,753,445,746,503,301,0.97777426,20,,2,1.24,
74,2,car,crv,117,1316,390,813,1199,423,0.30318785,20,,2,0.35279399499582986,
75,2,car,crv,239,759,447,740,520,293,0.956478,20,,2,0.35279399499582986,
76,2,car,crv,126,1307,387,813,1181,426,0.3400013,20,,2,1.24,
77,2,car,crv,250,757,446,745,507,299,0.93553233,20,,2,1.24,
78,2,car,crv,118,1316,385,817,1198,432,0.46192503,20,,2,1.24,
79,2,car,crv,242,760,449,744,518,295,0.9251644,20,,2,1.24,
80,2,car,crv,125,1310,389,811,1185,422,0.32076746,20,,2,0.3561181434599156,
81,2,car,crv,250,758,446,739,508,293,0.9462212,20,,2,0.3561181434599156,
82,2,car,crv,250,754,444,740,504,296,0.96969557,20,,2,1.24,
83,2,car,crv,113,1313,388,814,1200,426,0.2754978,20,,2,1.24,
84,2,car,crv,244,756,445,743,512,298,0.96916515,20,,2,1.24,
85,2,car,crv,123,1309,388,814,1186,426,0.2760011,20,,2,1.24,
86,2,car,crv,249,758,446,740,509,294,0.950518,20,,2,1.24,
87,2,car,crv,253,754,447,737,501,290,0.94723046,20,,2,1.24,
88,2,car,crv,121,1308,387,817,1187,430,0.21458383,20,,2,0.36225779275484415,
89,2,car,crv,250,754,447,740,504,293,0.9610552,20,,2,0.36225779275484415,
90,2,car,crv,119,1317,388,814,1198,426,0.4732625,20,,2,1.24,
91,2,car,crv,245,758,448,742,513,294,0.94409996,20,,2,1.24,
92,2,car,crv,121,1308,388,815,1187,427,0.21448645,20,,2,0.35973041280539175,
93,2,car,crv,249,753,445,746,504,301,0.9724925,20,,2,0.35973041280539175,
94,2,car,crv,135,1302,387,821,1167,434,0.35179994,20,,2,1.2916666666666667,
95,2,car,crv,250,760,450,741,510,291,0.8736024,20,,2,1.2916666666666667,
96,2,car,crv,117,1313,390,812,1196,422,0.32242462,20,,2,1.2916666666666667,
97,2,car,crv,243,759,447,742,516,295,0.9675998,20,,2,1.2916666666666667,
98,2,car,crv,122,1311,387,814,1189,427,0.36553156,20,,2,1.2916666666666667,
99,2,car,crv,250,757,444,744,507,300,0.9479286,20,,2,1.2916666666666667,
100,2,car,crv,115,1321,388,815,1206,427,0.3674716,20,,2,1.24,
101,2,car,crv,248,756,446,740,508,294,0.92142504,20,,2,1.24,
102,2,car,crv,109,1315,384,827,1206,443,0.2820505,20,,2,1.24,
103,2,car,crv,249,758,449,736,509,287,0.91024953,20,,2,1.24,
104,2,car,crv,122,1310,388,817,1188,429,0.29904467,20,,2,0.3611111111111111,
105,2,car,crv,250,760,448,741,510,293,0.927252,20,,2,0.3611111111111111,
106,2,car,crv,129,1303,389,814,1174,425,0.27334884,20,,2,1.28,
107,2,car,crv,247,760,448,741,513,293,0.9333165,20,,2,1.28,
108,2,car,crv,122,1311,385,813,1189,428,0.35830083,20,,2,1.24,
109,2,car,crv,246,757,442,746,511,304,0.9668414,20,,2,1.24,
110,2,car,crv,122,1312,391,808,1190,417,0.34383425,20,,2,1.28,
111,2,car,crv,248,755,446,741,507,295,0.90284395,20,,2,1.28,
112,2,car,crv,129,1303,386,819,1174,433,0.2341652,20,,2,0.368824531516184,
113,2,car,crv,252,756,447,744,504,297,0.9354642,20,,2,0.368824531516184,
114,2,car,crv,253,756,446,744,503,298,0.97629297,20,,2,1.24,
115,2,car,crv,128,1307,388,817,1179,429,0.32914877,20,,2,1.2916666666666667,
116,2,car,crv,247,762,447,741,515,294,0.9441378,20,,2,1.2916666666666667,
117,2,car,crv,117,1313,388,818,1196,430,0.27251616,20,,2,0.3595317725752508,
118,2,car,crv,247,762,449,740,515,291,0.96550846,20,,2,0.3595317725752508,
119,2,car,crv,124,1305,387,820,1181,433,0.27402008,20,,2,0.36663844199830653,
120,2,car,crv,252,750,447,746,498,299,0.9501165,20,,2,0.36663844199830653,
121,2,car,crv,111,1317,390,812,1206,422,0.27479288,20,,2,0.34991708126036486,
122,2,car,crv,251,753,447,740,502,293,0.9438285,20,,2,0.34991708126036486,
123,2,car,crv,126,1309,390,814,1183,424,0.30222148,20,,2,1.2916666666666667,
124,2,car,crv,249,757,448,740,508,292,0.91383094,20,,2,1.2916666666666667,
125,2,car,crv,111,1317,390,811,1206,421,0.2941505,20,,2,0.3490878938640133,
126,2,car,crv,247,756,446,741,509,295,0.96245986,20,,2,0.3490878938640133,
127,2,car,crv,134,1300,387,818,1166,431,0.35928637,20,,2,1.28,
128,2,car,crv,251,757,447,743,506,296,0.9412378,20,,2,1.28,
129,2,car,crv,126,1312,388,815,1186,427,0.3965622,20,,2,1.24,
130,2,car,crv,252,758,446,743,506,297,0.9420341,20,,2,1.24,
131,2,car,crv,121,1316,389,809,1195,420,0.4096516,20,,2,1.24,
132,2,car,crv,244,761,447,742,517,295,0.9289579,20,,2,1.24,
133,2,car,crv,125,1312,392,805,1187,413,0.30284005,20,,2,1.24,
134,2,car,crv,245,760,447,739,515,292,0.9596912,20,,2,1.24,
135,2,car,crv,131,1307,388,812,1176,424,0.43397242,20,,2,1.2916666666666667,
136,2,car,crv,247,764,447,744,517,297,0.9014591,20,,2,1.2916666666666667,
137,2,car,crv,123,1315,388,811,1192,423,0.4968379,20,,2,1.24,
138,2,car,crv,246,758,446,743,512,297,0.87933147,20,,2,1.24,
139,2,car,crv,118,1312,389,813,1194,424,0.25691053,20,,2,0.35510887772194305,
140,2,car,crv,249,756,447,742,507,295,0.96910256,20,,2,0.35510887772194305,
141,2,car,crv,118,1319,389,813,1201,424,0.4023961,20,,2,1.28,
142,2,car,crv,243,757,448,743,514,295,0.94143236,20,,2,1.28,
143,2,car,crv,119,1322,385,815,1203,430,0.42900166,20,,2,1.24,
144,2,car,crv,246,762,447,741,516,294,0.790523,20,,2,1.24,
145,2,car,crv,119,1319,386,815,1200,429,0.44753623,20,,2,1.28,
146,2,car,crv,248,759,450,741,511,291,0.8263495,20,,2,1.28,
147,2,car,crv,114,1318,387,813,1204,426,0.43434885,20,,2,1.2916666666666667,
148,2,car,crv,246,759,446,744,513,298,0.9186257,20,,2,1.2916666666666667,
149,2,car,crv,119,1325,389,808,1206,419,0.46840343,20,,2,1.24,
150,2,car,crv,244,759,447,741,515,294,0.83414143,20,,2,1.24,
151,2,car,crv,116,1322,388,811,1206,423,0.44209528,20,,2,1.28,
152,2,car,crv,241,764,450,741,523,291,0.8834957,20,,2,1.28,
153,2,car,crv,334,710,446,701,376,255,0.92716336,3,0,2,0.6781914893617021,
154,2,car,crv,336,711,446,700,375,254,0.9036748,3,0,2,0.6773333333333333,
155,2,car,crv,335,709,444,701,374,257,0.9452533,3,0,2,0.6871657754010695,
0,2,car,crv,121,1303,389,815,1182,426,0.23151965,20,,2,0.3604060913705584,
1,2,car,crv,245,754,445,744,509,299,0.9742757,20,,2,0.3604060913705584,
2,2,car,crv,124,1302,388,819,1178,431,0.20558608,20,,2,0.36587436332767403,
3,2,car,crv,252,759,447,740,507,293,0.971343,20,,2,0.36587436332767403,
4,2,car,crv,120,1318,389,815,1198,426,0.37832162,20,,2,1.24,
5,2,car,crv,248,758,449,738,510,289,0.9015974,20,,2,1.24,
6,2,car,crv,123,1313,389,813,1190,424,0.38111085,20,,2,1.24,
7,2,car,crv,247,755,446,744,508,298,0.8986612,20,,2,1.24,
8,2,car,crv,117,1315,387,816,1198,429,0.4219676,20,,2,1.2307692307692308,
9,2,car,crv,251,757,449,740,506,291,0.9306962,20,,2,1.2307692307692308,
10,2,car,crv,119,1318,391,816,1199,425,0.41724253,20,,2,1.3333333333333333,
11,2,car,crv,247,759,447,741,512,294,0.9398525,20,,2,1.3333333333333333,
12,2,car,crv,128,1307,392,813,1179,421,0.25620303,20,,2,0.3570822731128075,
13,2,car,crv,251,756,447,741,505,294,0.9512551,20,,2,0.3570822731128075,
14,2,car,crv,119,1314,386,816,1195,430,0.45291424,20,,2,1.2916666666666667,
15,2,car,crv,250,759,449,744,509,295,0.90196574,20,,2,1.2916666666666667,
16,2,car,crv,126,1304,388,820,1178,432,0.2519957,20,,2,0.366723259762309,
17,2,car,crv,253,757,448,737,504,289,0.9349736,20,,2,0.366723259762309,
18,2,car,crv,122,1317,387,818,1195,431,0.38155946,20,,2,1.24,
19,2,car,crv,248,756,447,743,508,296,0.9098617,20,,2,1.24,
20,2,car,crv,120,1319,389,808,1199,419,0.49123806,20,,2,1.24,
21,2,car,crv,241,764,446,743,523,297,0.8688812,20,,2,1.24,
22,2,car,crv,251,754,448,736,503,288,0.9627608,20,,2,1.28,
23,2,car,crv,114,1312,387,822,1198,435,0.2406673,20,,2,0.3631051752921536,
24,2,car,crv,253,758,447,739,505,292,0.9361756,20,,2,0.3631051752921536,
25,2,car,crv,121,1313,387,820,1192,433,0.26400292,20,,2,1.24,
26,2,car,crv,246,754,446,742,508,296,0.95298326,20,,2,1.24,
27,2,car,crv,131,1305,389,817,1174,428,0.29075116,20,,2,0.3645655877342419,
28,2,car,crv,252,754,448,743,502,295,0.94248277,20,,2,0.3645655877342419,
29,2,car,crv,130,1307,389,819,1177,430,0.2569041,20,,2,1.24,
30,2,car,crv,256,753,448,740,497,292,0.955823,20,,2,1.24,
31,2,car,crv,127,1305,390,811,1178,421,0.25976446,20,,2,0.35738539898132426,
32,2,car,crv,250,757,443,743,507,300,0.9547171,20,,2,0.35738539898132426,
33,2,car,crv,123,1309,392,810,1186,418,0.28978387,20,,2,1.24,
34,2,car,crv,248,758,446,738,510,292,0.96847486,20,,2,1.24,
35,2,car,crv,123,1304,388,814,1181,426,0.2588897,20,,2,0.3607112616426757,
36,2,car,crv,250,759,447,742,509,295,0.9416412,20,,2,0.3607112616426757,
37,2,car,crv,130,1306,391,810,1176,419,0.26097575,20,,2,0.3562925170068027,
38,2,car,crv,250,756,447,739,506,292,0.95065075,20,,2,0.3562925170068027,
39,2,car,crv,123,1309,389,813,1186,424,0.31858423,20,,2,1.24,
40,2,car,crv,248,758,447,745,510,298,0.9534346,20,,2,1.24,
41,2,car,crv,121,1305,386,819,1184,433,0.24762785,20,,2,0.3657094594594595,
42,2,car,crv,248,759,448,745,511,297,0.96054053,20,,2,0.3657094594594595,
43,2,car,crv,251,754,443,743,503,300,0.96310854,20,,2,1.24,
44,2,car,crv,117,1318,387,822,1201,435,0.42310923,20,,2,1.2916666666666667,
45,2,car,crv,248,763,450,742,515,292,0.92204607,20,,2,1.2916666666666667,
46,2,car,crv,119,1311,391,813,1192,422,0.25885653,20,,2,1.25,
47,2,car,crv,246,752,446,739,506,293,0.95473194,20,,2,1.25,
48,2,car,crv,128,1304,388,815,1176,427,0.30647025,20,,2,1.28,
49,2,car,crv,251,758,443,746,507,303,0.93285924,20,,2,1.28,
50,2,car,crv,250,754,447,738,504,291,0.9767751,20,,2,1.24,
51,2,car,crv,109,1318,388,813,1209,425,0.32027155,20,,2,1.28,
52,2,car,crv,245,760,445,741,515,296,0.9680706,20,,2,1.28,
53,2,car,crv,127,1308,391,816,1181,425,0.2964813,20,,2,1.2916666666666667,
54,2,car,crv,250,757,447,742,507,295,0.9490655,20,,2,1.2916666666666667,
55,2,car,crv,125,1314,388,816,1189,428,0.42268884,20,,2,1.28,
56,2,car,crv,248,760,449,737,512,288,0.90941703,20,,2,1.28,
57,2,car,crv,129,1304,390,814,1175,424,0.26254445,20,,2,1.2916666666666667,
58,2,car,crv,252,755,447,740,503,293,0.94612926,20,,2,1.2916666666666667,
59,2,car,crv,114,1320,387,815,1206,428,0.30274954,20,,2,1.24,
60,2,car,crv,248,753,446,740,505,294,0.8954264,20,,2,1.24,
61,2,car,crv,127,1307,391,814,1180,423,0.278648,20,,2,0.35847457627118645,
62,2,car,crv,250,755,447,744,505,297,0.95984495,20,,2,0.35847457627118645,
63,2,car,crv,127,1302,386,816,1175,430,0.37110242,20,,2,1.28,
64,2,car,crv,246,757,444,747,511,303,0.96607155,20,,2,1.28,
65,2,car,crv,119,1307,387,816,1188,429,0.28644451,20,,2,0.3611111111111111,
66,2,car,crv,248,759,443,747,511,304,0.9593547,20,,2,0.3611111111111111,
67,2,car,crv,127,1306,389,820,1179,431,0.37050778,20,,2,1.24,
68,2,car,crv,252,758,449,742,506,293,0.9203835,20,,2,1.24,
69,2,car,crv,126,1306,387,819,1180,432,0.24266188,20,,2,0.36610169491525424,
70,2,car,crv,247,754,449,740,507,291,0.94762105,20,,2,0.36610169491525424,
71,2,car,crv,113,1317,388,815,1204,427,0.36209753,20,,2,1.24,
72,2,car,crv,247,755,446,738,508,292,0.93217456,20,,2,1.24,
73,2,car,crv,116,1312,386,813,1196,427,0.26130736,20,,2,0.35702341137123744,
74,2,car,crv,249,755,445,740,506,295,0.95275867,20,,2,0.35702341137123744,
75,2,car,crv,250,753,445,746,503,301,0.97777426,20,,2,1.24,
76,2,car,crv,117,1316,390,813,1199,423,0.30318785,20,,2,0.35279399499582986,
77,2,car,crv,239,759,447,740,520,293,0.956478,20,,2,0.35279399499582986,
78,2,car,crv,126,1307,387,813,1181,426,0.3400013,20,,2,1.24,
79,2,car,crv,250,757,446,745,507,299,0.93553233,20,,2,1.24,
80,2,car,crv,118,1316,385,817,1198,432,0.46192503,20,,2,1.24,
81,2,car,crv,242,760,449,744,518,295,0.9251644,20,,2,1.24,
82,2,car,crv,125,1310,389,811,1185,422,0.32076746,20,,2,0.3561181434599156,
83,2,car,crv,250,758,446,739,508,293,0.9462212,20,,2,0.3561181434599156,
84,2,car,crv,250,754,444,740,504,296,0.96969557,20,,2,1.24,
85,2,car,crv,113,1313,388,814,1200,426,0.2754978,20,,2,1.24,
86,2,car,crv,244,756,445,743,512,298,0.96916515,20,,2,1.24,
87,2,car,crv,123,1309,388,814,1186,426,0.2760011,20,,2,1.24,
88,2,car,crv,249,758,446,740,509,294,0.950518,20,,2,1.24,
89,2,car,crv,253,754,447,737,501,290,0.94723046,20,,2,1.24,
90,2,car,crv,121,1308,387,817,1187,430,0.21458383,20,,2,0.36225779275484415,
91,2,car,crv,250,754,447,740,504,293,0.9610552,20,,2,0.36225779275484415,
92,2,car,crv,119,1317,388,814,1198,426,0.4732625,20,,2,1.24,
93,2,car,crv,245,758,448,742,513,294,0.94409996,20,,2,1.24,
94,2,car,crv,121,1308,388,815,1187,427,0.21448645,20,,2,0.35973041280539175,
95,2,car,crv,249,753,445,746,504,301,0.9724925,20,,2,0.35973041280539175,
96,2,car,crv,135,1302,387,821,1167,434,0.35179994,20,,2,1.2916666666666667,
97,2,car,crv,250,760,450,741,510,291,0.8736024,20,,2,1.2916666666666667,
98,2,car,crv,117,1313,390,812,1196,422,0.32242462,20,,2,1.2916666666666667,
99,2,car,crv,243,759,447,742,516,295,0.9675998,20,,2,1.2916666666666667,
100,2,car,crv,122,1311,387,814,1189,427,0.36553156,20,,2,1.2916666666666667,
101,2,car,crv,250,757,444,744,507,300,0.9479286,20,,2,1.2916666666666667,
102,2,car,crv,115,1321,388,815,1206,427,0.3674716,20,,2,1.24,
103,2,car,crv,248,756,446,740,508,294,0.92142504,20,,2,1.24,
104,2,car,crv,109,1315,384,827,1206,443,0.2820505,20,,2,1.24,
105,2,car,crv,249,758,449,736,509,287,0.91024953,20,,2,1.24,
106,2,car,crv,122,1310,388,817,1188,429,0.29904467,20,,2,0.3611111111111111,
107,2,car,crv,250,760,448,741,510,293,0.927252,20,,2,0.3611111111111111,
108,2,car,crv,129,1303,389,814,1174,425,0.27334884,20,,2,1.28,
109,2,car,crv,247,760,448,741,513,293,0.9333165,20,,2,1.28,
110,2,car,crv,122,1311,385,813,1189,428,0.35830083,20,,2,1.24,
111,2,car,crv,246,757,442,746,511,304,0.9668414,20,,2,1.24,
112,2,car,crv,122,1312,391,808,1190,417,0.34383425,20,,2,1.28,
113,2,car,crv,248,755,446,741,507,295,0.90284395,20,,2,1.28,
114,2,car,crv,129,1303,386,819,1174,433,0.2341652,20,,2,0.368824531516184,
115,2,car,crv,252,756,447,744,504,297,0.9354642,20,,2,0.368824531516184,
116,2,car,crv,253,756,446,744,503,298,0.97629297,20,,2,1.24,
117,2,car,crv,128,1307,388,817,1179,429,0.32914877,20,,2,1.2916666666666667,
118,2,car,crv,247,762,447,741,515,294,0.9441378,20,,2,1.2916666666666667,
119,2,car,crv,117,1313,388,818,1196,430,0.27251616,20,,2,0.3595317725752508,
120,2,car,crv,247,762,449,740,515,291,0.96550846,20,,2,0.3595317725752508,
121,2,car,crv,124,1305,387,820,1181,433,0.27402008,20,,2,0.36663844199830653,
122,2,car,crv,252,750,447,746,498,299,0.9501165,20,,2,0.36663844199830653,
123,2,car,crv,111,1317,390,812,1206,422,0.27479288,20,,2,0.34991708126036486,
124,2,car,crv,251,753,447,740,502,293,0.9438285,20,,2,0.34991708126036486,
125,2,car,crv,126,1309,390,814,1183,424,0.30222148,20,,2,1.2916666666666667,
126,2,car,crv,249,757,448,740,508,292,0.91383094,20,,2,1.2916666666666667,
127,2,car,crv,111,1317,390,811,1206,421,0.2941505,20,,2,0.3490878938640133,
128,2,car,crv,247,756,446,741,509,295,0.96245986,20,,2,0.3490878938640133,
129,2,car,crv,134,1300,387,818,1166,431,0.35928637,20,,2,1.28,
130,2,car,crv,251,757,447,743,506,296,0.9412378,20,,2,1.28,
131,2,car,crv,126,1312,388,815,1186,427,0.3965622,20,,2,1.24,
132,2,car,crv,252,758,446,743,506,297,0.9420341,20,,2,1.24,
133,2,car,crv,121,1316,389,809,1195,420,0.4096516,20,,2,1.24,
134,2,car,crv,244,761,447,742,517,295,0.9289579,20,,2,1.24,
135,2,car,crv,125,1312,392,805,1187,413,0.30284005,20,,2,1.24,
136,2,car,crv,245,760,447,739,515,292,0.9596912,20,,2,1.24,
137,2,car,crv,131,1307,388,812,1176,424,0.43397242,20,,2,1.2916666666666667,
138,2,car,crv,247,764,447,744,517,297,0.9014591,20,,2,1.2916666666666667,
139,2,car,crv,123,1315,388,811,1192,423,0.4968379,20,,2,1.24,
140,2,car,crv,246,758,446,743,512,297,0.87933147,20,,2,1.24,
141,2,car,crv,118,1312,389,813,1194,424,0.25691053,20,,2,0.35510887772194305,
142,2,car,crv,249,756,447,742,507,295,0.96910256,20,,2,0.35510887772194305,
143,2,car,crv,118,1319,389,813,1201,424,0.4023961,20,,2,1.28,
144,2,car,crv,243,757,448,743,514,295,0.94143236,20,,2,1.28,
145,2,car,crv,119,1322,385,815,1203,430,0.42900166,20,,2,1.24,
146,2,car,crv,246,762,447,741,516,294,0.790523,20,,2,1.24,
147,2,car,crv,119,1319,386,815,1200,429,0.44753623,20,,2,1.28,
148,2,car,crv,248,759,450,741,511,291,0.8263495,20,,2,1.28,
149,2,car,crv,114,1318,387,813,1204,426,0.43434885,20,,2,1.2916666666666667,
150,2,car,crv,246,759,446,744,513,298,0.9186257,20,,2,1.2916666666666667,
151,2,car,crv,119,1325,389,808,1206,419,0.46840343,20,,2,1.24,
152,2,car,crv,244,759,447,741,515,294,0.83414143,20,,2,1.24,
153,2,car,crv,116,1322,388,811,1206,423,0.44209528,20,,2,1.28,
154,2,car,crv,241,764,450,741,523,291,0.8834957,20,,2,1.28,
155,2,car,crv,334,710,446,701,376,255,0.92716336,3,0,2,0.6781914893617021,
156,2,car,crv,336,711,446,700,375,254,0.9036748,3,0,2,0.6773333333333333,
157,2,car,crv,335,709,444,701,374,257,0.9452533,3,0,2,0.6871657754010695,
0,2,car,crv,129,1309,395,806,1180,411,0.31128713,20,,2,0.3483050847457627,
1,2,car,crv,248,761,449,740,513,291,0.95252526,20,,2,0.3483050847457627,
2,2,car,crv,121,1303,389,815,1182,426,0.23151965,20,,2,0.3604060913705584,
3,2,car,crv,245,754,445,744,509,299,0.9742757,20,,2,0.3604060913705584,
4,2,car,crv,124,1302,388,819,1178,431,0.20558608,20,,2,0.36587436332767403,
5,2,car,crv,252,759,447,740,507,293,0.971343,20,,2,0.36587436332767403,
6,2,car,crv,120,1318,389,815,1198,426,0.37832162,20,,2,1.24,
7,2,car,crv,248,758,449,738,510,289,0.9015974,20,,2,1.24,
8,2,car,crv,123,1313,389,813,1190,424,0.38111085,20,,2,1.24,
9,2,car,crv,247,755,446,744,508,298,0.8986612,20,,2,1.24,
10,2,car,crv,117,1315,387,816,1198,429,0.4219676,20,,2,1.2307692307692308,
11,2,car,crv,251,757,449,740,506,291,0.9306962,20,,2,1.2307692307692308,
12,2,car,crv,119,1318,391,816,1199,425,0.41724253,20,,2,1.3333333333333333,
13,2,car,crv,247,759,447,741,512,294,0.9398525,20,,2,1.3333333333333333,
14,2,car,crv,128,1307,392,813,1179,421,0.25620303,20,,2,0.3570822731128075,
15,2,car,crv,251,756,447,741,505,294,0.9512551,20,,2,0.3570822731128075,
16,2,car,crv,119,1314,386,816,1195,430,0.45291424,20,,2,1.2916666666666667,
17,2,car,crv,250,759,449,744,509,295,0.90196574,20,,2,1.2916666666666667,
18,2,car,crv,126,1304,388,820,1178,432,0.2519957,20,,2,0.366723259762309,
19,2,car,crv,253,757,448,737,504,289,0.9349736,20,,2,0.366723259762309,
20,2,car,crv,122,1317,387,818,1195,431,0.38155946,20,,2,1.24,
21,2,car,crv,248,756,447,743,508,296,0.9098617,20,,2,1.24,
22,2,car,crv,120,1319,389,808,1199,419,0.49123806,20,,2,1.24,
23,2,car,crv,241,764,446,743,523,297,0.8688812,20,,2,1.24,
24,2,car,crv,251,754,448,736,503,288,0.9627608,20,,2,1.28,
25,2,car,crv,114,1312,387,822,1198,435,0.2406673,20,,2,0.3631051752921536,
26,2,car,crv,253,758,447,739,505,292,0.9361756,20,,2,0.3631051752921536,
27,2,car,crv,121,1313,387,820,1192,433,0.26400292,20,,2,1.24,
28,2,car,crv,246,754,446,742,508,296,0.95298326,20,,2,1.24,
29,2,car,crv,131,1305,389,817,1174,428,0.29075116,20,,2,0.3645655877342419,
30,2,car,crv,252,754,448,743,502,295,0.94248277,20,,2,0.3645655877342419,
31,2,car,crv,130,1307,389,819,1177,430,0.2569041,20,,2,1.24,
32,2,car,crv,256,753,448,740,497,292,0.955823,20,,2,1.24,
33,2,car,crv,127,1305,390,811,1178,421,0.25976446,20,,2,0.35738539898132426,
34,2,car,crv,250,757,443,743,507,300,0.9547171,20,,2,0.35738539898132426,
35,2,car,crv,123,1309,392,810,1186,418,0.28978387,20,,2,1.24,
36,2,car,crv,248,758,446,738,510,292,0.96847486,20,,2,1.24,
37,2,car,crv,123,1304,388,814,1181,426,0.2588897,20,,2,0.3607112616426757,
38,2,car,crv,250,759,447,742,509,295,0.9416412,20,,2,0.3607112616426757,
39,2,car,crv,130,1306,391,810,1176,419,0.26097575,20,,2,0.3562925170068027,
40,2,car,crv,250,756,447,739,506,292,0.95065075,20,,2,0.3562925170068027,
41,2,car,crv,123,1309,389,813,1186,424,0.31858423,20,,2,1.24,
42,2,car,crv,248,758,447,745,510,298,0.9534346,20,,2,1.24,
43,2,car,crv,121,1305,386,819,1184,433,0.24762785,20,,2,0.3657094594594595,
44,2,car,crv,248,759,448,745,511,297,0.96054053,20,,2,0.3657094594594595,
45,2,car,crv,251,754,443,743,503,300,0.96310854,20,,2,1.24,
46,2,car,crv,117,1318,387,822,1201,435,0.42310923,20,,2,1.2916666666666667,
47,2,car,crv,248,763,450,742,515,292,0.92204607,20,,2,1.2916666666666667,
48,2,car,crv,119,1311,391,813,1192,422,0.25885653,20,,2,1.25,
49,2,car,crv,246,752,446,739,506,293,0.95473194,20,,2,1.25,
50,2,car,crv,128,1304,388,815,1176,427,0.30647025,20,,2,1.28,
51,2,car,crv,251,758,443,746,507,303,0.93285924,20,,2,1.28,
52,2,car,crv,250,754,447,738,504,291,0.9767751,20,,2,1.24,
53,2,car,crv,109,1318,388,813,1209,425,0.32027155,20,,2,1.28,
54,2,car,crv,245,760,445,741,515,296,0.9680706,20,,2,1.28,
55,2,car,crv,127,1308,391,816,1181,425,0.2964813,20,,2,1.2916666666666667,
56,2,car,crv,250,757,447,742,507,295,0.9490655,20,,2,1.2916666666666667,
57,2,car,crv,125,1314,388,816,1189,428,0.42268884,20,,2,1.28,
58,2,car,crv,248,760,449,737,512,288,0.90941703,20,,2,1.28,
59,2,car,crv,129,1304,390,814,1175,424,0.26254445,20,,2,1.2916666666666667,
60,2,car,crv,252,755,447,740,503,293,0.94612926,20,,2,1.2916666666666667,
61,2,car,crv,114,1320,387,815,1206,428,0.30274954,20,,2,1.24,
62,2,car,crv,248,753,446,740,505,294,0.8954264,20,,2,1.24,
63,2,car,crv,127,1307,391,814,1180,423,0.278648,20,,2,0.35847457627118645,
64,2,car,crv,250,755,447,744,505,297,0.95984495,20,,2,0.35847457627118645,
65,2,car,crv,127,1302,386,816,1175,430,0.37110242,20,,2,1.28,
66,2,car,crv,246,757,444,747,511,303,0.96607155,20,,2,1.28,
67,2,car,crv,119,1307,387,816,1188,429,0.28644451,20,,2,0.3611111111111111,
68,2,car,crv,248,759,443,747,511,304,0.9593547,20,,2,0.3611111111111111,
69,2,car,crv,127,1306,389,820,1179,431,0.37050778,20,,2,1.24,
70,2,car,crv,252,758,449,742,506,293,0.9203835,20,,2,1.24,
71,2,car,crv,126,1306,387,819,1180,432,0.24266188,20,,2,0.36610169491525424,
72,2,car,crv,247,754,449,740,507,291,0.94762105,20,,2,0.36610169491525424,
73,2,car,crv,113,1317,388,815,1204,427,0.36209753,20,,2,1.24,
74,2,car,crv,247,755,446,738,508,292,0.93217456,20,,2,1.24,
75,2,car,crv,116,1312,386,813,1196,427,0.26130736,20,,2,0.35702341137123744,
76,2,car,crv,249,755,445,740,506,295,0.95275867,20,,2,0.35702341137123744,
77,2,car,crv,250,753,445,746,503,301,0.97777426,20,,2,1.24,
78,2,car,crv,117,1316,390,813,1199,423,0.30318785,20,,2,0.35279399499582986,
79,2,car,crv,239,759,447,740,520,293,0.956478,20,,2,0.35279399499582986,
80,2,car,crv,126,1307,387,813,1181,426,0.3400013,20,,2,1.24,
81,2,car,crv,250,757,446,745,507,299,0.93553233,20,,2,1.24,
82,2,car,crv,118,1316,385,817,1198,432,0.46192503,20,,2,1.24,
83,2,car,crv,242,760,449,744,518,295,0.9251644,20,,2,1.24,
84,2,car,crv,125,1310,389,811,1185,422,0.32076746,20,,2,0.3561181434599156,
85,2,car,crv,250,758,446,739,508,293,0.9462212,20,,2,0.3561181434599156,
86,2,car,crv,250,754,444,740,504,296,0.96969557,20,,2,1.24,
87,2,car,crv,113,1313,388,814,1200,426,0.2754978,20,,2,1.24,
88,2,car,crv,244,756,445,743,512,298,0.96916515,20,,2,1.24,
89,2,car,crv,123,1309,388,814,1186,426,0.2760011,20,,2,1.24,
90,2,car,crv,249,758,446,740,509,294,0.950518,20,,2,1.24,
91,2,car,crv,253,754,447,737,501,290,0.94723046,20,,2,1.24,
92,2,car,crv,121,1308,387,817,1187,430,0.21458383,20,,2,0.36225779275484415,
93,2,car,crv,250,754,447,740,504,293,0.9610552,20,,2,0.36225779275484415,
94,2,car,crv,119,1317,388,814,1198,426,0.4732625,20,,2,1.24,
95,2,car,crv,245,758,448,742,513,294,0.94409996,20,,2,1.24,
96,2,car,crv,121,1308,388,815,1187,427,0.21448645,20,,2,0.35973041280539175,
97,2,car,crv,249,753,445,746,504,301,0.9724925,20,,2,0.35973041280539175,
98,2,car,crv,135,1302,387,821,1167,434,0.35179994,20,,2,1.2916666666666667,
99,2,car,crv,250,760,450,741,510,291,0.8736024,20,,2,1.2916666666666667,
100,2,car,crv,117,1313,390,812,1196,422,0.32242462,20,,2,1.2916666666666667,
101,2,car,crv,243,759,447,742,516,295,0.9675998,20,,2,1.2916666666666667,
102,2,car,crv,122,1311,387,814,1189,427,0.36553156,20,,2,1.2916666666666667,
103,2,car,crv,250,757,444,744,507,300,0.9479286,20,,2,1.2916666666666667,
104,2,car,crv,115,1321,388,815,1206,427,0.3674716,20,,2,1.24,
105,2,car,crv,248,756,446,740,508,294,0.92142504,20,,2,1.24,
106,2,car,crv,109,1315,384,827,1206,443,0.2820505,20,,2,1.24,
107,2,car,crv,249,758,449,736,509,287,0.91024953,20,,2,1.24,
108,2,car,crv,122,1310,388,817,1188,429,0.29904467,20,,2,0.3611111111111111,
109,2,car,crv,250,760,448,741,510,293,0.927252,20,,2,0.3611111111111111,
110,2,car,crv,129,1303,389,814,1174,425,0.27334884,20,,2,1.28,
111,2,car,crv,247,760,448,741,513,293,0.9333165,20,,2,1.28,
112,2,car,crv,122,1311,385,813,1189,428,0.35830083,20,,2,1.24,
113,2,car,crv,246,757,442,746,511,304,0.9668414,20,,2,1.24,
114,2,car,crv,122,1312,391,808,1190,417,0.34383425,20,,2,1.28,
115,2,car,crv,248,755,446,741,507,295,0.90284395,20,,2,1.28,
116,2,car,crv,129,1303,386,819,1174,433,0.2341652,20,,2,0.368824531516184,
117,2,car,crv,252,756,447,744,504,297,0.9354642,20,,2,0.368824531516184,
118,2,car,crv,253,756,446,744,503,298,0.97629297,20,,2,1.24,
119,2,car,crv,128,1307,388,817,1179,429,0.32914877,20,,2,1.2916666666666667,
120,2,car,crv,247,762,447,741,515,294,0.9441378,20,,2,1.2916666666666667,
121,2,car,crv,117,1313,388,818,1196,430,0.27251616,20,,2,0.3595317725752508,
122,2,car,crv,247,762,449,740,515,291,0.96550846,20,,2,0.3595317725752508,
123,2,car,crv,124,1305,387,820,1181,433,0.27402008,20,,2,0.36663844199830653,
124,2,car,crv,252,750,447,746,498,299,0.9501165,20,,2,0.36663844199830653,
125,2,car,crv,111,1317,390,812,1206,422,0.27479288,20,,2,0.34991708126036486,
126,2,car,crv,251,753,447,740,502,293,0.9438285,20,,2,0.34991708126036486,
127,2,car,crv,126,1309,390,814,1183,424,0.30222148,20,,2,1.2916666666666667,
128,2,car,crv,249,757,448,740,508,292,0.91383094,20,,2,1.2916666666666667,
129,2,car,crv,111,1317,390,811,1206,421,0.2941505,20,,2,0.3490878938640133,
130,2,car,crv,247,756,446,741,509,295,0.96245986,20,,2,0.3490878938640133,
131,2,car,crv,134,1300,387,818,1166,431,0.35928637,20,,2,1.28,
132,2,car,crv,251,757,447,743,506,296,0.9412378,20,,2,1.28,
133,2,car,crv,126,1312,388,815,1186,427,0.3965622,20,,2,1.24,
134,2,car,crv,252,758,446,743,506,297,0.9420341,20,,2,1.24,
135,2,car,crv,121,1316,389,809,1195,420,0.4096516,20,,2,1.24,
136,2,car,crv,244,761,447,742,517,295,0.9289579,20,,2,1.24,
137,2,car,crv,125,1312,392,805,1187,413,0.30284005,20,,2,1.24,
138,2,car,crv,245,760,447,739,515,292,0.9596912,20,,2,1.24,
139,2,car,crv,131,1307,388,812,1176,424,0.43397242,20,,2,1.2916666666666667,
140,2,car,crv,247,764,447,744,517,297,0.9014591,20,,2,1.2916666666666667,
141,2,car,crv,123,1315,388,811,1192,423,0.4968379,20,,2,1.24,
142,2,car,crv,246,758,446,743,512,297,0.87933147,20,,2,1.24,
143,2,car,crv,118,1312,389,813,1194,424,0.25691053,20,,2,0.35510887772194305,
144,2,car,crv,249,756,447,742,507,295,0.96910256,20,,2,0.35510887772194305,
145,2,car,crv,118,1319,389,813,1201,424,0.4023961,20,,2,1.28,
146,2,car,crv,243,757,448,743,514,295,0.94143236,20,,2,1.28,
147,2,car,crv,119,1322,385,815,1203,430,0.42900166,20,,2,1.24,
148,2,car,crv,246,762,447,741,516,294,0.790523,20,,2,1.24,
149,2,car,crv,119,1319,386,815,1200,429,0.44753623,20,,2,1.28,
150,2,car,crv,248,759,450,741,511,291,0.8263495,20,,2,1.28,
151,2,car,crv,114,1318,387,813,1204,426,0.43434885,20,,2,1.2916666666666667,
152,2,car,crv,246,759,446,744,513,298,0.9186257,20,,2,1.2916666666666667,
153,2,car,crv,119,1325,389,808,1206,419,0.46840343,20,,2,1.24,
154,2,car,crv,244,759,447,741,515,294,0.83414143,20,,2,1.24,
155,2,car,crv,116,1322,388,811,1206,423,0.44209528,20,,2,1.28,
156,2,car,crv,241,764,450,741,523,291,0.8834957,20,,2,1.28,
157,2,car,crv,334,710,446,701,376,255,0.92716336,3,0,2,0.6781914893617021,
158,2,car,crv,336,711,446,700,375,254,0.9036748,3,0,2,0.6773333333333333,
159,2,car,crv,335,709,444,701,374,257,0.9452533,3,0,2,0.6871657754010695,
0,2,car,crv,121,1303,387,817,1182,430,0.23037793,20,,2,0.3637901861252115,
1,2,car,crv,250,752,444,747,502,303,0.973318,20,,2,0.3637901861252115,
2,2,car,crv,129,1309,395,806,1180,411,0.31128713,20,,2,0.3483050847457627,
3,2,car,crv,248,761,449,740,513,291,0.95252526,20,,2,0.3483050847457627,
4,2,car,crv,121,1303,389,815,1182,426,0.23151965,20,,2,0.3604060913705584,
5,2,car,crv,245,754,445,744,509,299,0.9742757,20,,2,0.3604060913705584,
6,2,car,crv,124,1302,388,819,1178,431,0.20558608,20,,2,0.36587436332767403,
7,2,car,crv,252,759,447,740,507,293,0.971343,20,,2,0.36587436332767403,
8,2,car,crv,120,1318,389,815,1198,426,0.37832162,20,,2,1.24,
9,2,car,crv,248,758,449,738,510,289,0.9015974,20,,2,1.24,
10,2,car,crv,123,1313,389,813,1190,424,0.38111085,20,,2,1.24,
11,2,car,crv,247,755,446,744,508,298,0.8986612,20,,2,1.24,
12,2,car,crv,117,1315,387,816,1198,429,0.4219676,20,,2,1.2307692307692308,
13,2,car,crv,251,757,449,740,506,291,0.9306962,20,,2,1.2307692307692308,
14,2,car,crv,119,1318,391,816,1199,425,0.41724253,20,,2,1.3333333333333333,
15,2,car,crv,247,759,447,741,512,294,0.9398525,20,,2,1.3333333333333333,
16,2,car,crv,128,1307,392,813,1179,421,0.25620303,20,,2,0.3570822731128075,
17,2,car,crv,251,756,447,741,505,294,0.9512551,20,,2,0.3570822731128075,
18,2,car,crv,119,1314,386,816,1195,430,0.45291424,20,,2,1.2916666666666667,
19,2,car,crv,250,759,449,744,509,295,0.90196574,20,,2,1.2916666666666667,
20,2,car,crv,126,1304,388,820,1178,432,0.2519957,20,,2,0.366723259762309,
21,2,car,crv,253,757,448,737,504,289,0.9349736,20,,2,0.366723259762309,
22,2,car,crv,122,1317,387,818,1195,431,0.38155946,20,,2,1.24,
23,2,car,crv,248,756,447,743,508,296,0.9098617,20,,2,1.24,
24,2,car,crv,120,1319,389,808,1199,419,0.49123806,20,,2,1.24,
25,2,car,crv,241,764,446,743,523,297,0.8688812,20,,2,1.24,
26,2,car,crv,251,754,448,736,503,288,0.9627608,20,,2,1.28,
27,2,car,crv,114,1312,387,822,1198,435,0.2406673,20,,2,0.3631051752921536,
28,2,car,crv,253,758,447,739,505,292,0.9361756,20,,2,0.3631051752921536,
29,2,car,crv,121,1313,387,820,1192,433,0.26400292,20,,2,1.24,
30,2,car,crv,246,754,446,742,508,296,0.95298326,20,,2,1.24,
31,2,car,crv,131,1305,389,817,1174,428,0.29075116,20,,2,0.3645655877342419,
32,2,car,crv,252,754,448,743,502,295,0.94248277,20,,2,0.3645655877342419,
33,2,car,crv,130,1307,389,819,1177,430,0.2569041,20,,2,1.24,
34,2,car,crv,256,753,448,740,497,292,0.955823,20,,2,1.24,
35,2,car,crv,127,1305,390,811,1178,421,0.25976446,20,,2,0.35738539898132426,
36,2,car,crv,250,757,443,743,507,300,0.9547171,20,,2,0.35738539898132426,
37,2,car,crv,123,1309,392,810,1186,418,0.28978387,20,,2,1.24,
38,2,car,crv,248,758,446,738,510,292,0.96847486,20,,2,1.24,
39,2,car,crv,123,1304,388,814,1181,426,0.2588897,20,,2,0.3607112616426757,
40,2,car,crv,250,759,447,742,509,295,0.9416412,20,,2,0.3607112616426757,
41,2,car,crv,130,1306,391,810,1176,419,0.26097575,20,,2,0.3562925170068027,
42,2,car,crv,250,756,447,739,506,292,0.95065075,20,,2,0.3562925170068027,
43,2,car,crv,123,1309,389,813,1186,424,0.31858423,20,,2,1.24,
44,2,car,crv,248,758,447,745,510,298,0.9534346,20,,2,1.24,
45,2,car,crv,121,1305,386,819,1184,433,0.24762785,20,,2,0.3657094594594595,
46,2,car,crv,248,759,448,745,511,297,0.96054053,20,,2,0.3657094594594595,
47,2,car,crv,251,754,443,743,503,300,0.96310854,20,,2,1.24,
48,2,car,crv,117,1318,387,822,1201,435,0.42310923,20,,2,1.2916666666666667,
49,2,car,crv,248,763,450,742,515,292,0.92204607,20,,2,1.2916666666666667,
50,2,car,crv,119,1311,391,813,1192,422,0.25885653,20,,2,1.25,
51,2,car,crv,246,752,446,739,506,293,0.95473194,20,,2,1.25,
52,2,car,crv,128,1304,388,815,1176,427,0.30647025,20,,2,1.28,
53,2,car,crv,251,758,443,746,507,303,0.93285924,20,,2,1.28,
54,2,car,crv,250,754,447,738,504,291,0.9767751,20,,2,1.24,
55,2,car,crv,109,1318,388,813,1209,425,0.32027155,20,,2,1.28,
56,2,car,crv,245,760,445,741,515,296,0.9680706,20,,2,1.28,
57,2,car,crv,127,1308,391,816,1181,425,0.2964813,20,,2,1.2916666666666667,
58,2,car,crv,250,757,447,742,507,295,0.9490655,20,,2,1.2916666666666667,
59,2,car,crv,125,1314,388,816,1189,428,0.42268884,20,,2,1.28,
60,2,car,crv,248,760,449,737,512,288,0.90941703,20,,2,1.28,
61,2,car,crv,129,1304,390,814,1175,424,0.26254445,20,,2,1.2916666666666667,
62,2,car,crv,252,755,447,740,503,293,0.94612926,20,,2,1.2916666666666667,
63,2,car,crv,114,1320,387,815,1206,428,0.30274954,20,,2,1.24,
64,2,car,crv,248,753,446,740,505,294,0.8954264,20,,2,1.24,
65,2,car,crv,127,1307,391,814,1180,423,0.278648,20,,2,0.35847457627118645,
66,2,car,crv,250,755,447,744,505,297,0.95984495,20,,2,0.35847457627118645,
67,2,car,crv,127,1302,386,816,1175,430,0.37110242,20,,2,1.28,
68,2,car,crv,246,757,444,747,511,303,0.96607155,20,,2,1.28,
69,2,car,crv,119,1307,387,816,1188,429,0.28644451,20,,2,0.3611111111111111,
70,2,car,crv,248,759,443,747,511,304,0.9593547,20,,2,0.3611111111111111,
71,2,car,crv,127,1306,389,820,1179,431,0.37050778,20,,2,1.24,
72,2,car,crv,252,758,449,742,506,293,0.9203835,20,,2,1.24,
73,2,car,crv,126,1306,387,819,1180,432,0.24266188,20,,2,0.36610169491525424,
74,2,car,crv,247,754,449,740,507,291,0.94762105,20,,2,0.36610169491525424,
75,2,car,crv,113,1317,388,815,1204,427,0.36209753,20,,2,1.24,
76,2,car,crv,247,755,446,738,508,292,0.93217456,20,,2,1.24,
77,2,car,crv,116,1312,386,813,1196,427,0.26130736,20,,2,0.35702341137123744,
78,2,car,crv,249,755,445,740,506,295,0.95275867,20,,2,0.35702341137123744,
79,2,car,crv,250,753,445,746,503,301,0.97777426,20,,2,1.24,
80,2,car,crv,117,1316,390,813,1199,423,0.30318785,20,,2,0.35279399499582986,
81,2,car,crv,239,759,447,740,520,293,0.956478,20,,2,0.35279399499582986,
82,2,car,crv,126,1307,387,813,1181,426,0.3400013,20,,2,1.24,
83,2,car,crv,250,757,446,745,507,299,0.93553233,20,,2,1.24,
84,2,car,crv,118,1316,385,817,1198,432,0.46192503,20,,2,1.24,
85,2,car,crv,242,760,449,744,518,295,0.9251644,20,,2,1.24,
86,2,car,crv,125,1310,389,811,1185,422,0.32076746,20,,2,0.3561181434599156,
87,2,car,crv,250,758,446,739,508,293,0.9462212,20,,2,0.3561181434599156,
88,2,car,crv,250,754,444,740,504,296,0.96969557,20,,2,1.24,
89,2,car,crv,113,1313,388,814,1200,426,0.2754978,20,,2,1.24,
90,2,car,crv,244,756,445,743,512,298,0.96916515,20,,2,1.24,
91,2,car,crv,123,1309,388,814,1186,426,0.2760011,20,,2,1.24,
92,2,car,crv,249,758,446,740,509,294,0.950518,20,,2,1.24,
93,2,car,crv,253,754,447,737,501,290,0.94723046,20,,2,1.24,
94,2,car,crv,121,1308,387,817,1187,430,0.21458383,20,,2,0.36225779275484415,
95,2,car,crv,250,754,447,740,504,293,0.9610552,20,,2,0.36225779275484415,
96,2,car,crv,119,1317,388,814,1198,426,0.4732625,20,,2,1.24,
97,2,car,crv,245,758,448,742,513,294,0.94409996,20,,2,1.24,
98,2,car,crv,121,1308,388,815,1187,427,0.21448645,20,,2,0.35973041280539175,
99,2,car,crv,249,753,445,746,504,301,0.9724925,20,,2,0.35973041280539175,
100,2,car,crv,135,1302,387,821,1167,434,0.35179994,20,,2,1.2916666666666667,
101,2,car,crv,250,760,450,741,510,291,0.8736024,20,,2,1.2916666666666667,
102,2,car,crv,117,1313,390,812,1196,422,0.32242462,20,,2,1.2916666666666667,
103,2,car,crv,243,759,447,742,516,295,0.9675998,20,,2,1.2916666666666667,
104,2,car,crv,122,1311,387,814,1189,427,0.36553156,20,,2,1.2916666666666667,
105,2,car,crv,250,757,444,744,507,300,0.9479286,20,,2,1.2916666666666667,
106,2,car,crv,115,1321,388,815,1206,427,0.3674716,20,,2,1.24,
107,2,car,crv,248,756,446,740,508,294,0.92142504,20,,2,1.24,
108,2,car,crv,109,1315,384,827,1206,443,0.2820505,20,,2,1.24,
109,2,car,crv,249,758,449,736,509,287,0.91024953,20,,2,1.24,
110,2,car,crv,122,1310,388,817,1188,429,0.29904467,20,,2,0.3611111111111111,
111,2,car,crv,250,760,448,741,510,293,0.927252,20,,2,0.3611111111111111,
112,2,car,crv,129,1303,389,814,1174,425,0.27334884,20,,2,1.28,
113,2,car,crv,247,760,448,741,513,293,0.9333165,20,,2,1.28,
114,2,car,crv,122,1311,385,813,1189,428,0.35830083,20,,2,1.24,
115,2,car,crv,246,757,442,746,511,304,0.9668414,20,,2,1.24,
116,2,car,crv,122,1312,391,808,1190,417,0.34383425,20,,2,1.28,
117,2,car,crv,248,755,446,741,507,295,0.90284395,20,,2,1.28,
118,2,car,crv,129,1303,386,819,1174,433,0.2341652,20,,2,0.368824531516184,
119,2,car,crv,252,756,447,744,504,297,0.9354642,20,,2,0.368824531516184,
120,2,car,crv,253,756,446,744,503,298,0.97629297,20,,2,1.24,
121,2,car,crv,128,1307,388,817,1179,429,0.32914877,20,,2,1.2916666666666667,
122,2,car,crv,247,762,447,741,515,294,0.9441378,20,,2,1.2916666666666667,
123,2,car,crv,117,1313,388,818,1196,430,0.27251616,20,,2,0.3595317725752508,
124,2,car,crv,247,762,449,740,515,291,0.96550846,20,,2,0.3595317725752508,
125,2,car,crv,124,1305,387,820,1181,433,0.27402008,20,,2,0.36663844199830653,
126,2,car,crv,252,750,447,746,498,299,0.9501165,20,,2,0.36663844199830653,
127,2,car,crv,111,1317,390,812,1206,422,0.27479288,20,,2,0.34991708126036486,
128,2,car,crv,251,753,447,740,502,293,0.9438285,20,,2,0.34991708126036486,
129,2,car,crv,126,1309,390,814,1183,424,0.30222148,20,,2,1.2916666666666667,
130,2,car,crv,249,757,448,740,508,292,0.91383094,20,,2,1.2916666666666667,
131,2,car,crv,111,1317,390,811,1206,421,0.2941505,20,,2,0.3490878938640133,
132,2,car,crv,247,756,446,741,509,295,0.96245986,20,,2,0.3490878938640133,
133,2,car,crv,134,1300,387,818,1166,431,0.35928637,20,,2,1.28,
134,2,car,crv,251,757,447,743,506,296,0.9412378,20,,2,1.28,
135,2,car,crv,126,1312,388,815,1186,427,0.3965622,20,,2,1.24,
136,2,car,crv,252,758,446,743,506,297,0.9420341,20,,2,1.24,
137,2,car,crv,121,1316,389,809,1195,420,0.4096516,20,,2,1.24,
138,2,car,crv,244,761,447,742,517,295,0.9289579,20,,2,1.24,
139,2,car,crv,125,1312,392,805,1187,413,0.30284005,20,,2,1.24,
140,2,car,crv,245,760,447,739,515,292,0.9596912,20,,2,1.24,
141,2,car,crv,131,1307,388,812,1176,424,0.43397242,20,,2,1.2916666666666667,
142,2,car,crv,247,764,447,744,517,297,0.9014591,20,,2,1.2916666666666667,
143,2,car,crv,123,1315,388,811,1192,423,0.4968379,20,,2,1.24,
144,2,car,crv,246,758,446,743,512,297,0.87933147,20,,2,1.24,
145,2,car,crv,118,1312,389,813,1194,424,0.25691053,20,,2,0.35510887772194305,
146,2,car,crv,249,756,447,742,507,295,0.96910256,20,,2,0.35510887772194305,
147,2,car,crv,118,1319,389,813,1201,424,0.4023961,20,,2,1.28,
148,2,car,crv,243,757,448,743,514,295,0.94143236,20,,2,1.28,
149,2,car,crv,119,1322,385,815,1203,430,0.42900166,20,,2,1.24,
150,2,car,crv,246,762,447,741,516,294,0.790523,20,,2,1.24,
151,2,car,crv,119,1319,386,815,1200,429,0.44753623,20,,2,1.28,
152,2,car,crv,248,759,450,741,511,291,0.8263495,20,,2,1.28,
153,2,car,crv,114,1318,387,813,1204,426,0.43434885,20,,2,1.2916666666666667,
154,2,car,crv,246,759,446,744,513,298,0.9186257,20,,2,1.2916666666666667,
155,2,car,crv,119,1325,389,808,1206,419,0.46840343,20,,2,1.24,
156,2,car,crv,244,759,447,741,515,294,0.83414143,20,,2,1.24,
157,2,car,crv,116,1322,388,811,1206,423,0.44209528,20,,2,1.28,
158,2,car,crv,241,764,450,741,523,291,0.8834957,20,,2,1.28,
159,2,car,crv,334,710,446,701,376,255,0.92716336,3,0,2,0.6781914893617021,
160,2,car,crv,336,711,446,700,375,254,0.9036748,3,0,2,0.6773333333333333,
161,2,car,crv,335,709,444,701,374,257,0.9452533,3,0,2,0.6871657754010695,
0,2,car,crv,118,1317,389,817,1199,428,0.40577245,20,,2,1.2916666666666667,
1,2,car,crv,250,758,446,743,508,297,0.94312155,20,,2,1.2916666666666667,
2,2,car,crv,121,1303,387,817,1182,430,0.23037793,20,,2,0.3637901861252115,
3,2,car,crv,250,752,444,747,502,303,0.973318,20,,2,0.3637901861252115,
4,2,car,crv,129,1309,395,806,1180,411,0.31128713,20,,2,0.3483050847457627,
5,2,car,crv,248,761,449,740,513,291,0.95252526,20,,2,0.3483050847457627,
6,2,car,crv,121,1303,389,815,1182,426,0.23151965,20,,2,0.3604060913705584,
7,2,car,crv,245,754,445,744,509,299,0.9742757,20,,2,0.3604060913705584,
8,2,car,crv,124,1302,388,819,1178,431,0.20558608,20,,2,0.36587436332767403,
9,2,car,crv,252,759,447,740,507,293,0.971343,20,,2,0.36587436332767403,
10,2,car,crv,120,1318,389,815,1198,426,0.37832162,20,,2,1.24,
11,2,car,crv,248,758,449,738,510,289,0.9015974,20,,2,1.24,
12,2,car,crv,123,1313,389,813,1190,424,0.38111085,20,,2,1.24,
13,2,car,crv,247,755,446,744,508,298,0.8986612,20,,2,1.24,
14,2,car,crv,117,1315,387,816,1198,429,0.4219676,20,,2,1.2307692307692308,
15,2,car,crv,251,757,449,740,506,291,0.9306962,20,,2,1.2307692307692308,
16,2,car,crv,119,1318,391,816,1199,425,0.41724253,20,,2,1.3333333333333333,
17,2,car,crv,247,759,447,741,512,294,0.9398525,20,,2,1.3333333333333333,
18,2,car,crv,128,1307,392,813,1179,421,0.25620303,20,,2,0.3570822731128075,
19,2,car,crv,251,756,447,741,505,294,0.9512551,20,,2,0.3570822731128075,
20,2,car,crv,119,1314,386,816,1195,430,0.45291424,20,,2,1.2916666666666667,
21,2,car,crv,250,759,449,744,509,295,0.90196574,20,,2,1.2916666666666667,
22,2,car,crv,126,1304,388,820,1178,432,0.2519957,20,,2,0.366723259762309,
23,2,car,crv,253,757,448,737,504,289,0.9349736,20,,2,0.366723259762309,
24,2,car,crv,122,1317,387,818,1195,431,0.38155946,20,,2,1.24,
25,2,car,crv,248,756,447,743,508,296,0.9098617,20,,2,1.24,
26,2,car,crv,120,1319,389,808,1199,419,0.49123806,20,,2,1.24,
27,2,car,crv,241,764,446,743,523,297,0.8688812,20,,2,1.24,
28,2,car,crv,251,754,448,736,503,288,0.9627608,20,,2,1.28,
29,2,car,crv,114,1312,387,822,1198,435,0.2406673,20,,2,0.3631051752921536,
30,2,car,crv,253,758,447,739,505,292,0.9361756,20,,2,0.3631051752921536,
31,2,car,crv,121,1313,387,820,1192,433,0.26400292,20,,2,1.24,
32,2,car,crv,246,754,446,742,508,296,0.95298326,20,,2,1.24,
33,2,car,crv,131,1305,389,817,1174,428,0.29075116,20,,2,0.3645655877342419,
34,2,car,crv,252,754,448,743,502,295,0.94248277,20,,2,0.3645655877342419,
35,2,car,crv,130,1307,389,819,1177,430,0.2569041,20,,2,1.24,
36,2,car,crv,256,753,448,740,497,292,0.955823,20,,2,1.24,
37,2,car,crv,127,1305,390,811,1178,421,0.25976446,20,,2,0.35738539898132426,
38,2,car,crv,250,757,443,743,507,300,0.9547171,20,,2,0.35738539898132426,
39,2,car,crv,123,1309,392,810,1186,418,0.28978387,20,,2,1.24,
40,2,car,crv,248,758,446,738,510,292,0.96847486,20,,2,1.24,
41,2,car,crv,123,1304,388,814,1181,426,0.2588897,20,,2,0.3607112616426757,
42,2,car,crv,250,759,447,742,509,295,0.9416412,20,,2,0.3607112616426757,
43,2,car,crv,130,1306,391,810,1176,419,0.26097575,20,,2,0.3562925170068027,
44,2,car,crv,250,756,447,739,506,292,0.95065075,20,,2,0.3562925170068027,
45,2,car,crv,123,1309,389,813,1186,424,0.31858423,20,,2,1.24,
46,2,car,crv,248,758,447,745,510,298,0.9534346,20,,2,1.24,
47,2,car,crv,121,1305,386,819,1184,433,0.24762785,20,,2,0.3657094594594595,
48,2,car,crv,248,759,448,745,511,297,0.96054053,20,,2,0.3657094594594595,
49,2,car,crv,251,754,443,743,503,300,0.96310854,20,,2,1.24,
50,2,car,crv,117,1318,387,822,1201,435,0.42310923,20,,2,1.2916666666666667,
51,2,car,crv,248,763,450,742,515,292,0.92204607,20,,2,1.2916666666666667,
52,2,car,crv,119,1311,391,813,1192,422,0.25885653,20,,2,1.25,
53,2,car,crv,246,752,446,739,506,293,0.95473194,20,,2,1.25,
54,2,car,crv,128,1304,388,815,1176,427,0.30647025,20,,2,1.28,
55,2,car,crv,251,758,443,746,507,303,0.93285924,20,,2,1.28,
56,2,car,crv,250,754,447,738,504,291,0.9767751,20,,2,1.24,
57,2,car,crv,109,1318,388,813,1209,425,0.32027155,20,,2,1.28,
58,2,car,crv,245,760,445,741,515,296,0.9680706,20,,2,1.28,
59,2,car,crv,127,1308,391,816,1181,425,0.2964813,20,,2,1.2916666666666667,
60,2,car,crv,250,757,447,742,507,295,0.9490655,20,,2,1.2916666666666667,
61,2,car,crv,125,1314,388,816,1189,428,0.42268884,20,,2,1.28,
62,2,car,crv,248,760,449,737,512,288,0.90941703,20,,2,1.28,
63,2,car,crv,129,1304,390,814,1175,424,0.26254445,20,,2,1.2916666666666667,
64,2,car,crv,252,755,447,740,503,293,0.94612926,20,,2,1.2916666666666667,
65,2,car,crv,114,1320,387,815,1206,428,0.30274954,20,,2,1.24,
66,2,car,crv,248,753,446,740,505,294,0.8954264,20,,2,1.24,
67,2,car,crv,127,1307,391,814,1180,423,0.278648,20,,2,0.35847457627118645,
68,2,car,crv,250,755,447,744,505,297,0.95984495,20,,2,0.35847457627118645,
69,2,car,crv,127,1302,386,816,1175,430,0.37110242,20,,2,1.28,
70,2,car,crv,246,757,444,747,511,303,0.96607155,20,,2,1.28,
71,2,car,crv,119,1307,387,816,1188,429,0.28644451,20,,2,0.3611111111111111,
72,2,car,crv,248,759,443,747,511,304,0.9593547,20,,2,0.3611111111111111,
73,2,car,crv,127,1306,389,820,1179,431,0.37050778,20,,2,1.24,
74,2,car,crv,252,758,449,742,506,293,0.9203835,20,,2,1.24,
75,2,car,crv,126,1306,387,819,1180,432,0.24266188,20,,2,0.36610169491525424,
76,2,car,crv,247,754,449,740,507,291,0.94762105,20,,2,0.36610169491525424,
77,2,car,crv,113,1317,388,815,1204,427,0.36209753,20,,2,1.24,
78,2,car,crv,247,755,446,738,508,292,0.93217456,20,,2,1.24,
79,2,car,crv,116,1312,386,813,1196,427,0.26130736,20,,2,0.35702341137123744,
80,2,car,crv,249,755,445,740,506,295,0.95275867,20,,2,0.35702341137123744,
81,2,car,crv,250,753,445,746,503,301,0.97777426,20,,2,1.24,
82,2,car,crv,117,1316,390,813,1199,423,0.30318785,20,,2,0.35279399499582986,
83,2,car,crv,239,759,447,740,520,293,0.956478,20,,2,0.35279399499582986,
84,2,car,crv,126,1307,387,813,1181,426,0.3400013,20,,2,1.24,
85,2,car,crv,250,757,446,745,507,299,0.93553233,20,,2,1.24,
86,2,car,crv,118,1316,385,817,1198,432,0.46192503,20,,2,1.24,
87,2,car,crv,242,760,449,744,518,295,0.9251644,20,,2,1.24,
88,2,car,crv,125,1310,389,811,1185,422,0.32076746,20,,2,0.3561181434599156,
89,2,car,crv,250,758,446,739,508,293,0.9462212,20,,2,0.3561181434599156,
90,2,car,crv,250,754,444,740,504,296,0.96969557,20,,2,1.24,
91,2,car,crv,113,1313,388,814,1200,426,0.2754978,20,,2,1.24,
92,2,car,crv,244,756,445,743,512,298,0.96916515,20,,2,1.24,
93,2,car,crv,123,1309,388,814,1186,426,0.2760011,20,,2,1.24,
94,2,car,crv,249,758,446,740,509,294,0.950518,20,,2,1.24,
95,2,car,crv,253,754,447,737,501,290,0.94723046,20,,2,1.24,
96,2,car,crv,121,1308,387,817,1187,430,0.21458383,20,,2,0.36225779275484415,
97,2,car,crv,250,754,447,740,504,293,0.9610552,20,,2,0.36225779275484415,
98,2,car,crv,119,1317,388,814,1198,426,0.4732625,20,,2,1.24,
99,2,car,crv,245,758,448,742,513,294,0.94409996,20,,2,1.24,
100,2,car,crv,121,1308,388,815,1187,427,0.21448645,20,,2,0.35973041280539175,
101,2,car,crv,249,753,445,746,504,301,0.9724925,20,,2,0.35973041280539175,
102,2,car,crv,135,1302,387,821,1167,434,0.35179994,20,,2,1.2916666666666667,
103,2,car,crv,250,760,450,741,510,291,0.8736024,20,,2,1.2916666666666667,
104,2,car,crv,117,1313,390,812,1196,422,0.32242462,20,,2,1.2916666666666667,
105,2,car,crv,243,759,447,742,516,295,0.9675998,20,,2,1.2916666666666667,
106,2,car,crv,122,1311,387,814,1189,427,0.36553156,20,,2,1.2916666666666667,
107,2,car,crv,250,757,444,744,507,300,0.9479286,20,,2,1.2916666666666667,
108,2,car,crv,115,1321,388,815,1206,427,0.3674716,20,,2,1.24,
109,2,car,crv,248,756,446,740,508,294,0.92142504,20,,2,1.24,
110,2,car,crv,109,1315,384,827,1206,443,0.2820505,20,,2,1.24,
111,2,car,crv,249,758,449,736,509,287,0.91024953,20,,2,1.24,
112,2,car,crv,122,1310,388,817,1188,429,0.29904467,20,,2,0.3611111111111111,
113,2,car,crv,250,760,448,741,510,293,0.927252,20,,2,0.3611111111111111,
114,2,car,crv,129,1303,389,814,1174,425,0.27334884,20,,2,1.28,
115,2,car,crv,247,760,448,741,513,293,0.9333165,20,,2,1.28,
116,2,car,crv,122,1311,385,813,1189,428,0.35830083,20,,2,1.24,
117,2,car,crv,246,757,442,746,511,304,0.9668414,20,,2,1.24,
118,2,car,crv,122,1312,391,808,1190,417,0.34383425,20,,2,1.28,
119,2,car,crv,248,755,446,741,507,295,0.90284395,20,,2,1.28,
120,2,car,crv,129,1303,386,819,1174,433,0.2341652,20,,2,0.368824531516184,
121,2,car,crv,252,756,447,744,504,297,0.9354642,20,,2,0.368824531516184,
122,2,car,crv,253,756,446,744,503,298,0.97629297,20,,2,1.24,
123,2,car,crv,128,1307,388,817,1179,429,0.32914877,20,,2,1.2916666666666667,
124,2,car,crv,247,762,447,741,515,294,0.9441378,20,,2,1.2916666666666667,
125,2,car,crv,117,1313,388,818,1196,430,0.27251616,20,,2,0.3595317725752508,
126,2,car,crv,247,762,449,740,515,291,0.96550846,20,,2,0.3595317725752508,
127,2,car,crv,124,1305,387,820,1181,433,0.27402008,20,,2,0.36663844199830653,
128,2,car,crv,252,750,447,746,498,299,0.9501165,20,,2,0.36663844199830653,
129,2,car,crv,111,1317,390,812,1206,422,0.27479288,20,,2,0.34991708126036486,
130,2,car,crv,251,753,447,740,502,293,0.9438285,20,,2,0.34991708126036486,
131,2,car,crv,126,1309,390,814,1183,424,0.30222148,20,,2,1.2916666666666667,
132,2,car,crv,249,757,448,740,508,292,0.91383094,20,,2,1.2916666666666667,
133,2,car,crv,111,1317,390,811,1206,421,0.2941505,20,,2,0.3490878938640133,
134,2,car,crv,247,756,446,741,509,295,0.96245986,20,,2,0.3490878938640133,
135,2,car,crv,134,1300,387,818,1166,431,0.35928637,20,,2,1.28,
136,2,car,crv,251,757,447,743,506,296,0.9412378,20,,2,1.28,
137,2,car,crv,126,1312,388,815,1186,427,0.3965622,20,,2,1.24,
138,2,car,crv,252,758,446,743,506,297,0.9420341,20,,2,1.24,
139,2,car,crv,121,1316,389,809,1195,420,0.4096516,20,,2,1.24,
140,2,car,crv,244,761,447,742,517,295,0.9289579,20,,2,1.24,
141,2,car,crv,125,1312,392,805,1187,413,0.30284005,20,,2,1.24,
142,2,car,crv,245,760,447,739,515,292,0.9596912,20,,2,1.24,
143,2,car,crv,131,1307,388,812,1176,424,0.43397242,20,,2,1.2916666666666667,
144,2,car,crv,247,764,447,744,517,297,0.9014591,20,,2,1.2916666666666667,
145,2,car,crv,123,1315,388,811,1192,423,0.4968379,20,,2,1.24,
146,2,car,crv,246,758,446,743,512,297,0.87933147,20,,2,1.24,
147,2,car,crv,118,1312,389,813,1194,424,0.25691053,20,,2,0.35510887772194305,
148,2,car,crv,249,756,447,742,507,295,0.96910256,20,,2,0.35510887772194305,
149,2,car,crv,118,1319,389,813,1201,424,0.4023961,20,,2,1.28,
150,2,car,crv,243,757,448,743,514,295,0.94143236,20,,2,1.28,
151,2,car,crv,119,1322,385,815,1203,430,0.42900166,20,,2,1.24,
152,2,car,crv,246,762,447,741,516,294,0.790523,20,,2,1.24,
153,2,car,crv,119,1319,386,815,1200,429,0.44753623,20,,2,1.28,
154,2,car,crv,248,759,450,741,511,291,0.8263495,20,,2,1.28,
155,2,car,crv,114,1318,387,813,1204,426,0.43434885,20,,2,1.2916666666666667,
156,2,car,crv,246,759,446,744,513,298,0.9186257,20,,2,1.2916666666666667,
157,2,car,crv,119,1325,389,808,1206,419,0.46840343,20,,2,1.24,
158,2,car,crv,244,759,447,741,515,294,0.83414143,20,,2,1.24,
159,2,car,crv,116,1322,388,811,1206,423,0.44209528,20,,2,1.28,
160,2,car,crv,241,764,450,741,523,291,0.8834957,20,,2,1.28,
161,2,car,crv,334,710,446,701,376,255,0.92716336,3,0,2,0.6781914893617021,
162,2,car,crv,336,711,446,700,375,254,0.9036748,3,0,2,0.6773333333333333,
163,2,car,crv,335,709,444,701,374,257,0.9452533,3,0,2,0.6871657754010695,
0,2,car,crv,121,1309,390,816,1188,426,0.26945764,20,,2,0.35858585858585856,
1,2,car,crv,250,755,447,742,505,295,0.97232443,20,,2,0.35858585858585856,
2,2,car,crv,118,1317,389,817,1199,428,0.40577245,20,,2,1.2916666666666667,
3,2,car,crv,250,758,446,743,508,297,0.94312155,20,,2,1.2916666666666667,
4,2,car,crv,121,1303,387,817,1182,430,0.23037793,20,,2,0.3637901861252115,
5,2,car,crv,250,752,444,747,502,303,0.973318,20,,2,0.3637901861252115,
6,2,car,crv,129,1309,395,806,1180,411,0.31128713,20,,2,0.3483050847457627,
7,2,car,crv,248,761,449,740,513,291,0.95252526,20,,2,0.3483050847457627,
8,2,car,crv,121,1303,389,815,1182,426,0.23151965,20,,2,0.3604060913705584,
9,2,car,crv,245,754,445,744,509,299,0.9742757,20,,2,0.3604060913705584,
10,2,car,crv,124,1302,388,819,1178,431,0.20558608,20,,2,0.36587436332767403,
11,2,car,crv,252,759,447,740,507,293,0.971343,20,,2,0.36587436332767403,
12,2,car,crv,120,1318,389,815,1198,426,0.37832162,20,,2,1.24,
13,2,car,crv,248,758,449,738,510,289,0.9015974,20,,2,1.24,
14,2,car,crv,123,1313,389,813,1190,424,0.38111085,20,,2,1.24,
15,2,car,crv,247,755,446,744,508,298,0.8986612,20,,2,1.24,
16,2,car,crv,117,1315,387,816,1198,429,0.4219676,20,,2,1.2307692307692308,
17,2,car,crv,251,757,449,740,506,291,0.9306962,20,,2,1.2307692307692308,
18,2,car,crv,119,1318,391,816,1199,425,0.41724253,20,,2,1.3333333333333333,
19,2,car,crv,247,759,447,741,512,294,0.9398525,20,,2,1.3333333333333333,
20,2,car,crv,128,1307,392,813,1179,421,0.25620303,20,,2,0.3570822731128075,
21,2,car,crv,251,756,447,741,505,294,0.9512551,20,,2,0.3570822731128075,
22,2,car,crv,119,1314,386,816,1195,430,0.45291424,20,,2,1.2916666666666667,
23,2,car,crv,250,759,449,744,509,295,0.90196574,20,,2,1.2916666666666667,
24,2,car,crv,126,1304,388,820,1178,432,0.2519957,20,,2,0.366723259762309,
25,2,car,crv,253,757,448,737,504,289,0.9349736,20,,2,0.366723259762309,
26,2,car,crv,122,1317,387,818,1195,431,0.38155946,20,,2,1.24,
27,2,car,crv,248,756,447,743,508,296,0.9098617,20,,2,1.24,
28,2,car,crv,120,1319,389,808,1199,419,0.49123806,20,,2,1.24,
29,2,car,crv,241,764,446,743,523,297,0.8688812,20,,2,1.24,
30,2,car,crv,251,754,448,736,503,288,0.9627608,20,,2,1.28,
31,2,car,crv,114,1312,387,822,1198,435,0.2406673,20,,2,0.3631051752921536,
32,2,car,crv,253,758,447,739,505,292,0.9361756,20,,2,0.3631051752921536,
33,2,car,crv,121,1313,387,820,1192,433,0.26400292,20,,2,1.24,
34,2,car,crv,246,754,446,742,508,296,0.95298326,20,,2,1.24,
35,2,car,crv,131,1305,389,817,1174,428,0.29075116,20,,2,0.3645655877342419,
36,2,car,crv,252,754,448,743,502,295,0.94248277,20,,2,0.3645655877342419,
37,2,car,crv,130,1307,389,819,1177,430,0.2569041,20,,2,1.24,
38,2,car,crv,256,753,448,740,497,292,0.955823,20,,2,1.24,
39,2,car,crv,127,1305,390,811,1178,421,0.25976446,20,,2,0.35738539898132426,
40,2,car,crv,250,757,443,743,507,300,0.9547171,20,,2,0.35738539898132426,
41,2,car,crv,123,1309,392,810,1186,418,0.28978387,20,,2,1.24,
42,2,car,crv,248,758,446,738,510,292,0.96847486,20,,2,1.24,
43,2,car,crv,123,1304,388,814,1181,426,0.2588897,20,,2,0.3607112616426757,
44,2,car,crv,250,759,447,742,509,295,0.9416412,20,,2,0.3607112616426757,
45,2,car,crv,130,1306,391,810,1176,419,0.26097575,20,,2,0.3562925170068027,
46,2,car,crv,250,756,447,739,506,292,0.95065075,20,,2,0.3562925170068027,
47,2,car,crv,123,1309,389,813,1186,424,0.31858423,20,,2,1.24,
48,2,car,crv,248,758,447,745,510,298,0.9534346,20,,2,1.24,
49,2,car,crv,121,1305,386,819,1184,433,0.24762785,20,,2,0.3657094594594595,
50,2,car,crv,248,759,448,745,511,297,0.96054053,20,,2,0.3657094594594595,
51,2,car,crv,251,754,443,743,503,300,0.96310854,20,,2,1.24,
52,2,car,crv,117,1318,387,822,1201,435,0.42310923,20,,2,1.2916666666666667,
53,2,car,crv,248,763,450,742,515,292,0.92204607,20,,2,1.2916666666666667,
54,2,car,crv,119,1311,391,813,1192,422,0.25885653,20,,2,1.25,
55,2,car,crv,246,752,446,739,506,293,0.95473194,20,,2,1.25,
56,2,car,crv,128,1304,388,815,1176,427,0.30647025,20,,2,1.28,
57,2,car,crv,251,758,443,746,507,303,0.93285924,20,,2,1.28,
58,2,car,crv,250,754,447,738,504,291,0.9767751,20,,2,1.24,
59,2,car,crv,109,1318,388,813,1209,425,0.32027155,20,,2,1.28,
60,2,car,crv,245,760,445,741,515,296,0.9680706,20,,2,1.28,
61,2,car,crv,127,1308,391,816,1181,425,0.2964813,20,,2,1.2916666666666667,
62,2,car,crv,250,757,447,742,507,295,0.9490655,20,,2,1.2916666666666667,
63,2,car,crv,125,1314,388,816,1189,428,0.42268884,20,,2,1.28,
64,2,car,crv,248,760,449,737,512,288,0.90941703,20,,2,1.28,
65,2,car,crv,129,1304,390,814,1175,424,0.26254445,20,,2,1.2916666666666667,
66,2,car,crv,252,755,447,740,503,293,0.94612926,20,,2,1.2916666666666667,
67,2,car,crv,114,1320,387,815,1206,428,0.30274954,20,,2,1.24,
68,2,car,crv,248,753,446,740,505,294,0.8954264,20,,2,1.24,
69,2,car,crv,127,1307,391,814,1180,423,0.278648,20,,2,0.35847457627118645,
70,2,car,crv,250,755,447,744,505,297,0.95984495,20,,2,0.35847457627118645,
71,2,car,crv,127,1302,386,816,1175,430,0.37110242,20,,2,1.28,
72,2,car,crv,246,757,444,747,511,303,0.96607155,20,,2,1.28,
73,2,car,crv,119,1307,387,816,1188,429,0.28644451,20,,2,0.3611111111111111,
74,2,car,crv,248,759,443,747,511,304,0.9593547,20,,2,0.3611111111111111,
75,2,car,crv,127,1306,389,820,1179,431,0.37050778,20,,2,1.24,
76,2,car,crv,252,758,449,742,506,293,0.9203835,20,,2,1.24,
77,2,car,crv,126,1306,387,819,1180,432,0.24266188,20,,2,0.36610169491525424,
78,2,car,crv,247,754,449,740,507,291,0.94762105,20,,2,0.36610169491525424,
79,2,car,crv,113,1317,388,815,1204,427,0.36209753,20,,2,1.24,
80,2,car,crv,247,755,446,738,508,292,0.93217456,20,,2,1.24,
81,2,car,crv,116,1312,386,813,1196,427,0.26130736,20,,2,0.35702341137123744,
82,2,car,crv,249,755,445,740,506,295,0.95275867,20,,2,0.35702341137123744,
83,2,car,crv,250,753,445,746,503,301,0.97777426,20,,2,1.24,
84,2,car,crv,117,1316,390,813,1199,423,0.30318785,20,,2,0.35279399499582986,
85,2,car,crv,239,759,447,740,520,293,0.956478,20,,2,0.35279399499582986,
86,2,car,crv,126,1307,387,813,1181,426,0.3400013,20,,2,1.24,
87,2,car,crv,250,757,446,745,507,299,0.93553233,20,,2,1.24,
88,2,car,crv,118,1316,385,817,1198,432,0.46192503,20,,2,1.24,
89,2,car,crv,242,760,449,744,518,295,0.9251644,20,,2,1.24,
90,2,car,crv,125,1310,389,811,1185,422,0.32076746,20,,2,0.3561181434599156,
91,2,car,crv,250,758,446,739,508,293,0.9462212,20,,2,0.3561181434599156,
92,2,car,crv,250,754,444,740,504,296,0.96969557,20,,2,1.24,
93,2,car,crv,113,1313,388,814,1200,426,0.2754978,20,,2,1.24,
94,2,car,crv,244,756,445,743,512,298,0.96916515,20,,2,1.24,
95,2,car,crv,123,1309,388,814,1186,426,0.2760011,20,,2,1.24,
96,2,car,crv,249,758,446,740,509,294,0.950518,20,,2,1.24,
97,2,car,crv,253,754,447,737,501,290,0.94723046,20,,2,1.24,
98,2,car,crv,121,1308,387,817,1187,430,0.21458383,20,,2,0.36225779275484415,
99,2,car,crv,250,754,447,740,504,293,0.9610552,20,,2,0.36225779275484415,
100,2,car,crv,119,1317,388,814,1198,426,0.4732625,20,,2,1.24,
101,2,car,crv,245,758,448,742,513,294,0.94409996,20,,2,1.24,
102,2,car,crv,121,1308,388,815,1187,427,0.21448645,20,,2,0.35973041280539175,
103,2,car,crv,249,753,445,746,504,301,0.9724925,20,,2,0.35973041280539175,
104,2,car,crv,135,1302,387,821,1167,434,0.35179994,20,,2,1.2916666666666667,
105,2,car,crv,250,760,450,741,510,291,0.8736024,20,,2,1.2916666666666667,
106,2,car,crv,117,1313,390,812,1196,422,0.32242462,20,,2,1.2916666666666667,
107,2,car,crv,243,759,447,742,516,295,0.9675998,20,,2,1.2916666666666667,
108,2,car,crv,122,1311,387,814,1189,427,0.36553156,20,,2,1.2916666666666667,
109,2,car,crv,250,757,444,744,507,300,0.9479286,20,,2,1.2916666666666667,
110,2,car,crv,115,1321,388,815,1206,427,0.3674716,20,,2,1.24,
111,2,car,crv,248,756,446,740,508,294,0.92142504,20,,2,1.24,
112,2,car,crv,109,1315,384,827,1206,443,0.2820505,20,,2,1.24,
113,2,car,crv,249,758,449,736,509,287,0.91024953,20,,2,1.24,
114,2,car,crv,122,1310,388,817,1188,429,0.29904467,20,,2,0.3611111111111111,
115,2,car,crv,250,760,448,741,510,293,0.927252,20,,2,0.3611111111111111,
116,2,car,crv,129,1303,389,814,1174,425,0.27334884,20,,2,1.28,
117,2,car,crv,247,760,448,741,513,293,0.9333165,20,,2,1.28,
118,2,car,crv,122,1311,385,813,1189,428,0.35830083,20,,2,1.24,
119,2,car,crv,246,757,442,746,511,304,0.9668414,20,,2,1.24,
120,2,car,crv,122,1312,391,808,1190,417,0.34383425,20,,2,1.28,
121,2,car,crv,248,755,446,741,507,295,0.90284395,20,,2,1.28,
122,2,car,crv,129,1303,386,819,1174,433,0.2341652,20,,2,0.368824531516184,
123,2,car,crv,252,756,447,744,504,297,0.9354642,20,,2,0.368824531516184,
124,2,car,crv,253,756,446,744,503,298,0.97629297,20,,2,1.24,
125,2,car,crv,128,1307,388,817,1179,429,0.32914877,20,,2,1.2916666666666667,
126,2,car,crv,247,762,447,741,515,294,0.9441378,20,,2,1.2916666666666667,
127,2,car,crv,117,1313,388,818,1196,430,0.27251616,20,,2,0.3595317725752508,
128,2,car,crv,247,762,449,740,515,291,0.96550846,20,,2,0.3595317725752508,
129,2,car,crv,124,1305,387,820,1181,433,0.27402008,20,,2,0.36663844199830653,
130,2,car,crv,252,750,447,746,498,299,0.9501165,20,,2,0.36663844199830653,
131,2,car,crv,111,1317,390,812,1206,422,0.27479288,20,,2,0.34991708126036486,
132,2,car,crv,251,753,447,740,502,293,0.9438285,20,,2,0.34991708126036486,
133,2,car,crv,126,1309,390,814,1183,424,0.30222148,20,,2,1.2916666666666667,
134,2,car,crv,249,757,448,740,508,292,0.91383094,20,,2,1.2916666666666667,
135,2,car,crv,111,1317,390,811,1206,421,0.2941505,20,,2,0.3490878938640133,
136,2,car,crv,247,756,446,741,509,295,0.96245986,20,,2,0.3490878938640133,
137,2,car,crv,134,1300,387,818,1166,431,0.35928637,20,,2,1.28,
138,2,car,crv,251,757,447,743,506,296,0.9412378,20,,2,1.28,
139,2,car,crv,126,1312,388,815,1186,427,0.3965622,20,,2,1.24,
140,2,car,crv,252,758,446,743,506,297,0.9420341,20,,2,1.24,
141,2,car,crv,121,1316,389,809,1195,420,0.4096516,20,,2,1.24,
142,2,car,crv,244,761,447,742,517,295,0.9289579,20,,2,1.24,
143,2,car,crv,125,1312,392,805,1187,413,0.30284005,20,,2,1.24,
144,2,car,crv,245,760,447,739,515,292,0.9596912,20,,2,1.24,
145,2,car,crv,131,1307,388,812,1176,424,0.43397242,20,,2,1.2916666666666667,
146,2,car,crv,247,764,447,744,517,297,0.9014591,20,,2,1.2916666666666667,
147,2,car,crv,123,1315,388,811,1192,423,0.4968379,20,,2,1.24,
148,2,car,crv,246,758,446,743,512,297,0.87933147,20,,2,1.24,
149,2,car,crv,118,1312,389,813,1194,424,0.25691053,20,,2,0.35510887772194305,
150,2,car,crv,249,756,447,742,507,295,0.96910256,20,,2,0.35510887772194305,
151,2,car,crv,118,1319,389,813,1201,424,0.4023961,20,,2,1.28,
152,2,car,crv,243,757,448,743,514,295,0.94143236,20,,2,1.28,
153,2,car,crv,119,1322,385,815,1203,430,0.42900166,20,,2,1.24,
154,2,car,crv,246,762,447,741,516,294,0.790523,20,,2,1.24,
155,2,car,crv,119,1319,386,815,1200,429,0.44753623,20,,2,1.28,
156,2,car,crv,248,759,450,741,511,291,0.8263495,20,,2,1.28,
157,2,car,crv,114,1318,387,813,1204,426,0.43434885,20,,2,1.2916666666666667,
158,2,car,crv,246,759,446,744,513,298,0.9186257,20,,2,1.2916666666666667,
159,2,car,crv,119,1325,389,808,1206,419,0.46840343,20,,2,1.24,
160,2,car,crv,244,759,447,741,515,294,0.83414143,20,,2,1.24,
161,2,car,crv,116,1322,388,811,1206,423,0.44209528,20,,2,1.28,
162,2,car,crv,241,764,450,741,523,291,0.8834957,20,,2,1.28,
163,2,car,crv,334,710,446,701,376,255,0.92716336,3,0,2,0.6781914893617021,
164,2,car,crv,336,711,446,700,375,254,0.9036748,3,0,2,0.6773333333333333,
165,2,car,crv,335,709,444,701,374,257,0.9452533,3,0,2,0.6871657754010695,
0,2,car,crv,129,1303,385,817,1174,432,0.33652014,20,,2,1.25,
1,2,car,crv,247,762,444,744,515,300,0.95280766,20,,2,1.25,
2,2,car,crv,121,1309,390,816,1188,426,0.26945764,20,,2,0.35858585858585856,
3,2,car,crv,250,755,447,742,505,295,0.97232443,20,,2,0.35858585858585856,
4,2,car,crv,118,1317,389,817,1199,428,0.40577245,20,,2,1.2916666666666667,
5,2,car,crv,250,758,446,743,508,297,0.94312155,20,,2,1.2916666666666667,
6,2,car,crv,121,1303,387,817,1182,430,0.23037793,20,,2,0.3637901861252115,
7,2,car,crv,250,752,444,747,502,303,0.973318,20,,2,0.3637901861252115,
8,2,car,crv,129,1309,395,806,1180,411,0.31128713,20,,2,0.3483050847457627,
9,2,car,crv,248,761,449,740,513,291,0.95252526,20,,2,0.3483050847457627,
10,2,car,crv,121,1303,389,815,1182,426,0.23151965,20,,2,0.3604060913705584,
11,2,car,crv,245,754,445,744,509,299,0.9742757,20,,2,0.3604060913705584,
12,2,car,crv,124,1302,388,819,1178,431,0.20558608,20,,2,0.36587436332767403,
13,2,car,crv,252,759,447,740,507,293,0.971343,20,,2,0.36587436332767403,
14,2,car,crv,120,1318,389,815,1198,426,0.37832162,20,,2,1.24,
15,2,car,crv,248,758,449,738,510,289,0.9015974,20,,2,1.24,
16,2,car,crv,123,1313,389,813,1190,424,0.38111085,20,,2,1.24,
17,2,car,crv,247,755,446,744,508,298,0.8986612,20,,2,1.24,
18,2,car,crv,117,1315,387,816,1198,429,0.4219676,20,,2,1.2307692307692308,
19,2,car,crv,251,757,449,740,506,291,0.9306962,20,,2,1.2307692307692308,
20,2,car,crv,119,1318,391,816,1199,425,0.41724253,20,,2,1.3333333333333333,
21,2,car,crv,247,759,447,741,512,294,0.9398525,20,,2,1.3333333333333333,
22,2,car,crv,128,1307,392,813,1179,421,0.25620303,20,,2,0.3570822731128075,
23,2,car,crv,251,756,447,741,505,294,0.9512551,20,,2,0.3570822731128075,
24,2,car,crv,119,1314,386,816,1195,430,0.45291424,20,,2,1.2916666666666667,
25,2,car,crv,250,759,449,744,509,295,0.90196574,20,,2,1.2916666666666667,
26,2,car,crv,126,1304,388,820,1178,432,0.2519957,20,,2,0.366723259762309,
27,2,car,crv,253,757,448,737,504,289,0.9349736,20,,2,0.366723259762309,
28,2,car,crv,122,1317,387,818,1195,431,0.38155946,20,,2,1.24,
29,2,car,crv,248,756,447,743,508,296,0.9098617,20,,2,1.24,
30,2,car,crv,120,1319,389,808,1199,419,0.49123806,20,,2,1.24,
31,2,car,crv,241,764,446,743,523,297,0.8688812,20,,2,1.24,
32,2,car,crv,251,754,448,736,503,288,0.9627608,20,,2,1.28,
33,2,car,crv,114,1312,387,822,1198,435,0.2406673,20,,2,0.3631051752921536,
34,2,car,crv,253,758,447,739,505,292,0.9361756,20,,2,0.3631051752921536,
35,2,car,crv,121,1313,387,820,1192,433,0.26400292,20,,2,1.24,
36,2,car,crv,246,754,446,742,508,296,0.95298326,20,,2,1.24,
37,2,car,crv,131,1305,389,817,1174,428,0.29075116,20,,2,0.3645655877342419,
38,2,car,crv,252,754,448,743,502,295,0.94248277,20,,2,0.3645655877342419,
39,2,car,crv,130,1307,389,819,1177,430,0.2569041,20,,2,1.24,
40,2,car,crv,256,753,448,740,497,292,0.955823,20,,2,1.24,
41,2,car,crv,127,1305,390,811,1178,421,0.25976446,20,,2,0.35738539898132426,
42,2,car,crv,250,757,443,743,507,300,0.9547171,20,,2,0.35738539898132426,
43,2,car,crv,123,1309,392,810,1186,418,0.28978387,20,,2,1.24,
44,2,car,crv,248,758,446,738,510,292,0.96847486,20,,2,1.24,
45,2,car,crv,123,1304,388,814,1181,426,0.2588897,20,,2,0.3607112616426757,
46,2,car,crv,250,759,447,742,509,295,0.9416412,20,,2,0.3607112616426757,
47,2,car,crv,130,1306,391,810,1176,419,0.26097575,20,,2,0.3562925170068027,
48,2,car,crv,250,756,447,739,506,292,0.95065075,20,,2,0.3562925170068027,
49,2,car,crv,123,1309,389,813,1186,424,0.31858423,20,,2,1.24,
50,2,car,crv,248,758,447,745,510,298,0.9534346,20,,2,1.24,
51,2,car,crv,121,1305,386,819,1184,433,0.24762785,20,,2,0.3657094594594595,
52,2,car,crv,248,759,448,745,511,297,0.96054053,20,,2,0.3657094594594595,
53,2,car,crv,251,754,443,743,503,300,0.96310854,20,,2,1.24,
54,2,car,crv,117,1318,387,822,1201,435,0.42310923,20,,2,1.2916666666666667,
55,2,car,crv,248,763,450,742,515,292,0.92204607,20,,2,1.2916666666666667,
56,2,car,crv,119,1311,391,813,1192,422,0.25885653,20,,2,1.25,
57,2,car,crv,246,752,446,739,506,293,0.95473194,20,,2,1.25,
58,2,car,crv,128,1304,388,815,1176,427,0.30647025,20,,2,1.28,
59,2,car,crv,251,758,443,746,507,303,0.93285924,20,,2,1.28,
60,2,car,crv,250,754,447,738,504,291,0.9767751,20,,2,1.24,
61,2,car,crv,109,1318,388,813,1209,425,0.32027155,20,,2,1.28,
62,2,car,crv,245,760,445,741,515,296,0.9680706,20,,2,1.28,
63,2,car,crv,127,1308,391,816,1181,425,0.2964813,20,,2,1.2916666666666667,
64,2,car,crv,250,757,447,742,507,295,0.9490655,20,,2,1.2916666666666667,
65,2,car,crv,125,1314,388,816,1189,428,0.42268884,20,,2,1.28,
66,2,car,crv,248,760,449,737,512,288,0.90941703,20,,2,1.28,
67,2,car,crv,129,1304,390,814,1175,424,0.26254445,20,,2,1.2916666666666667,
68,2,car,crv,252,755,447,740,503,293,0.94612926,20,,2,1.2916666666666667,
69,2,car,crv,114,1320,387,815,1206,428,0.30274954,20,,2,1.24,
70,2,car,crv,248,753,446,740,505,294,0.8954264,20,,2,1.24,
71,2,car,crv,127,1307,391,814,1180,423,0.278648,20,,2,0.35847457627118645,
72,2,car,crv,250,755,447,744,505,297,0.95984495,20,,2,0.35847457627118645,
73,2,car,crv,127,1302,386,816,1175,430,0.37110242,20,,2,1.28,
74,2,car,crv,246,757,444,747,511,303,0.96607155,20,,2,1.28,
75,2,car,crv,119,1307,387,816,1188,429,0.28644451,20,,2,0.3611111111111111,
76,2,car,crv,248,759,443,747,511,304,0.9593547,20,,2,0.3611111111111111,
77,2,car,crv,127,1306,389,820,1179,431,0.37050778,20,,2,1.24,
78,2,car,crv,252,758,449,742,506,293,0.9203835,20,,2,1.24,
79,2,car,crv,126,1306,387,819,1180,432,0.24266188,20,,2,0.36610169491525424,
80,2,car,crv,247,754,449,740,507,291,0.94762105,20,,2,0.36610169491525424,
81,2,car,crv,113,1317,388,815,1204,427,0.36209753,20,,2,1.24,
82,2,car,crv,247,755,446,738,508,292,0.93217456,20,,2,1.24,
83,2,car,crv,116,1312,386,813,1196,427,0.26130736,20,,2,0.35702341137123744,
84,2,car,crv,249,755,445,740,506,295,0.95275867,20,,2,0.35702341137123744,
85,2,car,crv,250,753,445,746,503,301,0.97777426,20,,2,1.24,
86,2,car,crv,117,1316,390,813,1199,423,0.30318785,20,,2,0.35279399499582986,
87,2,car,crv,239,759,447,740,520,293,0.956478,20,,2,0.35279399499582986,
88,2,car,crv,126,1307,387,813,1181,426,0.3400013,20,,2,1.24,
89,2,car,crv,250,757,446,745,507,299,0.93553233,20,,2,1.24,
90,2,car,crv,118,1316,385,817,1198,432,0.46192503,20,,2,1.24,
91,2,car,crv,242,760,449,744,518,295,0.9251644,20,,2,1.24,
92,2,car,crv,125,1310,389,811,1185,422,0.32076746,20,,2,0.3561181434599156,
93,2,car,crv,250,758,446,739,508,293,0.9462212,20,,2,0.3561181434599156,
94,2,car,crv,250,754,444,740,504,296,0.96969557,20,,2,1.24,
95,2,car,crv,113,1313,388,814,1200,426,0.2754978,20,,2,1.24,
96,2,car,crv,244,756,445,743,512,298,0.96916515,20,,2,1.24,
97,2,car,crv,123,1309,388,814,1186,426,0.2760011,20,,2,1.24,
98,2,car,crv,249,758,446,740,509,294,0.950518,20,,2,1.24,
99,2,car,crv,253,754,447,737,501,290,0.94723046,20,,2,1.24,
100,2,car,crv,121,1308,387,817,1187,430,0.21458383,20,,2,0.36225779275484415,
101,2,car,crv,250,754,447,740,504,293,0.9610552,20,,2,0.36225779275484415,
102,2,car,crv,119,1317,388,814,1198,426,0.4732625,20,,2,1.24,
103,2,car,crv,245,758,448,742,513,294,0.94409996,20,,2,1.24,
104,2,car,crv,121,1308,388,815,1187,427,0.21448645,20,,2,0.35973041280539175,
105,2,car,crv,249,753,445,746,504,301,0.9724925,20,,2,0.35973041280539175,
106,2,car,crv,135,1302,387,821,1167,434,0.35179994,20,,2,1.2916666666666667,
107,2,car,crv,250,760,450,741,510,291,0.8736024,20,,2,1.2916666666666667,
108,2,car,crv,117,1313,390,812,1196,422,0.32242462,20,,2,1.2916666666666667,
109,2,car,crv,243,759,447,742,516,295,0.9675998,20,,2,1.2916666666666667,
110,2,car,crv,122,1311,387,814,1189,427,0.36553156,20,,2,1.2916666666666667,
111,2,car,crv,250,757,444,744,507,300,0.9479286,20,,2,1.2916666666666667,
112,2,car,crv,115,1321,388,815,1206,427,0.3674716,20,,2,1.24,
113,2,car,crv,248,756,446,740,508,294,0.92142504,20,,2,1.24,
114,2,car,crv,109,1315,384,827,1206,443,0.2820505,20,,2,1.24,
115,2,car,crv,249,758,449,736,509,287,0.91024953,20,,2,1.24,
116,2,car,crv,122,1310,388,817,1188,429,0.29904467,20,,2,0.3611111111111111,
117,2,car,crv,250,760,448,741,510,293,0.927252,20,,2,0.3611111111111111,
118,2,car,crv,129,1303,389,814,1174,425,0.27334884,20,,2,1.28,
119,2,car,crv,247,760,448,741,513,293,0.9333165,20,,2,1.28,
120,2,car,crv,122,1311,385,813,1189,428,0.35830083,20,,2,1.24,
121,2,car,crv,246,757,442,746,511,304,0.9668414,20,,2,1.24,
122,2,car,crv,122,1312,391,808,1190,417,0.34383425,20,,2,1.28,
123,2,car,crv,248,755,446,741,507,295,0.90284395,20,,2,1.28,
124,2,car,crv,129,1303,386,819,1174,433,0.2341652,20,,2,0.368824531516184,
125,2,car,crv,252,756,447,744,504,297,0.9354642,20,,2,0.368824531516184,
126,2,car,crv,253,756,446,744,503,298,0.97629297,20,,2,1.24,
127,2,car,crv,128,1307,388,817,1179,429,0.32914877,20,,2,1.2916666666666667,
128,2,car,crv,247,762,447,741,515,294,0.9441378,20,,2,1.2916666666666667,
129,2,car,crv,117,1313,388,818,1196,430,0.27251616,20,,2,0.3595317725752508,
130,2,car,crv,247,762,449,740,515,291,0.96550846,20,,2,0.3595317725752508,
131,2,car,crv,124,1305,387,820,1181,433,0.27402008,20,,2,0.36663844199830653,
132,2,car,crv,252,750,447,746,498,299,0.9501165,20,,2,0.36663844199830653,
133,2,car,crv,111,1317,390,812,1206,422,0.27479288,20,,2,0.34991708126036486,
134,2,car,crv,251,753,447,740,502,293,0.9438285,20,,2,0.34991708126036486,
135,2,car,crv,126,1309,390,814,1183,424,0.30222148,20,,2,1.2916666666666667,
136,2,car,crv,249,757,448,740,508,292,0.91383094,20,,2,1.2916666666666667,
137,2,car,crv,111,1317,390,811,1206,421,0.2941505,20,,2,0.3490878938640133,
138,2,car,crv,247,756,446,741,509,295,0.96245986,20,,2,0.3490878938640133,
139,2,car,crv,134,1300,387,818,1166,431,0.35928637,20,,2,1.28,
140,2,car,crv,251,757,447,743,506,296,0.9412378,20,,2,1.28,
141,2,car,crv,126,1312,388,815,1186,427,0.3965622,20,,2,1.24,
142,2,car,crv,252,758,446,743,506,297,0.9420341,20,,2,1.24,
143,2,car,crv,121,1316,389,809,1195,420,0.4096516,20,,2,1.24,
144,2,car,crv,244,761,447,742,517,295,0.9289579,20,,2,1.24,
145,2,car,crv,125,1312,392,805,1187,413,0.30284005,20,,2,1.24,
146,2,car,crv,245,760,447,739,515,292,0.9596912,20,,2,1.24,
147,2,car,crv,131,1307,388,812,1176,424,0.43397242,20,,2,1.2916666666666667,
148,2,car,crv,247,764,447,744,517,297,0.9014591,20,,2,1.2916666666666667,
149,2,car,crv,123,1315,388,811,1192,423,0.4968379,20,,2,1.24,
150,2,car,crv,246,758,446,743,512,297,0.87933147,20,,2,1.24,
151,2,car,crv,118,1312,389,813,1194,424,0.25691053,20,,2,0.35510887772194305,
152,2,car,crv,249,756,447,742,507,295,0.96910256,20,,2,0.35510887772194305,
153,2,car,crv,118,1319,389,813,1201,424,0.4023961,20,,2,1.28,
154,2,car,crv,243,757,448,743,514,295,0.94143236,20,,2,1.28,
155,2,car,crv,119,1322,385,815,1203,430,0.42900166,20,,2,1.24,
156,2,car,crv,246,762,447,741,516,294,0.790523,20,,2,1.24,
157,2,car,crv,119,1319,386,815,1200,429,0.44753623,20,,2,1.28,
158,2,car,crv,248,759,450,741,511,291,0.8263495,20,,2,1.28,
159,2,car,crv,114,1318,387,813,1204,426,0.43434885,20,,2,1.2916666666666667,
160,2,car,crv,246,759,446,744,513,298,0.9186257,20,,2,1.2916666666666667,
161,2,car,crv,119,1325,389,808,1206,419,0.46840343,20,,2,1.24,
162,2,car,crv,244,759,447,741,515,294,0.83414143,20,,2,1.24,
163,2,car,crv,116,1322,388,811,1206,423,0.44209528,20,,2,1.28,
164,2,car,crv,241,764,450,741,523,291,0.8834957,20,,2,1.28,
165,2,car,crv,334,710,446,701,376,255,0.92716336,3,0,2,0.6781914893617021,
166,2,car,crv,336,711,446,700,375,254,0.9036748,3,0,2,0.6773333333333333,
167,2,car,crv,335,709,444,701,374,257,0.9452533,3,0,2,0.6871657754010695,
0,2,car,crv,120,1307,387,819,1187,432,0.29826218,20,,2,0.36394271272114576,
1,2,car,crv,251,756,446,743,505,297,0.96940076,20,,2,0.36394271272114576,
2,2,car,crv,129,1303,385,817,1174,432,0.33652014,20,,2,1.25,
3,2,car,crv,247,762,444,744,515,300,0.95280766,20,,2,1.25,
4,2,car,crv,121,1309,390,816,1188,426,0.26945764,20,,2,0.35858585858585856,
5,2,car,crv,250,755,447,742,505,295,0.97232443,20,,2,0.35858585858585856,
6,2,car,crv,118,1317,389,817,1199,428,0.40577245,20,,2,1.2916666666666667,
7,2,car,crv,250,758,446,743,508,297,0.94312155,20,,2,1.2916666666666667,
8,2,car,crv,121,1303,387,817,1182,430,0.23037793,20,,2,0.3637901861252115,
9,2,car,crv,250,752,444,747,502,303,0.973318,20,,2,0.3637901861252115,
10,2,car,crv,129,1309,395,806,1180,411,0.31128713,20,,2,0.3483050847457627,
11,2,car,crv,248,761,449,740,513,291,0.95252526,20,,2,0.3483050847457627,
12,2,car,crv,121,1303,389,815,1182,426,0.23151965,20,,2,0.3604060913705584,
13,2,car,crv,245,754,445,744,509,299,0.9742757,20,,2,0.3604060913705584,
14,2,car,crv,124,1302,388,819,1178,431,0.20558608,20,,2,0.36587436332767403,
15,2,car,crv,252,759,447,740,507,293,0.971343,20,,2,0.36587436332767403,
16,2,car,crv,120,1318,389,815,1198,426,0.37832162,20,,2,1.24,
17,2,car,crv,248,758,449,738,510,289,0.9015974,20,,2,1.24,
18,2,car,crv,123,1313,389,813,1190,424,0.38111085,20,,2,1.24,
19,2,car,crv,247,755,446,744,508,298,0.8986612,20,,2,1.24,
20,2,car,crv,117,1315,387,816,1198,429,0.4219676,20,,2,1.2307692307692308,
21,2,car,crv,251,757,449,740,506,291,0.9306962,20,,2,1.2307692307692308,
22,2,car,crv,119,1318,391,816,1199,425,0.41724253,20,,2,1.3333333333333333,
23,2,car,crv,247,759,447,741,512,294,0.9398525,20,,2,1.3333333333333333,
24,2,car,crv,128,1307,392,813,1179,421,0.25620303,20,,2,0.3570822731128075,
25,2,car,crv,251,756,447,741,505,294,0.9512551,20,,2,0.3570822731128075,
26,2,car,crv,119,1314,386,816,1195,430,0.45291424,20,,2,1.2916666666666667,
27,2,car,crv,250,759,449,744,509,295,0.90196574,20,,2,1.2916666666666667,
28,2,car,crv,126,1304,388,820,1178,432,0.2519957,20,,2,0.366723259762309,
29,2,car,crv,253,757,448,737,504,289,0.9349736,20,,2,0.366723259762309,
30,2,car,crv,122,1317,387,818,1195,431,0.38155946,20,,2,1.24,
31,2,car,crv,248,756,447,743,508,296,0.9098617,20,,2,1.24,
32,2,car,crv,120,1319,389,808,1199,419,0.49123806,20,,2,1.24,
33,2,car,crv,241,764,446,743,523,297,0.8688812,20,,2,1.24,
34,2,car,crv,251,754,448,736,503,288,0.9627608,20,,2,1.28,
35,2,car,crv,114,1312,387,822,1198,435,0.2406673,20,,2,0.3631051752921536,
36,2,car,crv,253,758,447,739,505,292,0.9361756,20,,2,0.3631051752921536,
37,2,car,crv,121,1313,387,820,1192,433,0.26400292,20,,2,1.24,
38,2,car,crv,246,754,446,742,508,296,0.95298326,20,,2,1.24,
39,2,car,crv,131,1305,389,817,1174,428,0.29075116,20,,2,0.3645655877342419,
40,2,car,crv,252,754,448,743,502,295,0.94248277,20,,2,0.3645655877342419,
41,2,car,crv,130,1307,389,819,1177,430,0.2569041,20,,2,1.24,
42,2,car,crv,256,753,448,740,497,292,0.955823,20,,2,1.24,
43,2,car,crv,127,1305,390,811,1178,421,0.25976446,20,,2,0.35738539898132426,
44,2,car,crv,250,757,443,743,507,300,0.9547171,20,,2,0.35738539898132426,
45,2,car,crv,123,1309,392,810,1186,418,0.28978387,20,,2,1.24,
46,2,car,crv,248,758,446,738,510,292,0.96847486,20,,2,1.24,
47,2,car,crv,123,1304,388,814,1181,426,0.2588897,20,,2,0.3607112616426757,
48,2,car,crv,250,759,447,742,509,295,0.9416412,20,,2,0.3607112616426757,
49,2,car,crv,130,1306,391,810,1176,419,0.26097575,20,,2,0.3562925170068027,
50,2,car,crv,250,756,447,739,506,292,0.95065075,20,,2,0.3562925170068027,
51,2,car,crv,123,1309,389,813,1186,424,0.31858423,20,,2,1.24,
52,2,car,crv,248,758,447,745,510,298,0.9534346,20,,2,1.24,
53,2,car,crv,121,1305,386,819,1184,433,0.24762785,20,,2,0.3657094594594595,
54,2,car,crv,248,759,448,745,511,297,0.96054053,20,,2,0.3657094594594595,
55,2,car,crv,251,754,443,743,503,300,0.96310854,20,,2,1.24,
56,2,car,crv,117,1318,387,822,1201,435,0.42310923,20,,2,1.2916666666666667,
57,2,car,crv,248,763,450,742,515,292,0.92204607,20,,2,1.2916666666666667,
58,2,car,crv,119,1311,391,813,1192,422,0.25885653,20,,2,1.25,
59,2,car,crv,246,752,446,739,506,293,0.95473194,20,,2,1.25,
60,2,car,crv,128,1304,388,815,1176,427,0.30647025,20,,2,1.28,
61,2,car,crv,251,758,443,746,507,303,0.93285924,20,,2,1.28,
62,2,car,crv,250,754,447,738,504,291,0.9767751,20,,2,1.24,
63,2,car,crv,109,1318,388,813,1209,425,0.32027155,20,,2,1.28,
64,2,car,crv,245,760,445,741,515,296,0.9680706,20,,2,1.28,
65,2,car,crv,127,1308,391,816,1181,425,0.2964813,20,,2,1.2916666666666667,
66,2,car,crv,250,757,447,742,507,295,0.9490655,20,,2,1.2916666666666667,
67,2,car,crv,125,1314,388,816,1189,428,0.42268884,20,,2,1.28,
68,2,car,crv,248,760,449,737,512,288,0.90941703,20,,2,1.28,
69,2,car,crv,129,1304,390,814,1175,424,0.26254445,20,,2,1.2916666666666667,
70,2,car,crv,252,755,447,740,503,293,0.94612926,20,,2,1.2916666666666667,
71,2,car,crv,114,1320,387,815,1206,428,0.30274954,20,,2,1.24,
72,2,car,crv,248,753,446,740,505,294,0.8954264,20,,2,1.24,
73,2,car,crv,127,1307,391,814,1180,423,0.278648,20,,2,0.35847457627118645,
74,2,car,crv,250,755,447,744,505,297,0.95984495,20,,2,0.35847457627118645,
75,2,car,crv,127,1302,386,816,1175,430,0.37110242,20,,2,1.28,
76,2,car,crv,246,757,444,747,511,303,0.96607155,20,,2,1.28,
77,2,car,crv,119,1307,387,816,1188,429,0.28644451,20,,2,0.3611111111111111,
78,2,car,crv,248,759,443,747,511,304,0.9593547,20,,2,0.3611111111111111,
79,2,car,crv,127,1306,389,820,1179,431,0.37050778,20,,2,1.24,
80,2,car,crv,252,758,449,742,506,293,0.9203835,20,,2,1.24,
81,2,car,crv,126,1306,387,819,1180,432,0.24266188,20,,2,0.36610169491525424,
82,2,car,crv,247,754,449,740,507,291,0.94762105,20,,2,0.36610169491525424,
83,2,car,crv,113,1317,388,815,1204,427,0.36209753,20,,2,1.24,
84,2,car,crv,247,755,446,738,508,292,0.93217456,20,,2,1.24,
85,2,car,crv,116,1312,386,813,1196,427,0.26130736,20,,2,0.35702341137123744,
86,2,car,crv,249,755,445,740,506,295,0.95275867,20,,2,0.35702341137123744,
87,2,car,crv,250,753,445,746,503,301,0.97777426,20,,2,1.24,
88,2,car,crv,117,1316,390,813,1199,423,0.30318785,20,,2,0.35279399499582986,
89,2,car,crv,239,759,447,740,520,293,0.956478,20,,2,0.35279399499582986,
90,2,car,crv,126,1307,387,813,1181,426,0.3400013,20,,2,1.24,
91,2,car,crv,250,757,446,745,507,299,0.93553233,20,,2,1.24,
92,2,car,crv,118,1316,385,817,1198,432,0.46192503,20,,2,1.24,
93,2,car,crv,242,760,449,744,518,295,0.9251644,20,,2,1.24,
94,2,car,crv,125,1310,389,811,1185,422,0.32076746,20,,2,0.3561181434599156,
95,2,car,crv,250,758,446,739,508,293,0.9462212,20,,2,0.3561181434599156,
96,2,car,crv,250,754,444,740,504,296,0.96969557,20,,2,1.24,
97,2,car,crv,113,1313,388,814,1200,426,0.2754978,20,,2,1.24,
98,2,car,crv,244,756,445,743,512,298,0.96916515,20,,2,1.24,
99,2,car,crv,123,1309,388,814,1186,426,0.2760011,20,,2,1.24,
100,2,car,crv,249,758,446,740,509,294,0.950518,20,,2,1.24,
101,2,car,crv,253,754,447,737,501,290,0.94723046,20,,2,1.24,
102,2,car,crv,121,1308,387,817,1187,430,0.21458383,20,,2,0.36225779275484415,
103,2,car,crv,250,754,447,740,504,293,0.9610552,20,,2,0.36225779275484415,
104,2,car,crv,119,1317,388,814,1198,426,0.4732625,20,,2,1.24,
105,2,car,crv,245,758,448,742,513,294,0.94409996,20,,2,1.24,
106,2,car,crv,121,1308,388,815,1187,427,0.21448645,20,,2,0.35973041280539175,
107,2,car,crv,249,753,445,746,504,301,0.9724925,20,,2,0.35973041280539175,
108,2,car,crv,135,1302,387,821,1167,434,0.35179994,20,,2,1.2916666666666667,
109,2,car,crv,250,760,450,741,510,291,0.8736024,20,,2,1.2916666666666667,
110,2,car,crv,117,1313,390,812,1196,422,0.32242462,20,,2,1.2916666666666667,
111,2,car,crv,243,759,447,742,516,295,0.9675998,20,,2,1.2916666666666667,
112,2,car,crv,122,1311,387,814,1189,427,0.36553156,20,,2,1.2916666666666667,
113,2,car,crv,250,757,444,744,507,300,0.9479286,20,,2,1.2916666666666667,
114,2,car,crv,115,1321,388,815,1206,427,0.3674716,20,,2,1.24,
115,2,car,crv,248,756,446,740,508,294,0.92142504,20,,2,1.24,
116,2,car,crv,109,1315,384,827,1206,443,0.2820505,20,,2,1.24,
117,2,car,crv,249,758,449,736,509,287,0.91024953,20,,2,1.24,
118,2,car,crv,122,1310,388,817,1188,429,0.29904467,20,,2,0.3611111111111111,
119,2,car,crv,250,760,448,741,510,293,0.927252,20,,2,0.3611111111111111,
120,2,car,crv,129,1303,389,814,1174,425,0.27334884,20,,2,1.28,
121,2,car,crv,247,760,448,741,513,293,0.9333165,20,,2,1.28,
122,2,car,crv,122,1311,385,813,1189,428,0.35830083,20,,2,1.24,
123,2,car,crv,246,757,442,746,511,304,0.9668414,20,,2,1.24,
124,2,car,crv,122,1312,391,808,1190,417,0.34383425,20,,2,1.28,
125,2,car,crv,248,755,446,741,507,295,0.90284395,20,,2,1.28,
126,2,car,crv,129,1303,386,819,1174,433,0.2341652,20,,2,0.368824531516184,
127,2,car,crv,252,756,447,744,504,297,0.9354642,20,,2,0.368824531516184,
128,2,car,crv,253,756,446,744,503,298,0.97629297,20,,2,1.24,
129,2,car,crv,128,1307,388,817,1179,429,0.32914877,20,,2,1.2916666666666667,
130,2,car,crv,247,762,447,741,515,294,0.9441378,20,,2,1.2916666666666667,
131,2,car,crv,117,1313,388,818,1196,430,0.27251616,20,,2,0.3595317725752508,
132,2,car,crv,247,762,449,740,515,291,0.96550846,20,,2,0.3595317725752508,
133,2,car,crv,124,1305,387,820,1181,433,0.27402008,20,,2,0.36663844199830653,
134,2,car,crv,252,750,447,746,498,299,0.9501165,20,,2,0.36663844199830653,
135,2,car,crv,111,1317,390,812,1206,422,0.27479288,20,,2,0.34991708126036486,
136,2,car,crv,251,753,447,740,502,293,0.9438285,20,,2,0.34991708126036486,
137,2,car,crv,126,1309,390,814,1183,424,0.30222148,20,,2,1.2916666666666667,
138,2,car,crv,249,757,448,740,508,292,0.91383094,20,,2,1.2916666666666667,
139,2,car,crv,111,1317,390,811,1206,421,0.2941505,20,,2,0.3490878938640133,
140,2,car,crv,247,756,446,741,509,295,0.96245986,20,,2,0.3490878938640133,
141,2,car,crv,134,1300,387,818,1166,431,0.35928637,20,,2,1.28,
142,2,car,crv,251,757,447,743,506,296,0.9412378,20,,2,1.28,
143,2,car,crv,126,1312,388,815,1186,427,0.3965622,20,,2,1.24,
144,2,car,crv,252,758,446,743,506,297,0.9420341,20,,2,1.24,
145,2,car,crv,121,1316,389,809,1195,420,0.4096516,20,,2,1.24,
146,2,car,crv,244,761,447,742,517,295,0.9289579,20,,2,1.24,
147,2,car,crv,125,1312,392,805,1187,413,0.30284005,20,,2,1.24,
148,2,car,crv,245,760,447,739,515,292,0.9596912,20,,2,1.24,
149,2,car,crv,131,1307,388,812,1176,424,0.43397242,20,,2,1.2916666666666667,
150,2,car,crv,247,764,447,744,517,297,0.9014591,20,,2,1.2916666666666667,
151,2,car,crv,123,1315,388,811,1192,423,0.4968379,20,,2,1.24,
152,2,car,crv,246,758,446,743,512,297,0.87933147,20,,2,1.24,
153,2,car,crv,118,1312,389,813,1194,424,0.25691053,20,,2,0.35510887772194305,
154,2,car,crv,249,756,447,742,507,295,0.96910256,20,,2,0.35510887772194305,
155,2,car,crv,118,1319,389,813,1201,424,0.4023961,20,,2,1.28,
156,2,car,crv,243,757,448,743,514,295,0.94143236,20,,2,1.28,
157,2,car,crv,119,1322,385,815,1203,430,0.42900166,20,,2,1.24,
158,2,car,crv,246,762,447,741,516,294,0.790523,20,,2,1.24,
159,2,car,crv,119,1319,386,815,1200,429,0.44753623,20,,2,1.28,
160,2,car,crv,248,759,450,741,511,291,0.8263495,20,,2,1.28,
161,2,car,crv,114,1318,387,813,1204,426,0.43434885,20,,2,1.2916666666666667,
162,2,car,crv,246,759,446,744,513,298,0.9186257,20,,2,1.2916666666666667,
163,2,car,crv,119,1325,389,808,1206,419,0.46840343,20,,2,1.24,
164,2,car,crv,244,759,447,741,515,294,0.83414143,20,,2,1.24,
165,2,car,crv,116,1322,388,811,1206,423,0.44209528,20,,2,1.28,
166,2,car,crv,241,764,450,741,523,291,0.8834957,20,,2,1.28,
167,2,car,crv,334,710,446,701,376,255,0.92716336,3,0,2,0.6781914893617021,
168,2,car,crv,336,711,446,700,375,254,0.9036748,3,0,2,0.6773333333333333,
169,2,car,crv,335,709,444,701,374,257,0.9452533,3,0,2,0.6871657754010695,
0,2,car,crv,122,1317,391,811,1195,420,0.44330603,20,,2,1.24,
1,2,car,crv,243,763,449,737,520,288,0.921945,20,,2,1.24,
2,2,car,crv,120,1307,387,819,1187,432,0.29826218,20,,2,0.36394271272114576,
3,2,car,crv,251,756,446,743,505,297,0.96940076,20,,2,0.36394271272114576,
4,2,car,crv,129,1303,385,817,1174,432,0.33652014,20,,2,1.25,
5,2,car,crv,247,762,444,744,515,300,0.95280766,20,,2,1.25,
6,2,car,crv,121,1309,390,816,1188,426,0.26945764,20,,2,0.35858585858585856,
7,2,car,crv,250,755,447,742,505,295,0.97232443,20,,2,0.35858585858585856,
8,2,car,crv,118,1317,389,817,1199,428,0.40577245,20,,2,1.2916666666666667,
9,2,car,crv,250,758,446,743,508,297,0.94312155,20,,2,1.2916666666666667,
10,2,car,crv,121,1303,387,817,1182,430,0.23037793,20,,2,0.3637901861252115,
11,2,car,crv,250,752,444,747,502,303,0.973318,20,,2,0.3637901861252115,
12,2,car,crv,129,1309,395,806,1180,411,0.31128713,20,,2,0.3483050847457627,
13,2,car,crv,248,761,449,740,513,291,0.95252526,20,,2,0.3483050847457627,
14,2,car,crv,121,1303,389,815,1182,426,0.23151965,20,,2,0.3604060913705584,
15,2,car,crv,245,754,445,744,509,299,0.9742757,20,,2,0.3604060913705584,
16,2,car,crv,124,1302,388,819,1178,431,0.20558608,20,,2,0.36587436332767403,
17,2,car,crv,252,759,447,740,507,293,0.971343,20,,2,0.36587436332767403,
18,2,car,crv,120,1318,389,815,1198,426,0.37832162,20,,2,1.24,
19,2,car,crv,248,758,449,738,510,289,0.9015974,20,,2,1.24,
20,2,car,crv,123,1313,389,813,1190,424,0.38111085,20,,2,1.24,
21,2,car,crv,247,755,446,744,508,298,0.8986612,20,,2,1.24,
22,2,car,crv,117,1315,387,816,1198,429,0.4219676,20,,2,1.2307692307692308,
23,2,car,crv,251,757,449,740,506,291,0.9306962,20,,2,1.2307692307692308,
24,2,car,crv,119,1318,391,816,1199,425,0.41724253,20,,2,1.3333333333333333,
25,2,car,crv,247,759,447,741,512,294,0.9398525,20,,2,1.3333333333333333,
26,2,car,crv,128,1307,392,813,1179,421,0.25620303,20,,2,0.3570822731128075,
27,2,car,crv,251,756,447,741,505,294,0.9512551,20,,2,0.3570822731128075,
28,2,car,crv,119,1314,386,816,1195,430,0.45291424,20,,2,1.2916666666666667,
29,2,car,crv,250,759,449,744,509,295,0.90196574,20,,2,1.2916666666666667,
30,2,car,crv,126,1304,388,820,1178,432,0.2519957,20,,2,0.366723259762309,
31,2,car,crv,253,757,448,737,504,289,0.9349736,20,,2,0.366723259762309,
32,2,car,crv,122,1317,387,818,1195,431,0.38155946,20,,2,1.24,
33,2,car,crv,248,756,447,743,508,296,0.9098617,20,,2,1.24,
34,2,car,crv,120,1319,389,808,1199,419,0.49123806,20,,2,1.24,
35,2,car,crv,241,764,446,743,523,297,0.8688812,20,,2,1.24,
36,2,car,crv,251,754,448,736,503,288,0.9627608,20,,2,1.28,
37,2,car,crv,114,1312,387,822,1198,435,0.2406673,20,,2,0.3631051752921536,
38,2,car,crv,253,758,447,739,505,292,0.9361756,20,,2,0.3631051752921536,
39,2,car,crv,121,1313,387,820,1192,433,0.26400292,20,,2,1.24,
40,2,car,crv,246,754,446,742,508,296,0.95298326,20,,2,1.24,
41,2,car,crv,131,1305,389,817,1174,428,0.29075116,20,,2,0.3645655877342419,
42,2,car,crv,252,754,448,743,502,295,0.94248277,20,,2,0.3645655877342419,
43,2,car,crv,130,1307,389,819,1177,430,0.2569041,20,,2,1.24,
44,2,car,crv,256,753,448,740,497,292,0.955823,20,,2,1.24,
45,2,car,crv,127,1305,390,811,1178,421,0.25976446,20,,2,0.35738539898132426,
46,2,car,crv,250,757,443,743,507,300,0.9547171,20,,2,0.35738539898132426,
47,2,car,crv,123,1309,392,810,1186,418,0.28978387,20,,2,1.24,
48,2,car,crv,248,758,446,738,510,292,0.96847486,20,,2,1.24,
49,2,car,crv,123,1304,388,814,1181,426,0.2588897,20,,2,0.3607112616426757,
50,2,car,crv,250,759,447,742,509,295,0.9416412,20,,2,0.3607112616426757,
51,2,car,crv,130,1306,391,810,1176,419,0.26097575,20,,2,0.3562925170068027,
52,2,car,crv,250,756,447,739,506,292,0.95065075,20,,2,0.3562925170068027,
53,2,car,crv,123,1309,389,813,1186,424,0.31858423,20,,2,1.24,
54,2,car,crv,248,758,447,745,510,298,0.9534346,20,,2,1.24,
55,2,car,crv,121,1305,386,819,1184,433,0.24762785,20,,2,0.3657094594594595,
56,2,car,crv,248,759,448,745,511,297,0.96054053,20,,2,0.3657094594594595,
57,2,car,crv,251,754,443,743,503,300,0.96310854,20,,2,1.24,
58,2,car,crv,117,1318,387,822,1201,435,0.42310923,20,,2,1.2916666666666667,
59,2,car,crv,248,763,450,742,515,292,0.92204607,20,,2,1.2916666666666667,
60,2,car,crv,119,1311,391,813,1192,422,0.25885653,20,,2,1.25,
61,2,car,crv,246,752,446,739,506,293,0.95473194,20,,2,1.25,
62,2,car,crv,128,1304,388,815,1176,427,0.30647025,20,,2,1.28,
63,2,car,crv,251,758,443,746,507,303,0.93285924,20,,2,1.28,
64,2,car,crv,250,754,447,738,504,291,0.9767751,20,,2,1.24,
65,2,car,crv,109,1318,388,813,1209,425,0.32027155,20,,2,1.28,
66,2,car,crv,245,760,445,741,515,296,0.9680706,20,,2,1.28,
67,2,car,crv,127,1308,391,816,1181,425,0.2964813,20,,2,1.2916666666666667,
68,2,car,crv,250,757,447,742,507,295,0.9490655,20,,2,1.2916666666666667,
69,2,car,crv,125,1314,388,816,1189,428,0.42268884,20,,2,1.28,
70,2,car,crv,248,760,449,737,512,288,0.90941703,20,,2,1.28,
71,2,car,crv,129,1304,390,814,1175,424,0.26254445,20,,2,1.2916666666666667,
72,2,car,crv,252,755,447,740,503,293,0.94612926,20,,2,1.2916666666666667,
73,2,car,crv,114,1320,387,815,1206,428,0.30274954,20,,2,1.24,
74,2,car,crv,248,753,446,740,505,294,0.8954264,20,,2,1.24,
75,2,car,crv,127,1307,391,814,1180,423,0.278648,20,,2,0.35847457627118645,
76,2,car,crv,250,755,447,744,505,297,0.95984495,20,,2,0.35847457627118645,
77,2,car,crv,127,1302,386,816,1175,430,0.37110242,20,,2,1.28,
78,2,car,crv,246,757,444,747,511,303,0.96607155,20,,2,1.28,
79,2,car,crv,119,1307,387,816,1188,429,0.28644451,20,,2,0.3611111111111111,
80,2,car,crv,248,759,443,747,511,304,0.9593547,20,,2,0.3611111111111111,
81,2,car,crv,127,1306,389,820,1179,431,0.37050778,20,,2,1.24,
82,2,car,crv,252,758,449,742,506,293,0.9203835,20,,2,1.24,
83,2,car,crv,126,1306,387,819,1180,432,0.24266188,20,,2,0.36610169491525424,
84,2,car,crv,247,754,449,740,507,291,0.94762105,20,,2,0.36610169491525424,
85,2,car,crv,113,1317,388,815,1204,427,0.36209753,20,,2,1.24,
86,2,car,crv,247,755,446,738,508,292,0.93217456,20,,2,1.24,
87,2,car,crv,116,1312,386,813,1196,427,0.26130736,20,,2,0.35702341137123744,
88,2,car,crv,249,755,445,740,506,295,0.95275867,20,,2,0.35702341137123744,
89,2,car,crv,250,753,445,746,503,301,0.97777426,20,,2,1.24,
90,2,car,crv,117,1316,390,813,1199,423,0.30318785,20,,2,0.35279399499582986,
91,2,car,crv,239,759,447,740,520,293,0.956478,20,,2,0.35279399499582986,
92,2,car,crv,126,1307,387,813,1181,426,0.3400013,20,,2,1.24,
93,2,car,crv,250,757,446,745,507,299,0.93553233,20,,2,1.24,
94,2,car,crv,118,1316,385,817,1198,432,0.46192503,20,,2,1.24,
95,2,car,crv,242,760,449,744,518,295,0.9251644,20,,2,1.24,
96,2,car,crv,125,1310,389,811,1185,422,0.32076746,20,,2,0.3561181434599156,
97,2,car,crv,250,758,446,739,508,293,0.9462212,20,,2,0.3561181434599156,
98,2,car,crv,250,754,444,740,504,296,0.96969557,20,,2,1.24,
99,2,car,crv,113,1313,388,814,1200,426,0.2754978,20,,2,1.24,
100,2,car,crv,244,756,445,743,512,298,0.96916515,20,,2,1.24,
101,2,car,crv,123,1309,388,814,1186,426,0.2760011,20,,2,1.24,
102,2,car,crv,249,758,446,740,509,294,0.950518,20,,2,1.24,
103,2,car,crv,253,754,447,737,501,290,0.94723046,20,,2,1.24,
104,2,car,crv,121,1308,387,817,1187,430,0.21458383,20,,2,0.36225779275484415,
105,2,car,crv,250,754,447,740,504,293,0.9610552,20,,2,0.36225779275484415,
106,2,car,crv,119,1317,388,814,1198,426,0.4732625,20,,2,1.24,
107,2,car,crv,245,758,448,742,513,294,0.94409996,20,,2,1.24,
108,2,car,crv,121,1308,388,815,1187,427,0.21448645,20,,2,0.35973041280539175,
109,2,car,crv,249,753,445,746,504,301,0.9724925,20,,2,0.35973041280539175,
110,2,car,crv,135,1302,387,821,1167,434,0.35179994,20,,2,1.2916666666666667,
111,2,car,crv,250,760,450,741,510,291,0.8736024,20,,2,1.2916666666666667,
112,2,car,crv,117,1313,390,812,1196,422,0.32242462,20,,2,1.2916666666666667,
113,2,car,crv,243,759,447,742,516,295,0.9675998,20,,2,1.2916666666666667,
114,2,car,crv,122,1311,387,814,1189,427,0.36553156,20,,2,1.2916666666666667,
115,2,car,crv,250,757,444,744,507,300,0.9479286,20,,2,1.2916666666666667,
116,2,car,crv,115,1321,388,815,1206,427,0.3674716,20,,2,1.24,
117,2,car,crv,248,756,446,740,508,294,0.92142504,20,,2,1.24,
118,2,car,crv,109,1315,384,827,1206,443,0.2820505,20,,2,1.24,
119,2,car,crv,249,758,449,736,509,287,0.91024953,20,,2,1.24,
120,2,car,crv,122,1310,388,817,1188,429,0.29904467,20,,2,0.3611111111111111,
121,2,car,crv,250,760,448,741,510,293,0.927252,20,,2,0.3611111111111111,
122,2,car,crv,129,1303,389,814,1174,425,0.27334884,20,,2,1.28,
123,2,car,crv,247,760,448,741,513,293,0.9333165,20,,2,1.28,
124,2,car,crv,122,1311,385,813,1189,428,0.35830083,20,,2,1.24,
125,2,car,crv,246,757,442,746,511,304,0.9668414,20,,2,1.24,
126,2,car,crv,122,1312,391,808,1190,417,0.34383425,20,,2,1.28,
127,2,car,crv,248,755,446,741,507,295,0.90284395,20,,2,1.28,
128,2,car,crv,129,1303,386,819,1174,433,0.2341652,20,,2,0.368824531516184,
129,2,car,crv,252,756,447,744,504,297,0.9354642,20,,2,0.368824531516184,
130,2,car,crv,253,756,446,744,503,298,0.97629297,20,,2,1.24,
131,2,car,crv,128,1307,388,817,1179,429,0.32914877,20,,2,1.2916666666666667,
132,2,car,crv,247,762,447,741,515,294,0.9441378,20,,2,1.2916666666666667,
133,2,car,crv,117,1313,388,818,1196,430,0.27251616,20,,2,0.3595317725752508,
134,2,car,crv,247,762,449,740,515,291,0.96550846,20,,2,0.3595317725752508,
135,2,car,crv,124,1305,387,820,1181,433,0.27402008,20,,2,0.36663844199830653,
136,2,car,crv,252,750,447,746,498,299,0.9501165,20,,2,0.36663844199830653,
137,2,car,crv,111,1317,390,812,1206,422,0.27479288,20,,2,0.34991708126036486,
138,2,car,crv,251,753,447,740,502,293,0.9438285,20,,2,0.34991708126036486,
139,2,car,crv,126,1309,390,814,1183,424,0.30222148,20,,2,1.2916666666666667,
140,2,car,crv,249,757,448,740,508,292,0.91383094,20,,2,1.2916666666666667,
141,2,car,crv,111,1317,390,811,1206,421,0.2941505,20,,2,0.3490878938640133,
142,2,car,crv,247,756,446,741,509,295,0.96245986,20,,2,0.3490878938640133,
143,2,car,crv,134,1300,387,818,1166,431,0.35928637,20,,2,1.28,
144,2,car,crv,251,757,447,743,506,296,0.9412378,20,,2,1.28,
145,2,car,crv,126,1312,388,815,1186,427,0.3965622,20,,2,1.24,
146,2,car,crv,252,758,446,743,506,297,0.9420341,20,,2,1.24,
147,2,car,crv,121,1316,389,809,1195,420,0.4096516,20,,2,1.24,
148,2,car,crv,244,761,447,742,517,295,0.9289579,20,,2,1.24,
149,2,car,crv,125,1312,392,805,1187,413,0.30284005,20,,2,1.24,
150,2,car,crv,245,760,447,739,515,292,0.9596912,20,,2,1.24,
151,2,car,crv,131,1307,388,812,1176,424,0.43397242,20,,2,1.2916666666666667,
152,2,car,crv,247,764,447,744,517,297,0.9014591,20,,2,1.2916666666666667,
153,2,car,crv,123,1315,388,811,1192,423,0.4968379,20,,2,1.24,
154,2,car,crv,246,758,446,743,512,297,0.87933147,20,,2,1.24,
155,2,car,crv,118,1312,389,813,1194,424,0.25691053,20,,2,0.35510887772194305,
156,2,car,crv,249,756,447,742,507,295,0.96910256,20,,2,0.35510887772194305,
157,2,car,crv,118,1319,389,813,1201,424,0.4023961,20,,2,1.28,
158,2,car,crv,243,757,448,743,514,295,0.94143236,20,,2,1.28,
159,2,car,crv,119,1322,385,815,1203,430,0.42900166,20,,2,1.24,
160,2,car,crv,246,762,447,741,516,294,0.790523,20,,2,1.24,
161,2,car,crv,119,1319,386,815,1200,429,0.44753623,20,,2,1.28,
162,2,car,crv,248,759,450,741,511,291,0.8263495,20,,2,1.28,
163,2,car,crv,114,1318,387,813,1204,426,0.43434885,20,,2,1.2916666666666667,
164,2,car,crv,246,759,446,744,513,298,0.9186257,20,,2,1.2916666666666667,
165,2,car,crv,119,1325,389,808,1206,419,0.46840343,20,,2,1.24,
166,2,car,crv,244,759,447,741,515,294,0.83414143,20,,2,1.24,
167,2,car,crv,116,1322,388,811,1206,423,0.44209528,20,,2,1.28,
168,2,car,crv,241,764,450,741,523,291,0.8834957,20,,2,1.28,
169,2,car,crv,334,710,446,701,376,255,0.92716336,3,0,2,0.6781914893617021,
170,2,car,crv,336,711,446,700,375,254,0.9036748,3,0,2,0.6773333333333333,
171,2,car,crv,335,709,444,701,374,257,0.9452533,3,0,2,0.6871657754010695,
0,2,car,crv,129,1310,386,816,1181,430,0.3428058,20,,2,1.2916666666666667,
1,2,car,crv,247,760,447,740,513,293,0.8918332,20,,2,1.2916666666666667,
2,2,car,crv,122,1317,391,811,1195,420,0.44330603,20,,2,1.24,
3,2,car,crv,243,763,449,737,520,288,0.921945,20,,2,1.24,
4,2,car,crv,120,1307,387,819,1187,432,0.29826218,20,,2,0.36394271272114576,
5,2,car,crv,251,756,446,743,505,297,0.96940076,20,,2,0.36394271272114576,
6,2,car,crv,129,1303,385,817,1174,432,0.33652014,20,,2,1.25,
7,2,car,crv,247,762,444,744,515,300,0.95280766,20,,2,1.25,
8,2,car,crv,121,1309,390,816,1188,426,0.26945764,20,,2,0.35858585858585856,
9,2,car,crv,250,755,447,742,505,295,0.97232443,20,,2,0.35858585858585856,
10,2,car,crv,118,1317,389,817,1199,428,0.40577245,20,,2,1.2916666666666667,
11,2,car,crv,250,758,446,743,508,297,0.94312155,20,,2,1.2916666666666667,
12,2,car,crv,121,1303,387,817,1182,430,0.23037793,20,,2,0.3637901861252115,
13,2,car,crv,250,752,444,747,502,303,0.973318,20,,2,0.3637901861252115,
14,2,car,crv,129,1309,395,806,1180,411,0.31128713,20,,2,0.3483050847457627,
15,2,car,crv,248,761,449,740,513,291,0.95252526,20,,2,0.3483050847457627,
16,2,car,crv,121,1303,389,815,1182,426,0.23151965,20,,2,0.3604060913705584,
17,2,car,crv,245,754,445,744,509,299,0.9742757,20,,2,0.3604060913705584,
18,2,car,crv,124,1302,388,819,1178,431,0.20558608,20,,2,0.36587436332767403,
19,2,car,crv,252,759,447,740,507,293,0.971343,20,,2,0.36587436332767403,
20,2,car,crv,120,1318,389,815,1198,426,0.37832162,20,,2,1.24,
21,2,car,crv,248,758,449,738,510,289,0.9015974,20,,2,1.24,
22,2,car,crv,123,1313,389,813,1190,424,0.38111085,20,,2,1.24,
23,2,car,crv,247,755,446,744,508,298,0.8986612,20,,2,1.24,
24,2,car,crv,117,1315,387,816,1198,429,0.4219676,20,,2,1.2307692307692308,
25,2,car,crv,251,757,449,740,506,291,0.9306962,20,,2,1.2307692307692308,
26,2,car,crv,119,1318,391,816,1199,425,0.41724253,20,,2,1.3333333333333333,
27,2,car,crv,247,759,447,741,512,294,0.9398525,20,,2,1.3333333333333333,
28,2,car,crv,128,1307,392,813,1179,421,0.25620303,20,,2,0.3570822731128075,
29,2,car,crv,251,756,447,741,505,294,0.9512551,20,,2,0.3570822731128075,
30,2,car,crv,119,1314,386,816,1195,430,0.45291424,20,,2,1.2916666666666667,
31,2,car,crv,250,759,449,744,509,295,0.90196574,20,,2,1.2916666666666667,
32,2,car,crv,126,1304,388,820,1178,432,0.2519957,20,,2,0.366723259762309,
33,2,car,crv,253,757,448,737,504,289,0.9349736,20,,2,0.366723259762309,
34,2,car,crv,122,1317,387,818,1195,431,0.38155946,20,,2,1.24,
35,2,car,crv,248,756,447,743,508,296,0.9098617,20,,2,1.24,
36,2,car,crv,120,1319,389,808,1199,419,0.49123806,20,,2,1.24,
37,2,car,crv,241,764,446,743,523,297,0.8688812,20,,2,1.24,
38,2,car,crv,251,754,448,736,503,288,0.9627608,20,,2,1.28,
39,2,car,crv,114,1312,387,822,1198,435,0.2406673,20,,2,0.3631051752921536,
40,2,car,crv,253,758,447,739,505,292,0.9361756,20,,2,0.3631051752921536,
41,2,car,crv,121,1313,387,820,1192,433,0.26400292,20,,2,1.24,
42,2,car,crv,246,754,446,742,508,296,0.95298326,20,,2,1.24,
43,2,car,crv,131,1305,389,817,1174,428,0.29075116,20,,2,0.3645655877342419,
44,2,car,crv,252,754,448,743,502,295,0.94248277,20,,2,0.3645655877342419,
45,2,car,crv,130,1307,389,819,1177,430,0.2569041,20,,2,1.24,
46,2,car,crv,256,753,448,740,497,292,0.955823,20,,2,1.24,
47,2,car,crv,127,1305,390,811,1178,421,0.25976446,20,,2,0.35738539898132426,
48,2,car,crv,250,757,443,743,507,300,0.9547171,20,,2,0.35738539898132426,
49,2,car,crv,123,1309,392,810,1186,418,0.28978387,20,,2,1.24,
50,2,car,crv,248,758,446,738,510,292,0.96847486,20,,2,1.24,
51,2,car,crv,123,1304,388,814,1181,426,0.2588897,20,,2,0.3607112616426757,
52,2,car,crv,250,759,447,742,509,295,0.9416412,20,,2,0.3607112616426757,
53,2,car,crv,130,1306,391,810,1176,419,0.26097575,20,,2,0.3562925170068027,
54,2,car,crv,250,756,447,739,506,292,0.95065075,20,,2,0.3562925170068027,
55,2,car,crv,123,1309,389,813,1186,424,0.31858423,20,,2,1.24,
56,2,car,crv,248,758,447,745,510,298,0.9534346,20,,2,1.24,
57,2,car,crv,121,1305,386,819,1184,433,0.24762785,20,,2,0.3657094594594595,
58,2,car,crv,248,759,448,745,511,297,0.96054053,20,,2,0.3657094594594595,
59,2,car,crv,251,754,443,743,503,300,0.96310854,20,,2,1.24,
60,2,car,crv,117,1318,387,822,1201,435,0.42310923,20,,2,1.2916666666666667,
61,2,car,crv,248,763,450,742,515,292,0.92204607,20,,2,1.2916666666666667,
62,2,car,crv,119,1311,391,813,1192,422,0.25885653,20,,2,1.25,
63,2,car,crv,246,752,446,739,506,293,0.95473194,20,,2,1.25,
64,2,car,crv,128,1304,388,815,1176,427,0.30647025,20,,2,1.28,
65,2,car,crv,251,758,443,746,507,303,0.93285924,20,,2,1.28,
66,2,car,crv,250,754,447,738,504,291,0.9767751,20,,2,1.24,
67,2,car,crv,109,1318,388,813,1209,425,0.32027155,20,,2,1.28,
68,2,car,crv,245,760,445,741,515,296,0.9680706,20,,2,1.28,
69,2,car,crv,127,1308,391,816,1181,425,0.2964813,20,,2,1.2916666666666667,
70,2,car,crv,250,757,447,742,507,295,0.9490655,20,,2,1.2916666666666667,
71,2,car,crv,125,1314,388,816,1189,428,0.42268884,20,,2,1.28,
72,2,car,crv,248,760,449,737,512,288,0.90941703,20,,2,1.28,
73,2,car,crv,129,1304,390,814,1175,424,0.26254445,20,,2,1.2916666666666667,
74,2,car,crv,252,755,447,740,503,293,0.94612926,20,,2,1.2916666666666667,
75,2,car,crv,114,1320,387,815,1206,428,0.30274954,20,,2,1.24,
76,2,car,crv,248,753,446,740,505,294,0.8954264,20,,2,1.24,
77,2,car,crv,127,1307,391,814,1180,423,0.278648,20,,2,0.35847457627118645,
78,2,car,crv,250,755,447,744,505,297,0.95984495,20,,2,0.35847457627118645,
79,2,car,crv,127,1302,386,816,1175,430,0.37110242,20,,2,1.28,
80,2,car,crv,246,757,444,747,511,303,0.96607155,20,,2,1.28,
81,2,car,crv,119,1307,387,816,1188,429,0.28644451,20,,2,0.3611111111111111,
82,2,car,crv,248,759,443,747,511,304,0.9593547,20,,2,0.3611111111111111,
83,2,car,crv,127,1306,389,820,1179,431,0.37050778,20,,2,1.24,
84,2,car,crv,252,758,449,742,506,293,0.9203835,20,,2,1.24,
85,2,car,crv,126,1306,387,819,1180,432,0.24266188,20,,2,0.36610169491525424,
86,2,car,crv,247,754,449,740,507,291,0.94762105,20,,2,0.36610169491525424,
87,2,car,crv,113,1317,388,815,1204,427,0.36209753,20,,2,1.24,
88,2,car,crv,247,755,446,738,508,292,0.93217456,20,,2,1.24,
89,2,car,crv,116,1312,386,813,1196,427,0.26130736,20,,2,0.35702341137123744,
90,2,car,crv,249,755,445,740,506,295,0.95275867,20,,2,0.35702341137123744,
91,2,car,crv,250,753,445,746,503,301,0.97777426,20,,2,1.24,
92,2,car,crv,117,1316,390,813,1199,423,0.30318785,20,,2,0.35279399499582986,
93,2,car,crv,239,759,447,740,520,293,0.956478,20,,2,0.35279399499582986,
94,2,car,crv,126,1307,387,813,1181,426,0.3400013,20,,2,1.24,
95,2,car,crv,250,757,446,745,507,299,0.93553233,20,,2,1.24,
96,2,car,crv,118,1316,385,817,1198,432,0.46192503,20,,2,1.24,
97,2,car,crv,242,760,449,744,518,295,0.9251644,20,,2,1.24,
98,2,car,crv,125,1310,389,811,1185,422,0.32076746,20,,2,0.3561181434599156,
99,2,car,crv,250,758,446,739,508,293,0.9462212,20,,2,0.3561181434599156,
100,2,car,crv,250,754,444,740,504,296,0.96969557,20,,2,1.24,
101,2,car,crv,113,1313,388,814,1200,426,0.2754978,20,,2,1.24,
102,2,car,crv,244,756,445,743,512,298,0.96916515,20,,2,1.24,
103,2,car,crv,123,1309,388,814,1186,426,0.2760011,20,,2,1.24,
104,2,car,crv,249,758,446,740,509,294,0.950518,20,,2,1.24,
105,2,car,crv,253,754,447,737,501,290,0.94723046,20,,2,1.24,
106,2,car,crv,121,1308,387,817,1187,430,0.21458383,20,,2,0.36225779275484415,
107,2,car,crv,250,754,447,740,504,293,0.9610552,20,,2,0.36225779275484415,
108,2,car,crv,119,1317,388,814,1198,426,0.4732625,20,,2,1.24,
109,2,car,crv,245,758,448,742,513,294,0.94409996,20,,2,1.24,
110,2,car,crv,121,1308,388,815,1187,427,0.21448645,20,,2,0.35973041280539175,
111,2,car,crv,249,753,445,746,504,301,0.9724925,20,,2,0.35973041280539175,
112,2,car,crv,135,1302,387,821,1167,434,0.35179994,20,,2,1.2916666666666667,
113,2,car,crv,250,760,450,741,510,291,0.8736024,20,,2,1.2916666666666667,
114,2,car,crv,117,1313,390,812,1196,422,0.32242462,20,,2,1.2916666666666667,
115,2,car,crv,243,759,447,742,516,295,0.9675998,20,,2,1.2916666666666667,
116,2,car,crv,122,1311,387,814,1189,427,0.36553156,20,,2,1.2916666666666667,
117,2,car,crv,250,757,444,744,507,300,0.9479286,20,,2,1.2916666666666667,
118,2,car,crv,115,1321,388,815,1206,427,0.3674716,20,,2,1.24,
119,2,car,crv,248,756,446,740,508,294,0.92142504,20,,2,1.24,
120,2,car,crv,109,1315,384,827,1206,443,0.2820505,20,,2,1.24,
121,2,car,crv,249,758,449,736,509,287,0.91024953,20,,2,1.24,
122,2,car,crv,122,1310,388,817,1188,429,0.29904467,20,,2,0.3611111111111111,
123,2,car,crv,250,760,448,741,510,293,0.927252,20,,2,0.3611111111111111,
124,2,car,crv,129,1303,389,814,1174,425,0.27334884,20,,2,1.28,
125,2,car,crv,247,760,448,741,513,293,0.9333165,20,,2,1.28,
126,2,car,crv,122,1311,385,813,1189,428,0.35830083,20,,2,1.24,
127,2,car,crv,246,757,442,746,511,304,0.9668414,20,,2,1.24,
128,2,car,crv,122,1312,391,808,1190,417,0.34383425,20,,2,1.28,
129,2,car,crv,248,755,446,741,507,295,0.90284395,20,,2,1.28,
130,2,car,crv,129,1303,386,819,1174,433,0.2341652,20,,2,0.368824531516184,
131,2,car,crv,252,756,447,744,504,297,0.9354642,20,,2,0.368824531516184,
132,2,car,crv,253,756,446,744,503,298,0.97629297,20,,2,1.24,
133,2,car,crv,128,1307,388,817,1179,429,0.32914877,20,,2,1.2916666666666667,
134,2,car,crv,247,762,447,741,515,294,0.9441378,20,,2,1.2916666666666667,
135,2,car,crv,117,1313,388,818,1196,430,0.27251616,20,,2,0.3595317725752508,
136,2,car,crv,247,762,449,740,515,291,0.96550846,20,,2,0.3595317725752508,
137,2,car,crv,124,1305,387,820,1181,433,0.27402008,20,,2,0.36663844199830653,
138,2,car,crv,252,750,447,746,498,299,0.9501165,20,,2,0.36663844199830653,
139,2,car,crv,111,1317,390,812,1206,422,0.27479288,20,,2,0.34991708126036486,
140,2,car,crv,251,753,447,740,502,293,0.9438285,20,,2,0.34991708126036486,
141,2,car,crv,126,1309,390,814,1183,424,0.30222148,20,,2,1.2916666666666667,
142,2,car,crv,249,757,448,740,508,292,0.91383094,20,,2,1.2916666666666667,
143,2,car,crv,111,1317,390,811,1206,421,0.2941505,20,,2,0.3490878938640133,
144,2,car,crv,247,756,446,741,509,295,0.96245986,20,,2,0.3490878938640133,
145,2,car,crv,134,1300,387,818,1166,431,0.35928637,20,,2,1.28,
146,2,car,crv,251,757,447,743,506,296,0.9412378,20,,2,1.28,
147,2,car,crv,126,1312,388,815,1186,427,0.3965622,20,,2,1.24,
148,2,car,crv,252,758,446,743,506,297,0.9420341,20,,2,1.24,
149,2,car,crv,121,1316,389,809,1195,420,0.4096516,20,,2,1.24,
150,2,car,crv,244,761,447,742,517,295,0.9289579,20,,2,1.24,
151,2,car,crv,125,1312,392,805,1187,413,0.30284005,20,,2,1.24,
152,2,car,crv,245,760,447,739,515,292,0.9596912,20,,2,1.24,
153,2,car,crv,131,1307,388,812,1176,424,0.43397242,20,,2,1.2916666666666667,
154,2,car,crv,247,764,447,744,517,297,0.9014591,20,,2,1.2916666666666667,
155,2,car,crv,123,1315,388,811,1192,423,0.4968379,20,,2,1.24,
156,2,car,crv,246,758,446,743,512,297,0.87933147,20,,2,1.24,
157,2,car,crv,118,1312,389,813,1194,424,0.25691053,20,,2,0.35510887772194305,
158,2,car,crv,249,756,447,742,507,295,0.96910256,20,,2,0.35510887772194305,
159,2,car,crv,118,1319,389,813,1201,424,0.4023961,20,,2,1.28,
160,2,car,crv,243,757,448,743,514,295,0.94143236,20,,2,1.28,
161,2,car,crv,119,1322,385,815,1203,430,0.42900166,20,,2,1.24,
162,2,car,crv,246,762,447,741,516,294,0.790523,20,,2,1.24,
163,2,car,crv,119,1319,386,815,1200,429,0.44753623,20,,2,1.28,
164,2,car,crv,248,759,450,741,511,291,0.8263495,20,,2,1.28,
165,2,car,crv,114,1318,387,813,1204,426,0.43434885,20,,2,1.2916666666666667,
166,2,car,crv,246,759,446,744,513,298,0.9186257,20,,2,1.2916666666666667,
167,2,car,crv,119,1325,389,808,1206,419,0.46840343,20,,2,1.24,
168,2,car,crv,244,759,447,741,515,294,0.83414143,20,,2,1.24,
169,2,car,crv,116,1322,388,811,1206,423,0.44209528,20,,2,1.28,
170,2,car,crv,241,764,450,741,523,291,0.8834957,20,,2,1.28,
171,2,car,crv,334,710,446,701,376,255,0.92716336,3,0,2,0.6781914893617021,
172,2,car,crv,336,711,446,700,375,254,0.9036748,3,0,2,0.6773333333333333,
173,2,car,crv,335,709,444,701,374,257,0.9452533,3,0,2,0.6871657754010695,
0,2,car,crv,110,1316,390,815,1206,425,0.20233919,20,,2,0.3524046434494196,
1,2,car,crv,250,753,447,736,503,289,0.9751715,20,,2,0.3524046434494196,
2,2,car,crv,129,1310,386,816,1181,430,0.3428058,20,,2,1.2916666666666667,
3,2,car,crv,247,760,447,740,513,293,0.8918332,20,,2,1.2916666666666667,
4,2,car,crv,122,1317,391,811,1195,420,0.44330603,20,,2,1.24,
5,2,car,crv,243,763,449,737,520,288,0.921945,20,,2,1.24,
6,2,car,crv,120,1307,387,819,1187,432,0.29826218,20,,2,0.36394271272114576,
7,2,car,crv,251,756,446,743,505,297,0.96940076,20,,2,0.36394271272114576,
8,2,car,crv,129,1303,385,817,1174,432,0.33652014,20,,2,1.25,
9,2,car,crv,247,762,444,744,515,300,0.95280766,20,,2,1.25,
10,2,car,crv,121,1309,390,816,1188,426,0.26945764,20,,2,0.35858585858585856,
11,2,car,crv,250,755,447,742,505,295,0.97232443,20,,2,0.35858585858585856,
12,2,car,crv,118,1317,389,817,1199,428,0.40577245,20,,2,1.2916666666666667,
13,2,car,crv,250,758,446,743,508,297,0.94312155,20,,2,1.2916666666666667,
14,2,car,crv,121,1303,387,817,1182,430,0.23037793,20,,2,0.3637901861252115,
15,2,car,crv,250,752,444,747,502,303,0.973318,20,,2,0.3637901861252115,
16,2,car,crv,129,1309,395,806,1180,411,0.31128713,20,,2,0.3483050847457627,
17,2,car,crv,248,761,449,740,513,291,0.95252526,20,,2,0.3483050847457627,
18,2,car,crv,121,1303,389,815,1182,426,0.23151965,20,,2,0.3604060913705584,
19,2,car,crv,245,754,445,744,509,299,0.9742757,20,,2,0.3604060913705584,
20,2,car,crv,124,1302,388,819,1178,431,0.20558608,20,,2,0.36587436332767403,
21,2,car,crv,252,759,447,740,507,293,0.971343,20,,2,0.36587436332767403,
22,2,car,crv,120,1318,389,815,1198,426,0.37832162,20,,2,1.24,
23,2,car,crv,248,758,449,738,510,289,0.9015974,20,,2,1.24,
24,2,car,crv,123,1313,389,813,1190,424,0.38111085,20,,2,1.24,
25,2,car,crv,247,755,446,744,508,298,0.8986612,20,,2,1.24,
26,2,car,crv,117,1315,387,816,1198,429,0.4219676,20,,2,1.2307692307692308,
27,2,car,crv,251,757,449,740,506,291,0.9306962,20,,2,1.2307692307692308,
28,2,car,crv,119,1318,391,816,1199,425,0.41724253,20,,2,1.3333333333333333,
29,2,car,crv,247,759,447,741,512,294,0.9398525,20,,2,1.3333333333333333,
30,2,car,crv,128,1307,392,813,1179,421,0.25620303,20,,2,0.3570822731128075,
31,2,car,crv,251,756,447,741,505,294,0.9512551,20,,2,0.3570822731128075,
32,2,car,crv,119,1314,386,816,1195,430,0.45291424,20,,2,1.2916666666666667,
33,2,car,crv,250,759,449,744,509,295,0.90196574,20,,2,1.2916666666666667,
34,2,car,crv,126,1304,388,820,1178,432,0.2519957,20,,2,0.366723259762309,
35,2,car,crv,253,757,448,737,504,289,0.9349736,20,,2,0.366723259762309,
36,2,car,crv,122,1317,387,818,1195,431,0.38155946,20,,2,1.24,
37,2,car,crv,248,756,447,743,508,296,0.9098617,20,,2,1.24,
38,2,car,crv,120,1319,389,808,1199,419,0.49123806,20,,2,1.24,
39,2,car,crv,241,764,446,743,523,297,0.8688812,20,,2,1.24,
40,2,car,crv,251,754,448,736,503,288,0.9627608,20,,2,1.28,
41,2,car,crv,114,1312,387,822,1198,435,0.2406673,20,,2,0.3631051752921536,
42,2,car,crv,253,758,447,739,505,292,0.9361756,20,,2,0.3631051752921536,
43,2,car,crv,121,1313,387,820,1192,433,0.26400292,20,,2,1.24,
44,2,car,crv,246,754,446,742,508,296,0.95298326,20,,2,1.24,
45,2,car,crv,131,1305,389,817,1174,428,0.29075116,20,,2,0.3645655877342419,
46,2,car,crv,252,754,448,743,502,295,0.94248277,20,,2,0.3645655877342419,
47,2,car,crv,130,1307,389,819,1177,430,0.2569041,20,,2,1.24,
48,2,car,crv,256,753,448,740,497,292,0.955823,20,,2,1.24,
49,2,car,crv,127,1305,390,811,1178,421,0.25976446,20,,2,0.35738539898132426,
50,2,car,crv,250,757,443,743,507,300,0.9547171,20,,2,0.35738539898132426,
51,2,car,crv,123,1309,392,810,1186,418,0.28978387,20,,2,1.24,
52,2,car,crv,248,758,446,738,510,292,0.96847486,20,,2,1.24,
53,2,car,crv,123,1304,388,814,1181,426,0.2588897,20,,2,0.3607112616426757,
54,2,car,crv,250,759,447,742,509,295,0.9416412,20,,2,0.3607112616426757,
55,2,car,crv,130,1306,391,810,1176,419,0.26097575,20,,2,0.3562925170068027,
56,2,car,crv,250,756,447,739,506,292,0.95065075,20,,2,0.3562925170068027,
57,2,car,crv,123,1309,389,813,1186,424,0.31858423,20,,2,1.24,
58,2,car,crv,248,758,447,745,510,298,0.9534346,20,,2,1.24,
59,2,car,crv,121,1305,386,819,1184,433,0.24762785,20,,2,0.3657094594594595,
60,2,car,crv,248,759,448,745,511,297,0.96054053,20,,2,0.3657094594594595,
61,2,car,crv,251,754,443,743,503,300,0.96310854,20,,2,1.24,
62,2,car,crv,117,1318,387,822,1201,435,0.42310923,20,,2,1.2916666666666667,
63,2,car,crv,248,763,450,742,515,292,0.92204607,20,,2,1.2916666666666667,
64,2,car,crv,119,1311,391,813,1192,422,0.25885653,20,,2,1.25,
65,2,car,crv,246,752,446,739,506,293,0.95473194,20,,2,1.25,
66,2,car,crv,128,1304,388,815,1176,427,0.30647025,20,,2,1.28,
67,2,car,crv,251,758,443,746,507,303,0.93285924,20,,2,1.28,
68,2,car,crv,250,754,447,738,504,291,0.9767751,20,,2,1.24,
69,2,car,crv,109,1318,388,813,1209,425,0.32027155,20,,2,1.28,
70,2,car,crv,245,760,445,741,515,296,0.9680706,20,,2,1.28,
71,2,car,crv,127,1308,391,816,1181,425,0.2964813,20,,2,1.2916666666666667,
72,2,car,crv,250,757,447,742,507,295,0.9490655,20,,2,1.2916666666666667,
73,2,car,crv,125,1314,388,816,1189,428,0.42268884,20,,2,1.28,
74,2,car,crv,248,760,449,737,512,288,0.90941703,20,,2,1.28,
75,2,car,crv,129,1304,390,814,1175,424,0.26254445,20,,2,1.2916666666666667,
76,2,car,crv,252,755,447,740,503,293,0.94612926,20,,2,1.2916666666666667,
77,2,car,crv,114,1320,387,815,1206,428,0.30274954,20,,2,1.24,
78,2,car,crv,248,753,446,740,505,294,0.8954264,20,,2,1.24,
79,2,car,crv,127,1307,391,814,1180,423,0.278648,20,,2,0.35847457627118645,
80,2,car,crv,250,755,447,744,505,297,0.95984495,20,,2,0.35847457627118645,
81,2,car,crv,127,1302,386,816,1175,430,0.37110242,20,,2,1.28,
82,2,car,crv,246,757,444,747,511,303,0.96607155,20,,2,1.28,
83,2,car,crv,119,1307,387,816,1188,429,0.28644451,20,,2,0.3611111111111111,
84,2,car,crv,248,759,443,747,511,304,0.9593547,20,,2,0.3611111111111111,
85,2,car,crv,127,1306,389,820,1179,431,0.37050778,20,,2,1.24,
86,2,car,crv,252,758,449,742,506,293,0.9203835,20,,2,1.24,
87,2,car,crv,126,1306,387,819,1180,432,0.24266188,20,,2,0.36610169491525424,
88,2,car,crv,247,754,449,740,507,291,0.94762105,20,,2,0.36610169491525424,
89,2,car,crv,113,1317,388,815,1204,427,0.36209753,20,,2,1.24,
90,2,car,crv,247,755,446,738,508,292,0.93217456,20,,2,1.24,
91,2,car,crv,116,1312,386,813,1196,427,0.26130736,20,,2,0.35702341137123744,
92,2,car,crv,249,755,445,740,506,295,0.95275867,20,,2,0.35702341137123744,
93,2,car,crv,250,753,445,746,503,301,0.97777426,20,,2,1.24,
94,2,car,crv,117,1316,390,813,1199,423,0.30318785,20,,2,0.35279399499582986,
95,2,car,crv,239,759,447,740,520,293,0.956478,20,,2,0.35279399499582986,
96,2,car,crv,126,1307,387,813,1181,426,0.3400013,20,,2,1.24,
97,2,car,crv,250,757,446,745,507,299,0.93553233,20,,2,1.24,
98,2,car,crv,118,1316,385,817,1198,432,0.46192503,20,,2,1.24,
99,2,car,crv,242,760,449,744,518,295,0.9251644,20,,2,1.24,
100,2,car,crv,125,1310,389,811,1185,422,0.32076746,20,,2,0.3561181434599156,
101,2,car,crv,250,758,446,739,508,293,0.9462212,20,,2,0.3561181434599156,
102,2,car,crv,250,754,444,740,504,296,0.96969557,20,,2,1.24,
103,2,car,crv,113,1313,388,814,1200,426,0.2754978,20,,2,1.24,
104,2,car,crv,244,756,445,743,512,298,0.96916515,20,,2,1.24,
105,2,car,crv,123,1309,388,814,1186,426,0.2760011,20,,2,1.24,
106,2,car,crv,249,758,446,740,509,294,0.950518,20,,2,1.24,
107,2,car,crv,253,754,447,737,501,290,0.94723046,20,,2,1.24,
108,2,car,crv,121,1308,387,817,1187,430,0.21458383,20,,2,0.36225779275484415,
109,2,car,crv,250,754,447,740,504,293,0.9610552,20,,2,0.36225779275484415,
110,2,car,crv,119,1317,388,814,1198,426,0.4732625,20,,2,1.24,
111,2,car,crv,245,758,448,742,513,294,0.94409996,20,,2,1.24,
112,2,car,crv,121,1308,388,815,1187,427,0.21448645,20,,2,0.35973041280539175,
113,2,car,crv,249,753,445,746,504,301,0.9724925,20,,2,0.35973041280539175,
114,2,car,crv,135,1302,387,821,1167,434,0.35179994,20,,2,1.2916666666666667,
115,2,car,crv,250,760,450,741,510,291,0.8736024,20,,2,1.2916666666666667,
116,2,car,crv,117,1313,390,812,1196,422,0.32242462,20,,2,1.2916666666666667,
117,2,car,crv,243,759,447,742,516,295,0.9675998,20,,2,1.2916666666666667,
118,2,car,crv,122,1311,387,814,1189,427,0.36553156,20,,2,1.2916666666666667,
119,2,car,crv,250,757,444,744,507,300,0.9479286,20,,2,1.2916666666666667,
120,2,car,crv,115,1321,388,815,1206,427,0.3674716,20,,2,1.24,
121,2,car,crv,248,756,446,740,508,294,0.92142504,20,,2,1.24,
122,2,car,crv,109,1315,384,827,1206,443,0.2820505,20,,2,1.24,
123,2,car,crv,249,758,449,736,509,287,0.91024953,20,,2,1.24,
124,2,car,crv,122,1310,388,817,1188,429,0.29904467,20,,2,0.3611111111111111,
125,2,car,crv,250,760,448,741,510,293,0.927252,20,,2,0.3611111111111111,
126,2,car,crv,129,1303,389,814,1174,425,0.27334884,20,,2,1.28,
127,2,car,crv,247,760,448,741,513,293,0.9333165,20,,2,1.28,
128,2,car,crv,122,1311,385,813,1189,428,0.35830083,20,,2,1.24,
129,2,car,crv,246,757,442,746,511,304,0.9668414,20,,2,1.24,
130,2,car,crv,122,1312,391,808,1190,417,0.34383425,20,,2,1.28,
131,2,car,crv,248,755,446,741,507,295,0.90284395,20,,2,1.28,
132,2,car,crv,129,1303,386,819,1174,433,0.2341652,20,,2,0.368824531516184,
133,2,car,crv,252,756,447,744,504,297,0.9354642,20,,2,0.368824531516184,
134,2,car,crv,253,756,446,744,503,298,0.97629297,20,,2,1.24,
135,2,car,crv,128,1307,388,817,1179,429,0.32914877,20,,2,1.2916666666666667,
136,2,car,crv,247,762,447,741,515,294,0.9441378,20,,2,1.2916666666666667,
137,2,car,crv,117,1313,388,818,1196,430,0.27251616,20,,2,0.3595317725752508,
138,2,car,crv,247,762,449,740,515,291,0.96550846,20,,2,0.3595317725752508,
139,2,car,crv,124,1305,387,820,1181,433,0.27402008,20,,2,0.36663844199830653,
140,2,car,crv,252,750,447,746,498,299,0.9501165,20,,2,0.36663844199830653,
141,2,car,crv,111,1317,390,812,1206,422,0.27479288,20,,2,0.34991708126036486,
142,2,car,crv,251,753,447,740,502,293,0.9438285,20,,2,0.34991708126036486,
143,2,car,crv,126,1309,390,814,1183,424,0.30222148,20,,2,1.2916666666666667,
144,2,car,crv,249,757,448,740,508,292,0.91383094,20,,2,1.2916666666666667,
145,2,car,crv,111,1317,390,811,1206,421,0.2941505,20,,2,0.3490878938640133,
146,2,car,crv,247,756,446,741,509,295,0.96245986,20,,2,0.3490878938640133,
147,2,car,crv,134,1300,387,818,1166,431,0.35928637,20,,2,1.28,
148,2,car,crv,251,757,447,743,506,296,0.9412378,20,,2,1.28,
149,2,car,crv,126,1312,388,815,1186,427,0.3965622,20,,2,1.24,
150,2,car,crv,252,758,446,743,506,297,0.9420341,20,,2,1.24,
151,2,car,crv,121,1316,389,809,1195,420,0.4096516,20,,2,1.24,
152,2,car,crv,244,761,447,742,517,295,0.9289579,20,,2,1.24,
153,2,car,crv,125,1312,392,805,1187,413,0.30284005,20,,2,1.24,
154,2,car,crv,245,760,447,739,515,292,0.9596912,20,,2,1.24,
155,2,car,crv,131,1307,388,812,1176,424,0.43397242,20,,2,1.2916666666666667,
156,2,car,crv,247,764,447,744,517,297,0.9014591,20,,2,1.2916666666666667,
157,2,car,crv,123,1315,388,811,1192,423,0.4968379,20,,2,1.24,
158,2,car,crv,246,758,446,743,512,297,0.87933147,20,,2,1.24,
159,2,car,crv,118,1312,389,813,1194,424,0.25691053,20,,2,0.35510887772194305,
160,2,car,crv,249,756,447,742,507,295,0.96910256,20,,2,0.35510887772194305,
161,2,car,crv,118,1319,389,813,1201,424,0.4023961,20,,2,1.28,
162,2,car,crv,243,757,448,743,514,295,0.94143236,20,,2,1.28,
163,2,car,crv,119,1322,385,815,1203,430,0.42900166,20,,2,1.24,
164,2,car,crv,246,762,447,741,516,294,0.790523,20,,2,1.24,
165,2,car,crv,119,1319,386,815,1200,429,0.44753623,20,,2,1.28,
166,2,car,crv,248,759,450,741,511,291,0.8263495,20,,2,1.28,
167,2,car,crv,114,1318,387,813,1204,426,0.43434885,20,,2,1.2916666666666667,
168,2,car,crv,246,759,446,744,513,298,0.9186257,20,,2,1.2916666666666667,
169,2,car,crv,119,1325,389,808,1206,419,0.46840343,20,,2,1.24,
170,2,car,crv,244,759,447,741,515,294,0.83414143,20,,2,1.24,
171,2,car,crv,116,1322,388,811,1206,423,0.44209528,20,,2,1.28,
172,2,car,crv,241,764,450,741,523,291,0.8834957,20,,2,1.28,
173,2,car,crv,334,710,446,701,376,255,0.92716336,3,0,2,0.6781914893617021,
174,2,car,crv,336,711,446,700,375,254,0.9036748,3,0,2,0.6773333333333333,
175,2,car,crv,335,709,444,701,374,257,0.9452533,3,0,2,0.6871657754010695,
0,2,car,crv,120,1318,392,810,1198,418,0.37392586,20,,2,1.2916666666666667,
1,2,car,crv,248,758,450,739,510,289,0.9237008,20,,2,1.2916666666666667,
2,2,car,crv,110,1316,390,815,1206,425,0.20233919,20,,2,0.3524046434494196,
3,2,car,crv,250,753,447,736,503,289,0.9751715,20,,2,0.3524046434494196,
4,2,car,crv,129,1310,386,816,1181,430,0.3428058,20,,2,1.2916666666666667,
5,2,car,crv,247,760,447,740,513,293,0.8918332,20,,2,1.2916666666666667,
6,2,car,crv,122,1317,391,811,1195,420,0.44330603,20,,2,1.24,
7,2,car,crv,243,763,449,737,520,288,0.921945,20,,2,1.24,
8,2,car,crv,120,1307,387,819,1187,432,0.29826218,20,,2,0.36394271272114576,
9,2,car,crv,251,756,446,743,505,297,0.96940076,20,,2,0.36394271272114576,
10,2,car,crv,129,1303,385,817,1174,432,0.33652014,20,,2,1.25,
11,2,car,crv,247,762,444,744,515,300,0.95280766,20,,2,1.25,
12,2,car,crv,121,1309,390,816,1188,426,0.26945764,20,,2,0.35858585858585856,
13,2,car,crv,250,755,447,742,505,295,0.97232443,20,,2,0.35858585858585856,
14,2,car,crv,118,1317,389,817,1199,428,0.40577245,20,,2,1.2916666666666667,
15,2,car,crv,250,758,446,743,508,297,0.94312155,20,,2,1.2916666666666667,
16,2,car,crv,121,1303,387,817,1182,430,0.23037793,20,,2,0.3637901861252115,
17,2,car,crv,250,752,444,747,502,303,0.973318,20,,2,0.3637901861252115,
18,2,car,crv,129,1309,395,806,1180,411,0.31128713,20,,2,0.3483050847457627,
19,2,car,crv,248,761,449,740,513,291,0.95252526,20,,2,0.3483050847457627,
20,2,car,crv,121,1303,389,815,1182,426,0.23151965,20,,2,0.3604060913705584,
21,2,car,crv,245,754,445,744,509,299,0.9742757,20,,2,0.3604060913705584,
22,2,car,crv,124,1302,388,819,1178,431,0.20558608,20,,2,0.36587436332767403,
23,2,car,crv,252,759,447,740,507,293,0.971343,20,,2,0.36587436332767403,
24,2,car,crv,120,1318,389,815,1198,426,0.37832162,20,,2,1.24,
25,2,car,crv,248,758,449,738,510,289,0.9015974,20,,2,1.24,
26,2,car,crv,123,1313,389,813,1190,424,0.38111085,20,,2,1.24,
27,2,car,crv,247,755,446,744,508,298,0.8986612,20,,2,1.24,
28,2,car,crv,117,1315,387,816,1198,429,0.4219676,20,,2,1.2307692307692308,
29,2,car,crv,251,757,449,740,506,291,0.9306962,20,,2,1.2307692307692308,
30,2,car,crv,119,1318,391,816,1199,425,0.41724253,20,,2,1.3333333333333333,
31,2,car,crv,247,759,447,741,512,294,0.9398525,20,,2,1.3333333333333333,
32,2,car,crv,128,1307,392,813,1179,421,0.25620303,20,,2,0.3570822731128075,
33,2,car,crv,251,756,447,741,505,294,0.9512551,20,,2,0.3570822731128075,
34,2,car,crv,119,1314,386,816,1195,430,0.45291424,20,,2,1.2916666666666667,
35,2,car,crv,250,759,449,744,509,295,0.90196574,20,,2,1.2916666666666667,
36,2,car,crv,126,1304,388,820,1178,432,0.2519957,20,,2,0.366723259762309,
37,2,car,crv,253,757,448,737,504,289,0.9349736,20,,2,0.366723259762309,
38,2,car,crv,122,1317,387,818,1195,431,0.38155946,20,,2,1.24,
39,2,car,crv,248,756,447,743,508,296,0.9098617,20,,2,1.24,
40,2,car,crv,120,1319,389,808,1199,419,0.49123806,20,,2,1.24,
41,2,car,crv,241,764,446,743,523,297,0.8688812,20,,2,1.24,
42,2,car,crv,251,754,448,736,503,288,0.9627608,20,,2,1.28,
43,2,car,crv,114,1312,387,822,1198,435,0.2406673,20,,2,0.3631051752921536,
44,2,car,crv,253,758,447,739,505,292,0.9361756,20,,2,0.3631051752921536,
45,2,car,crv,121,1313,387,820,1192,433,0.26400292,20,,2,1.24,
46,2,car,crv,246,754,446,742,508,296,0.95298326,20,,2,1.24,
47,2,car,crv,131,1305,389,817,1174,428,0.29075116,20,,2,0.3645655877342419,
48,2,car,crv,252,754,448,743,502,295,0.94248277,20,,2,0.3645655877342419,
49,2,car,crv,130,1307,389,819,1177,430,0.2569041,20,,2,1.24,
50,2,car,crv,256,753,448,740,497,292,0.955823,20,,2,1.24,
51,2,car,crv,127,1305,390,811,1178,421,0.25976446,20,,2,0.35738539898132426,
52,2,car,crv,250,757,443,743,507,300,0.9547171,20,,2,0.35738539898132426,
53,2,car,crv,123,1309,392,810,1186,418,0.28978387,20,,2,1.24,
54,2,car,crv,248,758,446,738,510,292,0.96847486,20,,2,1.24,
55,2,car,crv,123,1304,388,814,1181,426,0.2588897,20,,2,0.3607112616426757,
56,2,car,crv,250,759,447,742,509,295,0.9416412,20,,2,0.3607112616426757,
57,2,car,crv,130,1306,391,810,1176,419,0.26097575,20,,2,0.3562925170068027,
58,2,car,crv,250,756,447,739,506,292,0.95065075,20,,2,0.3562925170068027,
59,2,car,crv,123,1309,389,813,1186,424,0.31858423,20,,2,1.24,
60,2,car,crv,248,758,447,745,510,298,0.9534346,20,,2,1.24,
61,2,car,crv,121,1305,386,819,1184,433,0.24762785,20,,2,0.3657094594594595,
62,2,car,crv,248,759,448,745,511,297,0.96054053,20,,2,0.3657094594594595,
63,2,car,crv,251,754,443,743,503,300,0.96310854,20,,2,1.24,
64,2,car,crv,117,1318,387,822,1201,435,0.42310923,20,,2,1.2916666666666667,
65,2,car,crv,248,763,450,742,515,292,0.92204607,20,,2,1.2916666666666667,
66,2,car,crv,119,1311,391,813,1192,422,0.25885653,20,,2,1.25,
67,2,car,crv,246,752,446,739,506,293,0.95473194,20,,2,1.25,
68,2,car,crv,128,1304,388,815,1176,427,0.30647025,20,,2,1.28,
69,2,car,crv,251,758,443,746,507,303,0.93285924,20,,2,1.28,
70,2,car,crv,250,754,447,738,504,291,0.9767751,20,,2,1.24,
71,2,car,crv,109,1318,388,813,1209,425,0.32027155,20,,2,1.28,
72,2,car,crv,245,760,445,741,515,296,0.9680706,20,,2,1.28,
73,2,car,crv,127,1308,391,816,1181,425,0.2964813,20,,2,1.2916666666666667,
74,2,car,crv,250,757,447,742,507,295,0.9490655,20,,2,1.2916666666666667,
75,2,car,crv,125,1314,388,816,1189,428,0.42268884,20,,2,1.28,
76,2,car,crv,248,760,449,737,512,288,0.90941703,20,,2,1.28,
77,2,car,crv,129,1304,390,814,1175,424,0.26254445,20,,2,1.2916666666666667,
78,2,car,crv,252,755,447,740,503,293,0.94612926,20,,2,1.2916666666666667,
79,2,car,crv,114,1320,387,815,1206,428,0.30274954,20,,2,1.24,
80,2,car,crv,248,753,446,740,505,294,0.8954264,20,,2,1.24,
81,2,car,crv,127,1307,391,814,1180,423,0.278648,20,,2,0.35847457627118645,
82,2,car,crv,250,755,447,744,505,297,0.95984495,20,,2,0.35847457627118645,
83,2,car,crv,127,1302,386,816,1175,430,0.37110242,20,,2,1.28,
84,2,car,crv,246,757,444,747,511,303,0.96607155,20,,2,1.28,
85,2,car,crv,119,1307,387,816,1188,429,0.28644451,20,,2,0.3611111111111111,
86,2,car,crv,248,759,443,747,511,304,0.9593547,20,,2,0.3611111111111111,
87,2,car,crv,127,1306,389,820,1179,431,0.37050778,20,,2,1.24,
88,2,car,crv,252,758,449,742,506,293,0.9203835,20,,2,1.24,
89,2,car,crv,126,1306,387,819,1180,432,0.24266188,20,,2,0.36610169491525424,
90,2,car,crv,247,754,449,740,507,291,0.94762105,20,,2,0.36610169491525424,
91,2,car,crv,113,1317,388,815,1204,427,0.36209753,20,,2,1.24,
92,2,car,crv,247,755,446,738,508,292,0.93217456,20,,2,1.24,
93,2,car,crv,116,1312,386,813,1196,427,0.26130736,20,,2,0.35702341137123744,
94,2,car,crv,249,755,445,740,506,295,0.95275867,20,,2,0.35702341137123744,
95,2,car,crv,250,753,445,746,503,301,0.97777426,20,,2,1.24,
96,2,car,crv,117,1316,390,813,1199,423,0.30318785,20,,2,0.35279399499582986,
97,2,car,crv,239,759,447,740,520,293,0.956478,20,,2,0.35279399499582986,
98,2,car,crv,126,1307,387,813,1181,426,0.3400013,20,,2,1.24,
99,2,car,crv,250,757,446,745,507,299,0.93553233,20,,2,1.24,
100,2,car,crv,118,1316,385,817,1198,432,0.46192503,20,,2,1.24,
101,2,car,crv,242,760,449,744,518,295,0.9251644,20,,2,1.24,
102,2,car,crv,125,1310,389,811,1185,422,0.32076746,20,,2,0.3561181434599156,
103,2,car,crv,250,758,446,739,508,293,0.9462212,20,,2,0.3561181434599156,
104,2,car,crv,250,754,444,740,504,296,0.96969557,20,,2,1.24,
105,2,car,crv,113,1313,388,814,1200,426,0.2754978,20,,2,1.24,
106,2,car,crv,244,756,445,743,512,298,0.96916515,20,,2,1.24,
107,2,car,crv,123,1309,388,814,1186,426,0.2760011,20,,2,1.24,
108,2,car,crv,249,758,446,740,509,294,0.950518,20,,2,1.24,
109,2,car,crv,253,754,447,737,501,290,0.94723046,20,,2,1.24,
110,2,car,crv,121,1308,387,817,1187,430,0.21458383,20,,2,0.36225779275484415,
111,2,car,crv,250,754,447,740,504,293,0.9610552,20,,2,0.36225779275484415,
112,2,car,crv,119,1317,388,814,1198,426,0.4732625,20,,2,1.24,
113,2,car,crv,245,758,448,742,513,294,0.94409996,20,,2,1.24,
114,2,car,crv,121,1308,388,815,1187,427,0.21448645,20,,2,0.35973041280539175,
115,2,car,crv,249,753,445,746,504,301,0.9724925,20,,2,0.35973041280539175,
116,2,car,crv,135,1302,387,821,1167,434,0.35179994,20,,2,1.2916666666666667,
117,2,car,crv,250,760,450,741,510,291,0.8736024,20,,2,1.2916666666666667,
118,2,car,crv,117,1313,390,812,1196,422,0.32242462,20,,2,1.2916666666666667,
119,2,car,crv,243,759,447,742,516,295,0.9675998,20,,2,1.2916666666666667,
120,2,car,crv,122,1311,387,814,1189,427,0.36553156,20,,2,1.2916666666666667,
121,2,car,crv,250,757,444,744,507,300,0.9479286,20,,2,1.2916666666666667,
122,2,car,crv,115,1321,388,815,1206,427,0.3674716,20,,2,1.24,
123,2,car,crv,248,756,446,740,508,294,0.92142504,20,,2,1.24,
124,2,car,crv,109,1315,384,827,1206,443,0.2820505,20,,2,1.24,
125,2,car,crv,249,758,449,736,509,287,0.91024953,20,,2,1.24,
126,2,car,crv,122,1310,388,817,1188,429,0.29904467,20,,2,0.3611111111111111,
127,2,car,crv,250,760,448,741,510,293,0.927252,20,,2,0.3611111111111111,
128,2,car,crv,129,1303,389,814,1174,425,0.27334884,20,,2,1.28,
129,2,car,crv,247,760,448,741,513,293,0.9333165,20,,2,1.28,
130,2,car,crv,122,1311,385,813,1189,428,0.35830083,20,,2,1.24,
131,2,car,crv,246,757,442,746,511,304,0.9668414,20,,2,1.24,
132,2,car,crv,122,1312,391,808,1190,417,0.34383425,20,,2,1.28,
133,2,car,crv,248,755,446,741,507,295,0.90284395,20,,2,1.28,
134,2,car,crv,129,1303,386,819,1174,433,0.2341652,20,,2,0.368824531516184,
135,2,car,crv,252,756,447,744,504,297,0.9354642,20,,2,0.368824531516184,
136,2,car,crv,253,756,446,744,503,298,0.97629297,20,,2,1.24,
137,2,car,crv,128,1307,388,817,1179,429,0.32914877,20,,2,1.2916666666666667,
138,2,car,crv,247,762,447,741,515,294,0.9441378,20,,2,1.2916666666666667,
139,2,car,crv,117,1313,388,818,1196,430,0.27251616,20,,2,0.3595317725752508,
140,2,car,crv,247,762,449,740,515,291,0.96550846,20,,2,0.3595317725752508,
141,2,car,crv,124,1305,387,820,1181,433,0.27402008,20,,2,0.36663844199830653,
142,2,car,crv,252,750,447,746,498,299,0.9501165,20,,2,0.36663844199830653,
143,2,car,crv,111,1317,390,812,1206,422,0.27479288,20,,2,0.34991708126036486,
144,2,car,crv,251,753,447,740,502,293,0.9438285,20,,2,0.34991708126036486,
145,2,car,crv,126,1309,390,814,1183,424,0.30222148,20,,2,1.2916666666666667,
146,2,car,crv,249,757,448,740,508,292,0.91383094,20,,2,1.2916666666666667,
147,2,car,crv,111,1317,390,811,1206,421,0.2941505,20,,2,0.3490878938640133,
148,2,car,crv,247,756,446,741,509,295,0.96245986,20,,2,0.3490878938640133,
149,2,car,crv,134,1300,387,818,1166,431,0.35928637,20,,2,1.28,
150,2,car,crv,251,757,447,743,506,296,0.9412378,20,,2,1.28,
151,2,car,crv,126,1312,388,815,1186,427,0.3965622,20,,2,1.24,
152,2,car,crv,252,758,446,743,506,297,0.9420341,20,,2,1.24,
153,2,car,crv,121,1316,389,809,1195,420,0.4096516,20,,2,1.24,
154,2,car,crv,244,761,447,742,517,295,0.9289579,20,,2,1.24,
155,2,car,crv,125,1312,392,805,1187,413,0.30284005,20,,2,1.24,
156,2,car,crv,245,760,447,739,515,292,0.9596912,20,,2,1.24,
157,2,car,crv,131,1307,388,812,1176,424,0.43397242,20,,2,1.2916666666666667,
158,2,car,crv,247,764,447,744,517,297,0.9014591,20,,2,1.2916666666666667,
159,2,car,crv,123,1315,388,811,1192,423,0.4968379,20,,2,1.24,
160,2,car,crv,246,758,446,743,512,297,0.87933147,20,,2,1.24,
161,2,car,crv,118,1312,389,813,1194,424,0.25691053,20,,2,0.35510887772194305,
162,2,car,crv,249,756,447,742,507,295,0.96910256,20,,2,0.35510887772194305,
163,2,car,crv,118,1319,389,813,1201,424,0.4023961,20,,2,1.28,
164,2,car,crv,243,757,448,743,514,295,0.94143236,20,,2,1.28,
165,2,car,crv,119,1322,385,815,1203,430,0.42900166,20,,2,1.24,
166,2,car,crv,246,762,447,741,516,294,0.790523,20,,2,1.24,
167,2,car,crv,119,1319,386,815,1200,429,0.44753623,20,,2,1.28,
168,2,car,crv,248,759,450,741,511,291,0.8263495,20,,2,1.28,
169,2,car,crv,114,1318,387,813,1204,426,0.43434885,20,,2,1.2916666666666667,
170,2,car,crv,246,759,446,744,513,298,0.9186257,20,,2,1.2916666666666667,
171,2,car,crv,119,1325,389,808,1206,419,0.46840343,20,,2,1.24,
172,2,car,crv,244,759,447,741,515,294,0.83414143,20,,2,1.24,
173,2,car,crv,116,1322,388,811,1206,423,0.44209528,20,,2,1.28,
174,2,car,crv,241,764,450,741,523,291,0.8834957,20,,2,1.28,
175,2,car,crv,334,710,446,701,376,255,0.92716336,3,0,2,0.6781914893617021,
176,2,car,crv,336,711,446,700,375,254,0.9036748,3,0,2,0.6773333333333333,
177,2,car,crv,335,709,444,701,374,257,0.9452533,3,0,2,0.6871657754010695,
0,2,car,crv,123,1308,390,814,1185,424,0.3166677,20,,2,1.24,
1,2,car,crv,247,758,447,742,511,295,0.9435399,20,,2,1.24,
2,2,car,crv,120,1318,392,810,1198,418,0.37392586,20,,2,1.2916666666666667,
3,2,car,crv,248,758,450,739,510,289,0.9237008,20,,2,1.2916666666666667,
4,2,car,crv,110,1316,390,815,1206,425,0.20233919,20,,2,0.3524046434494196,
5,2,car,crv,250,753,447,736,503,289,0.9751715,20,,2,0.3524046434494196,
6,2,car,crv,129,1310,386,816,1181,430,0.3428058,20,,2,1.2916666666666667,
7,2,car,crv,247,760,447,740,513,293,0.8918332,20,,2,1.2916666666666667,
8,2,car,crv,122,1317,391,811,1195,420,0.44330603,20,,2,1.24,
9,2,car,crv,243,763,449,737,520,288,0.921945,20,,2,1.24,
10,2,car,crv,120,1307,387,819,1187,432,0.29826218,20,,2,0.36394271272114576,
11,2,car,crv,251,756,446,743,505,297,0.96940076,20,,2,0.36394271272114576,
12,2,car,crv,129,1303,385,817,1174,432,0.33652014,20,,2,1.25,
13,2,car,crv,247,762,444,744,515,300,0.95280766,20,,2,1.25,
14,2,car,crv,121,1309,390,816,1188,426,0.26945764,20,,2,0.35858585858585856,
15,2,car,crv,250,755,447,742,505,295,0.97232443,20,,2,0.35858585858585856,
16,2,car,crv,118,1317,389,817,1199,428,0.40577245,20,,2,1.2916666666666667,
17,2,car,crv,250,758,446,743,508,297,0.94312155,20,,2,1.2916666666666667,
18,2,car,crv,121,1303,387,817,1182,430,0.23037793,20,,2,0.3637901861252115,
19,2,car,crv,250,752,444,747,502,303,0.973318,20,,2,0.3637901861252115,
20,2,car,crv,129,1309,395,806,1180,411,0.31128713,20,,2,0.3483050847457627,
21,2,car,crv,248,761,449,740,513,291,0.95252526,20,,2,0.3483050847457627,
22,2,car,crv,121,1303,389,815,1182,426,0.23151965,20,,2,0.3604060913705584,
23,2,car,crv,245,754,445,744,509,299,0.9742757,20,,2,0.3604060913705584,
24,2,car,crv,124,1302,388,819,1178,431,0.20558608,20,,2,0.36587436332767403,
25,2,car,crv,252,759,447,740,507,293,0.971343,20,,2,0.36587436332767403,
26,2,car,crv,120,1318,389,815,1198,426,0.37832162,20,,2,1.24,
27,2,car,crv,248,758,449,738,510,289,0.9015974,20,,2,1.24,
28,2,car,crv,123,1313,389,813,1190,424,0.38111085,20,,2,1.24,
29,2,car,crv,247,755,446,744,508,298,0.8986612,20,,2,1.24,
30,2,car,crv,117,1315,387,816,1198,429,0.4219676,20,,2,1.2307692307692308,
31,2,car,crv,251,757,449,740,506,291,0.9306962,20,,2,1.2307692307692308,
32,2,car,crv,119,1318,391,816,1199,425,0.41724253,20,,2,1.3333333333333333,
33,2,car,crv,247,759,447,741,512,294,0.9398525,20,,2,1.3333333333333333,
34,2,car,crv,128,1307,392,813,1179,421,0.25620303,20,,2,0.3570822731128075,
35,2,car,crv,251,756,447,741,505,294,0.9512551,20,,2,0.3570822731128075,
36,2,car,crv,119,1314,386,816,1195,430,0.45291424,20,,2,1.2916666666666667,
37,2,car,crv,250,759,449,744,509,295,0.90196574,20,,2,1.2916666666666667,
38,2,car,crv,126,1304,388,820,1178,432,0.2519957,20,,2,0.366723259762309,
39,2,car,crv,253,757,448,737,504,289,0.9349736,20,,2,0.366723259762309,
40,2,car,crv,122,1317,387,818,1195,431,0.38155946,20,,2,1.24,
41,2,car,crv,248,756,447,743,508,296,0.9098617,20,,2,1.24,
42,2,car,crv,120,1319,389,808,1199,419,0.49123806,20,,2,1.24,
43,2,car,crv,241,764,446,743,523,297,0.8688812,20,,2,1.24,
44,2,car,crv,251,754,448,736,503,288,0.9627608,20,,2,1.28,
45,2,car,crv,114,1312,387,822,1198,435,0.2406673,20,,2,0.3631051752921536,
46,2,car,crv,253,758,447,739,505,292,0.9361756,20,,2,0.3631051752921536,
47,2,car,crv,121,1313,387,820,1192,433,0.26400292,20,,2,1.24,
48,2,car,crv,246,754,446,742,508,296,0.95298326,20,,2,1.24,
49,2,car,crv,131,1305,389,817,1174,428,0.29075116,20,,2,0.3645655877342419,
50,2,car,crv,252,754,448,743,502,295,0.94248277,20,,2,0.3645655877342419,
51,2,car,crv,130,1307,389,819,1177,430,0.2569041,20,,2,1.24,
52,2,car,crv,256,753,448,740,497,292,0.955823,20,,2,1.24,
53,2,car,crv,127,1305,390,811,1178,421,0.25976446,20,,2,0.35738539898132426,
54,2,car,crv,250,757,443,743,507,300,0.9547171,20,,2,0.35738539898132426,
55,2,car,crv,123,1309,392,810,1186,418,0.28978387,20,,2,1.24,
56,2,car,crv,248,758,446,738,510,292,0.96847486,20,,2,1.24,
57,2,car,crv,123,1304,388,814,1181,426,0.2588897,20,,2,0.3607112616426757,
58,2,car,crv,250,759,447,742,509,295,0.9416412,20,,2,0.3607112616426757,
59,2,car,crv,130,1306,391,810,1176,419,0.26097575,20,,2,0.3562925170068027,
60,2,car,crv,250,756,447,739,506,292,0.95065075,20,,2,0.3562925170068027,
61,2,car,crv,123,1309,389,813,1186,424,0.31858423,20,,2,1.24,
62,2,car,crv,248,758,447,745,510,298,0.9534346,20,,2,1.24,
63,2,car,crv,121,1305,386,819,1184,433,0.24762785,20,,2,0.3657094594594595,
64,2,car,crv,248,759,448,745,511,297,0.96054053,20,,2,0.3657094594594595,
65,2,car,crv,251,754,443,743,503,300,0.96310854,20,,2,1.24,
66,2,car,crv,117,1318,387,822,1201,435,0.42310923,20,,2,1.2916666666666667,
67,2,car,crv,248,763,450,742,515,292,0.92204607,20,,2,1.2916666666666667,
68,2,car,crv,119,1311,391,813,1192,422,0.25885653,20,,2,1.25,
69,2,car,crv,246,752,446,739,506,293,0.95473194,20,,2,1.25,
70,2,car,crv,128,1304,388,815,1176,427,0.30647025,20,,2,1.28,
71,2,car,crv,251,758,443,746,507,303,0.93285924,20,,2,1.28,
72,2,car,crv,250,754,447,738,504,291,0.9767751,20,,2,1.24,
73,2,car,crv,109,1318,388,813,1209,425,0.32027155,20,,2,1.28,
74,2,car,crv,245,760,445,741,515,296,0.9680706,20,,2,1.28,
75,2,car,crv,127,1308,391,816,1181,425,0.2964813,20,,2,1.2916666666666667,
76,2,car,crv,250,757,447,742,507,295,0.9490655,20,,2,1.2916666666666667,
77,2,car,crv,125,1314,388,816,1189,428,0.42268884,20,,2,1.28,
78,2,car,crv,248,760,449,737,512,288,0.90941703,20,,2,1.28,
79,2,car,crv,129,1304,390,814,1175,424,0.26254445,20,,2,1.2916666666666667,
80,2,car,crv,252,755,447,740,503,293,0.94612926,20,,2,1.2916666666666667,
81,2,car,crv,114,1320,387,815,1206,428,0.30274954,20,,2,1.24,
82,2,car,crv,248,753,446,740,505,294,0.8954264,20,,2,1.24,
83,2,car,crv,127,1307,391,814,1180,423,0.278648,20,,2,0.35847457627118645,
84,2,car,crv,250,755,447,744,505,297,0.95984495,20,,2,0.35847457627118645,
85,2,car,crv,127,1302,386,816,1175,430,0.37110242,20,,2,1.28,
86,2,car,crv,246,757,444,747,511,303,0.96607155,20,,2,1.28,
87,2,car,crv,119,1307,387,816,1188,429,0.28644451,20,,2,0.3611111111111111,
88,2,car,crv,248,759,443,747,511,304,0.9593547,20,,2,0.3611111111111111,
89,2,car,crv,127,1306,389,820,1179,431,0.37050778,20,,2,1.24,
90,2,car,crv,252,758,449,742,506,293,0.9203835,20,,2,1.24,
91,2,car,crv,126,1306,387,819,1180,432,0.24266188,20,,2,0.36610169491525424,
92,2,car,crv,247,754,449,740,507,291,0.94762105,20,,2,0.36610169491525424,
93,2,car,crv,113,1317,388,815,1204,427,0.36209753,20,,2,1.24,
94,2,car,crv,247,755,446,738,508,292,0.93217456,20,,2,1.24,
95,2,car,crv,116,1312,386,813,1196,427,0.26130736,20,,2,0.35702341137123744,
96,2,car,crv,249,755,445,740,506,295,0.95275867,20,,2,0.35702341137123744,
97,2,car,crv,250,753,445,746,503,301,0.97777426,20,,2,1.24,
98,2,car,crv,117,1316,390,813,1199,423,0.30318785,20,,2,0.35279399499582986,
99,2,car,crv,239,759,447,740,520,293,0.956478,20,,2,0.35279399499582986,
100,2,car,crv,126,1307,387,813,1181,426,0.3400013,20,,2,1.24,
101,2,car,crv,250,757,446,745,507,299,0.93553233,20,,2,1.24,
102,2,car,crv,118,1316,385,817,1198,432,0.46192503,20,,2,1.24,
103,2,car,crv,242,760,449,744,518,295,0.9251644,20,,2,1.24,
104,2,car,crv,125,1310,389,811,1185,422,0.32076746,20,,2,0.3561181434599156,
105,2,car,crv,250,758,446,739,508,293,0.9462212,20,,2,0.3561181434599156,
106,2,car,crv,250,754,444,740,504,296,0.96969557,20,,2,1.24,
107,2,car,crv,113,1313,388,814,1200,426,0.2754978,20,,2,1.24,
108,2,car,crv,244,756,445,743,512,298,0.96916515,20,,2,1.24,
109,2,car,crv,123,1309,388,814,1186,426,0.2760011,20,,2,1.24,
110,2,car,crv,249,758,446,740,509,294,0.950518,20,,2,1.24,
111,2,car,crv,253,754,447,737,501,290,0.94723046,20,,2,1.24,
112,2,car,crv,121,1308,387,817,1187,430,0.21458383,20,,2,0.36225779275484415,
113,2,car,crv,250,754,447,740,504,293,0.9610552,20,,2,0.36225779275484415,
114,2,car,crv,119,1317,388,814,1198,426,0.4732625,20,,2,1.24,
115,2,car,crv,245,758,448,742,513,294,0.94409996,20,,2,1.24,
116,2,car,crv,121,1308,388,815,1187,427,0.21448645,20,,2,0.35973041280539175,
117,2,car,crv,249,753,445,746,504,301,0.9724925,20,,2,0.35973041280539175,
118,2,car,crv,135,1302,387,821,1167,434,0.35179994,20,,2,1.2916666666666667,
119,2,car,crv,250,760,450,741,510,291,0.8736024,20,,2,1.2916666666666667,
120,2,car,crv,117,1313,390,812,1196,422,0.32242462,20,,2,1.2916666666666667,
121,2,car,crv,243,759,447,742,516,295,0.9675998,20,,2,1.2916666666666667,
122,2,car,crv,122,1311,387,814,1189,427,0.36553156,20,,2,1.2916666666666667,
123,2,car,crv,250,757,444,744,507,300,0.9479286,20,,2,1.2916666666666667,
124,2,car,crv,115,1321,388,815,1206,427,0.3674716,20,,2,1.24,
125,2,car,crv,248,756,446,740,508,294,0.92142504,20,,2,1.24,
126,2,car,crv,109,1315,384,827,1206,443,0.2820505,20,,2,1.24,
127,2,car,crv,249,758,449,736,509,287,0.91024953,20,,2,1.24,
128,2,car,crv,122,1310,388,817,1188,429,0.29904467,20,,2,0.3611111111111111,
129,2,car,crv,250,760,448,741,510,293,0.927252,20,,2,0.3611111111111111,
130,2,car,crv,129,1303,389,814,1174,425,0.27334884,20,,2,1.28,
131,2,car,crv,247,760,448,741,513,293,0.9333165,20,,2,1.28,
132,2,car,crv,122,1311,385,813,1189,428,0.35830083,20,,2,1.24,
133,2,car,crv,246,757,442,746,511,304,0.9668414,20,,2,1.24,
134,2,car,crv,122,1312,391,808,1190,417,0.34383425,20,,2,1.28,
135,2,car,crv,248,755,446,741,507,295,0.90284395,20,,2,1.28,
136,2,car,crv,129,1303,386,819,1174,433,0.2341652,20,,2,0.368824531516184,
137,2,car,crv,252,756,447,744,504,297,0.9354642,20,,2,0.368824531516184,
138,2,car,crv,253,756,446,744,503,298,0.97629297,20,,2,1.24,
139,2,car,crv,128,1307,388,817,1179,429,0.32914877,20,,2,1.2916666666666667,
140,2,car,crv,247,762,447,741,515,294,0.9441378,20,,2,1.2916666666666667,
141,2,car,crv,117,1313,388,818,1196,430,0.27251616,20,,2,0.3595317725752508,
142,2,car,crv,247,762,449,740,515,291,0.96550846,20,,2,0.3595317725752508,
143,2,car,crv,124,1305,387,820,1181,433,0.27402008,20,,2,0.36663844199830653,
144,2,car,crv,252,750,447,746,498,299,0.9501165,20,,2,0.36663844199830653,
145,2,car,crv,111,1317,390,812,1206,422,0.27479288,20,,2,0.34991708126036486,
146,2,car,crv,251,753,447,740,502,293,0.9438285,20,,2,0.34991708126036486,
147,2,car,crv,126,1309,390,814,1183,424,0.30222148,20,,2,1.2916666666666667,
148,2,car,crv,249,757,448,740,508,292,0.91383094,20,,2,1.2916666666666667,
149,2,car,crv,111,1317,390,811,1206,421,0.2941505,20,,2,0.3490878938640133,
150,2,car,crv,247,756,446,741,509,295,0.96245986,20,,2,0.3490878938640133,
151,2,car,crv,134,1300,387,818,1166,431,0.35928637,20,,2,1.28,
152,2,car,crv,251,757,447,743,506,296,0.9412378,20,,2,1.28,
153,2,car,crv,126,1312,388,815,1186,427,0.3965622,20,,2,1.24,
154,2,car,crv,252,758,446,743,506,297,0.9420341,20,,2,1.24,
155,2,car,crv,121,1316,389,809,1195,420,0.4096516,20,,2,1.24,
156,2,car,crv,244,761,447,742,517,295,0.9289579,20,,2,1.24,
157,2,car,crv,125,1312,392,805,1187,413,0.30284005,20,,2,1.24,
158,2,car,crv,245,760,447,739,515,292,0.9596912,20,,2,1.24,
159,2,car,crv,131,1307,388,812,1176,424,0.43397242,20,,2,1.2916666666666667,
160,2,car,crv,247,764,447,744,517,297,0.9014591,20,,2,1.2916666666666667,
161,2,car,crv,123,1315,388,811,1192,423,0.4968379,20,,2,1.24,
162,2,car,crv,246,758,446,743,512,297,0.87933147,20,,2,1.24,
163,2,car,crv,118,1312,389,813,1194,424,0.25691053,20,,2,0.35510887772194305,
164,2,car,crv,249,756,447,742,507,295,0.96910256,20,,2,0.35510887772194305,
165,2,car,crv,118,1319,389,813,1201,424,0.4023961,20,,2,1.28,
166,2,car,crv,243,757,448,743,514,295,0.94143236,20,,2,1.28,
167,2,car,crv,119,1322,385,815,1203,430,0.42900166,20,,2,1.24,
168,2,car,crv,246,762,447,741,516,294,0.790523,20,,2,1.24,
169,2,car,crv,119,1319,386,815,1200,429,0.44753623,20,,2,1.28,
170,2,car,crv,248,759,450,741,511,291,0.8263495,20,,2,1.28,
171,2,car,crv,114,1318,387,813,1204,426,0.43434885,20,,2,1.2916666666666667,
172,2,car,crv,246,759,446,744,513,298,0.9186257,20,,2,1.2916666666666667,
173,2,car,crv,119,1325,389,808,1206,419,0.46840343,20,,2,1.24,
174,2,car,crv,244,759,447,741,515,294,0.83414143,20,,2,1.24,
175,2,car,crv,116,1322,388,811,1206,423,0.44209528,20,,2,1.28,
176,2,car,crv,241,764,450,741,523,291,0.8834957,20,,2,1.28,
177,2,car,crv,334,710,446,701,376,255,0.92716336,3,0,2,0.6781914893617021,
178,2,car,crv,336,711,446,700,375,254,0.9036748,3,0,2,0.6773333333333333,
179,2,car,crv,335,709,444,701,374,257,0.9452533,3,0,2,0.6871657754010695,
0,2,car,crv,118,1319,389,817,1201,428,0.37113744,20,,2,1.2916666666666667,
1,2,car,crv,247,758,450,737,511,287,0.9113323,20,,2,1.2916666666666667,
2,2,car,crv,123,1308,390,814,1185,424,0.3166677,20,,2,1.24,
3,2,car,crv,247,758,447,742,511,295,0.9435399,20,,2,1.24,
4,2,car,crv,120,1318,392,810,1198,418,0.37392586,20,,2,1.2916666666666667,
5,2,car,crv,248,758,450,739,510,289,0.9237008,20,,2,1.2916666666666667,
6,2,car,crv,110,1316,390,815,1206,425,0.20233919,20,,2,0.3524046434494196,
7,2,car,crv,250,753,447,736,503,289,0.9751715,20,,2,0.3524046434494196,
8,2,car,crv,129,1310,386,816,1181,430,0.3428058,20,,2,1.2916666666666667,
9,2,car,crv,247,760,447,740,513,293,0.8918332,20,,2,1.2916666666666667,
10,2,car,crv,122,1317,391,811,1195,420,0.44330603,20,,2,1.24,
11,2,car,crv,243,763,449,737,520,288,0.921945,20,,2,1.24,
12,2,car,crv,120,1307,387,819,1187,432,0.29826218,20,,2,0.36394271272114576,
13,2,car,crv,251,756,446,743,505,297,0.96940076,20,,2,0.36394271272114576,
14,2,car,crv,129,1303,385,817,1174,432,0.33652014,20,,2,1.25,
15,2,car,crv,247,762,444,744,515,300,0.95280766,20,,2,1.25,
16,2,car,crv,121,1309,390,816,1188,426,0.26945764,20,,2,0.35858585858585856,
17,2,car,crv,250,755,447,742,505,295,0.97232443,20,,2,0.35858585858585856,
18,2,car,crv,118,1317,389,817,1199,428,0.40577245,20,,2,1.2916666666666667,
19,2,car,crv,250,758,446,743,508,297,0.94312155,20,,2,1.2916666666666667,
20,2,car,crv,121,1303,387,817,1182,430,0.23037793,20,,2,0.3637901861252115,
21,2,car,crv,250,752,444,747,502,303,0.973318,20,,2,0.3637901861252115,
22,2,car,crv,129,1309,395,806,1180,411,0.31128713,20,,2,0.3483050847457627,
23,2,car,crv,248,761,449,740,513,291,0.95252526,20,,2,0.3483050847457627,
24,2,car,crv,121,1303,389,815,1182,426,0.23151965,20,,2,0.3604060913705584,
25,2,car,crv,245,754,445,744,509,299,0.9742757,20,,2,0.3604060913705584,
26,2,car,crv,124,1302,388,819,1178,431,0.20558608,20,,2,0.36587436332767403,
27,2,car,crv,252,759,447,740,507,293,0.971343,20,,2,0.36587436332767403,
28,2,car,crv,120,1318,389,815,1198,426,0.37832162,20,,2,1.24,
29,2,car,crv,248,758,449,738,510,289,0.9015974,20,,2,1.24,
30,2,car,crv,123,1313,389,813,1190,424,0.38111085,20,,2,1.24,
31,2,car,crv,247,755,446,744,508,298,0.8986612,20,,2,1.24,
32,2,car,crv,117,1315,387,816,1198,429,0.4219676,20,,2,1.2307692307692308,
33,2,car,crv,251,757,449,740,506,291,0.9306962,20,,2,1.2307692307692308,
34,2,car,crv,119,1318,391,816,1199,425,0.41724253,20,,2,1.3333333333333333,
35,2,car,crv,247,759,447,741,512,294,0.9398525,20,,2,1.3333333333333333,
36,2,car,crv,128,1307,392,813,1179,421,0.25620303,20,,2,0.3570822731128075,
37,2,car,crv,251,756,447,741,505,294,0.9512551,20,,2,0.3570822731128075,
38,2,car,crv,119,1314,386,816,1195,430,0.45291424,20,,2,1.2916666666666667,
39,2,car,crv,250,759,449,744,509,295,0.90196574,20,,2,1.2916666666666667,
40,2,car,crv,126,1304,388,820,1178,432,0.2519957,20,,2,0.366723259762309,
41,2,car,crv,253,757,448,737,504,289,0.9349736,20,,2,0.366723259762309,
42,2,car,crv,122,1317,387,818,1195,431,0.38155946,20,,2,1.24,
43,2,car,crv,248,756,447,743,508,296,0.9098617,20,,2,1.24,
44,2,car,crv,120,1319,389,808,1199,419,0.49123806,20,,2,1.24,
45,2,car,crv,241,764,446,743,523,297,0.8688812,20,,2,1.24,
46,2,car,crv,251,754,448,736,503,288,0.9627608,20,,2,1.28,
47,2,car,crv,114,1312,387,822,1198,435,0.2406673,20,,2,0.3631051752921536,
48,2,car,crv,253,758,447,739,505,292,0.9361756,20,,2,0.3631051752921536,
49,2,car,crv,121,1313,387,820,1192,433,0.26400292,20,,2,1.24,
50,2,car,crv,246,754,446,742,508,296,0.95298326,20,,2,1.24,
51,2,car,crv,131,1305,389,817,1174,428,0.29075116,20,,2,0.3645655877342419,
52,2,car,crv,252,754,448,743,502,295,0.94248277,20,,2,0.3645655877342419,
53,2,car,crv,130,1307,389,819,1177,430,0.2569041,20,,2,1.24,
54,2,car,crv,256,753,448,740,497,292,0.955823,20,,2,1.24,
55,2,car,crv,127,1305,390,811,1178,421,0.25976446,20,,2,0.35738539898132426,
56,2,car,crv,250,757,443,743,507,300,0.9547171,20,,2,0.35738539898132426,
57,2,car,crv,123,1309,392,810,1186,418,0.28978387,20,,2,1.24,
58,2,car,crv,248,758,446,738,510,292,0.96847486,20,,2,1.24,
59,2,car,crv,123,1304,388,814,1181,426,0.2588897,20,,2,0.3607112616426757,
60,2,car,crv,250,759,447,742,509,295,0.9416412,20,,2,0.3607112616426757,
61,2,car,crv,130,1306,391,810,1176,419,0.26097575,20,,2,0.3562925170068027,
62,2,car,crv,250,756,447,739,506,292,0.95065075,20,,2,0.3562925170068027,
63,2,car,crv,123,1309,389,813,1186,424,0.31858423,20,,2,1.24,
64,2,car,crv,248,758,447,745,510,298,0.9534346,20,,2,1.24,
65,2,car,crv,121,1305,386,819,1184,433,0.24762785,20,,2,0.3657094594594595,
66,2,car,crv,248,759,448,745,511,297,0.96054053,20,,2,0.3657094594594595,
67,2,car,crv,251,754,443,743,503,300,0.96310854,20,,2,1.24,
68,2,car,crv,117,1318,387,822,1201,435,0.42310923,20,,2,1.2916666666666667,
69,2,car,crv,248,763,450,742,515,292,0.92204607,20,,2,1.2916666666666667,
70,2,car,crv,119,1311,391,813,1192,422,0.25885653,20,,2,1.25,
71,2,car,crv,246,752,446,739,506,293,0.95473194,20,,2,1.25,
72,2,car,crv,128,1304,388,815,1176,427,0.30647025,20,,2,1.28,
73,2,car,crv,251,758,443,746,507,303,0.93285924,20,,2,1.28,
74,2,car,crv,250,754,447,738,504,291,0.9767751,20,,2,1.24,
75,2,car,crv,109,1318,388,813,1209,425,0.32027155,20,,2,1.28,
76,2,car,crv,245,760,445,741,515,296,0.9680706,20,,2,1.28,
77,2,car,crv,127,1308,391,816,1181,425,0.2964813,20,,2,1.2916666666666667,
78,2,car,crv,250,757,447,742,507,295,0.9490655,20,,2,1.2916666666666667,
79,2,car,crv,125,1314,388,816,1189,428,0.42268884,20,,2,1.28,
80,2,car,crv,248,760,449,737,512,288,0.90941703,20,,2,1.28,
81,2,car,crv,129,1304,390,814,1175,424,0.26254445,20,,2,1.2916666666666667,
82,2,car,crv,252,755,447,740,503,293,0.94612926,20,,2,1.2916666666666667,
83,2,car,crv,114,1320,387,815,1206,428,0.30274954,20,,2,1.24,
84,2,car,crv,248,753,446,740,505,294,0.8954264,20,,2,1.24,
85,2,car,crv,127,1307,391,814,1180,423,0.278648,20,,2,0.35847457627118645,
86,2,car,crv,250,755,447,744,505,297,0.95984495,20,,2,0.35847457627118645,
87,2,car,crv,127,1302,386,816,1175,430,0.37110242,20,,2,1.28,
88,2,car,crv,246,757,444,747,511,303,0.96607155,20,,2,1.28,
89,2,car,crv,119,1307,387,816,1188,429,0.28644451,20,,2,0.3611111111111111,
90,2,car,crv,248,759,443,747,511,304,0.9593547,20,,2,0.3611111111111111,
91,2,car,crv,127,1306,389,820,1179,431,0.37050778,20,,2,1.24,
92,2,car,crv,252,758,449,742,506,293,0.9203835,20,,2,1.24,
93,2,car,crv,126,1306,387,819,1180,432,0.24266188,20,,2,0.36610169491525424,
94,2,car,crv,247,754,449,740,507,291,0.94762105,20,,2,0.36610169491525424,
95,2,car,crv,113,1317,388,815,1204,427,0.36209753,20,,2,1.24,
96,2,car,crv,247,755,446,738,508,292,0.93217456,20,,2,1.24,
97,2,car,crv,116,1312,386,813,1196,427,0.26130736,20,,2,0.35702341137123744,
98,2,car,crv,249,755,445,740,506,295,0.95275867,20,,2,0.35702341137123744,
99,2,car,crv,250,753,445,746,503,301,0.97777426,20,,2,1.24,
100,2,car,crv,117,1316,390,813,1199,423,0.30318785,20,,2,0.35279399499582986,
101,2,car,crv,239,759,447,740,520,293,0.956478,20,,2,0.35279399499582986,
102,2,car,crv,126,1307,387,813,1181,426,0.3400013,20,,2,1.24,
103,2,car,crv,250,757,446,745,507,299,0.93553233,20,,2,1.24,
104,2,car,crv,118,1316,385,817,1198,432,0.46192503,20,,2,1.24,
105,2,car,crv,242,760,449,744,518,295,0.9251644,20,,2,1.24,
106,2,car,crv,125,1310,389,811,1185,422,0.32076746,20,,2,0.3561181434599156,
107,2,car,crv,250,758,446,739,508,293,0.9462212,20,,2,0.3561181434599156,
108,2,car,crv,250,754,444,740,504,296,0.96969557,20,,2,1.24,
109,2,car,crv,113,1313,388,814,1200,426,0.2754978,20,,2,1.24,
110,2,car,crv,244,756,445,743,512,298,0.96916515,20,,2,1.24,
111,2,car,crv,123,1309,388,814,1186,426,0.2760011,20,,2,1.24,
112,2,car,crv,249,758,446,740,509,294,0.950518,20,,2,1.24,
113,2,car,crv,253,754,447,737,501,290,0.94723046,20,,2,1.24,
114,2,car,crv,121,1308,387,817,1187,430,0.21458383,20,,2,0.36225779275484415,
115,2,car,crv,250,754,447,740,504,293,0.9610552,20,,2,0.36225779275484415,
116,2,car,crv,119,1317,388,814,1198,426,0.4732625,20,,2,1.24,
117,2,car,crv,245,758,448,742,513,294,0.94409996,20,,2,1.24,
118,2,car,crv,121,1308,388,815,1187,427,0.21448645,20,,2,0.35973041280539175,
119,2,car,crv,249,753,445,746,504,301,0.9724925,20,,2,0.35973041280539175,
120,2,car,crv,135,1302,387,821,1167,434,0.35179994,20,,2,1.2916666666666667,
121,2,car,crv,250,760,450,741,510,291,0.8736024,20,,2,1.2916666666666667,
122,2,car,crv,117,1313,390,812,1196,422,0.32242462,20,,2,1.2916666666666667,
123,2,car,crv,243,759,447,742,516,295,0.9675998,20,,2,1.2916666666666667,
124,2,car,crv,122,1311,387,814,1189,427,0.36553156,20,,2,1.2916666666666667,
125,2,car,crv,250,757,444,744,507,300,0.9479286,20,,2,1.2916666666666667,
126,2,car,crv,115,1321,388,815,1206,427,0.3674716,20,,2,1.24,
127,2,car,crv,248,756,446,740,508,294,0.92142504,20,,2,1.24,
128,2,car,crv,109,1315,384,827,1206,443,0.2820505,20,,2,1.24,
129,2,car,crv,249,758,449,736,509,287,0.91024953,20,,2,1.24,
130,2,car,crv,122,1310,388,817,1188,429,0.29904467,20,,2,0.3611111111111111,
131,2,car,crv,250,760,448,741,510,293,0.927252,20,,2,0.3611111111111111,
132,2,car,crv,129,1303,389,814,1174,425,0.27334884,20,,2,1.28,
133,2,car,crv,247,760,448,741,513,293,0.9333165,20,,2,1.28,
134,2,car,crv,122,1311,385,813,1189,428,0.35830083,20,,2,1.24,
135,2,car,crv,246,757,442,746,511,304,0.9668414,20,,2,1.24,
136,2,car,crv,122,1312,391,808,1190,417,0.34383425,20,,2,1.28,
137,2,car,crv,248,755,446,741,507,295,0.90284395,20,,2,1.28,
138,2,car,crv,129,1303,386,819,1174,433,0.2341652,20,,2,0.368824531516184,
139,2,car,crv,252,756,447,744,504,297,0.9354642,20,,2,0.368824531516184,
140,2,car,crv,253,756,446,744,503,298,0.97629297,20,,2,1.24,
141,2,car,crv,128,1307,388,817,1179,429,0.32914877,20,,2,1.2916666666666667,
142,2,car,crv,247,762,447,741,515,294,0.9441378,20,,2,1.2916666666666667,
143,2,car,crv,117,1313,388,818,1196,430,0.27251616,20,,2,0.3595317725752508,
144,2,car,crv,247,762,449,740,515,291,0.96550846,20,,2,0.3595317725752508,
145,2,car,crv,124,1305,387,820,1181,433,0.27402008,20,,2,0.36663844199830653,
146,2,car,crv,252,750,447,746,498,299,0.9501165,20,,2,0.36663844199830653,
147,2,car,crv,111,1317,390,812,1206,422,0.27479288,20,,2,0.34991708126036486,
148,2,car,crv,251,753,447,740,502,293,0.9438285,20,,2,0.34991708126036486,
149,2,car,crv,126,1309,390,814,1183,424,0.30222148,20,,2,1.2916666666666667,
150,2,car,crv,249,757,448,740,508,292,0.91383094,20,,2,1.2916666666666667,
151,2,car,crv,111,1317,390,811,1206,421,0.2941505,20,,2,0.3490878938640133,
152,2,car,crv,247,756,446,741,509,295,0.96245986,20,,2,0.3490878938640133,
153,2,car,crv,134,1300,387,818,1166,431,0.35928637,20,,2,1.28,
154,2,car,crv,251,757,447,743,506,296,0.9412378,20,,2,1.28,
155,2,car,crv,126,1312,388,815,1186,427,0.3965622,20,,2,1.24,
156,2,car,crv,252,758,446,743,506,297,0.9420341,20,,2,1.24,
157,2,car,crv,121,1316,389,809,1195,420,0.4096516,20,,2,1.24,
158,2,car,crv,244,761,447,742,517,295,0.9289579,20,,2,1.24,
159,2,car,crv,125,1312,392,805,1187,413,0.30284005,20,,2,1.24,
160,2,car,crv,245,760,447,739,515,292,0.9596912,20,,2,1.24,
161,2,car,crv,131,1307,388,812,1176,424,0.43397242,20,,2,1.2916666666666667,
162,2,car,crv,247,764,447,744,517,297,0.9014591,20,,2,1.2916666666666667,
163,2,car,crv,123,1315,388,811,1192,423,0.4968379,20,,2,1.24,
164,2,car,crv,246,758,446,743,512,297,0.87933147,20,,2,1.24,
165,2,car,crv,118,1312,389,813,1194,424,0.25691053,20,,2,0.35510887772194305,
166,2,car,crv,249,756,447,742,507,295,0.96910256,20,,2,0.35510887772194305,
167,2,car,crv,118,1319,389,813,1201,424,0.4023961,20,,2,1.28,
168,2,car,crv,243,757,448,743,514,295,0.94143236,20,,2,1.28,
169,2,car,crv,119,1322,385,815,1203,430,0.42900166,20,,2,1.24,
170,2,car,crv,246,762,447,741,516,294,0.790523,20,,2,1.24,
171,2,car,crv,119,1319,386,815,1200,429,0.44753623,20,,2,1.28,
172,2,car,crv,248,759,450,741,511,291,0.8263495,20,,2,1.28,
173,2,car,crv,114,1318,387,813,1204,426,0.43434885,20,,2,1.2916666666666667,
174,2,car,crv,246,759,446,744,513,298,0.9186257,20,,2,1.2916666666666667,
175,2,car,crv,119,1325,389,808,1206,419,0.46840343,20,,2,1.24,
176,2,car,crv,244,759,447,741,515,294,0.83414143,20,,2,1.24,
177,2,car,crv,116,1322,388,811,1206,423,0.44209528,20,,2,1.28,
178,2,car,crv,241,764,450,741,523,291,0.8834957,20,,2,1.28,
179,2,car,crv,334,710,446,701,376,255,0.92716336,3,0,2,0.6781914893617021,
180,2,car,crv,336,711,446,700,375,254,0.9036748,3,0,2,0.6773333333333333,
181,2,car,crv,335,709,444,701,374,257,0.9452533,3,0,2,0.6871657754010695,
0,2,car,crv,121,1309,389,816,1188,427,0.2116592,20,,2,0.35942760942760943,
1,2,car,crv,249,759,445,743,510,298,0.9460417,20,,2,0.35942760942760943,
2,2,car,crv,118,1319,389,817,1201,428,0.37113744,20,,2,1.2916666666666667,
3,2,car,crv,247,758,450,737,511,287,0.9113323,20,,2,1.2916666666666667,
4,2,car,crv,123,1308,390,814,1185,424,0.3166677,20,,2,1.24,
5,2,car,crv,247,758,447,742,511,295,0.9435399,20,,2,1.24,
6,2,car,crv,120,1318,392,810,1198,418,0.37392586,20,,2,1.2916666666666667,
7,2,car,crv,248,758,450,739,510,289,0.9237008,20,,2,1.2916666666666667,
8,2,car,crv,110,1316,390,815,1206,425,0.20233919,20,,2,0.3524046434494196,
9,2,car,crv,250,753,447,736,503,289,0.9751715,20,,2,0.3524046434494196,
10,2,car,crv,129,1310,386,816,1181,430,0.3428058,20,,2,1.2916666666666667,
11,2,car,crv,247,760,447,740,513,293,0.8918332,20,,2,1.2916666666666667,
12,2,car,crv,122,1317,391,811,1195,420,0.44330603,20,,2,1.24,
13,2,car,crv,243,763,449,737,520,288,0.921945,20,,2,1.24,
14,2,car,crv,120,1307,387,819,1187,432,0.29826218,20,,2,0.36394271272114576,
15,2,car,crv,251,756,446,743,505,297,0.96940076,20,,2,0.36394271272114576,
16,2,car,crv,129,1303,385,817,1174,432,0.33652014,20,,2,1.25,
17,2,car,crv,247,762,444,744,515,300,0.95280766,20,,2,1.25,
18,2,car,crv,121,1309,390,816,1188,426,0.26945764,20,,2,0.35858585858585856,
19,2,car,crv,250,755,447,742,505,295,0.97232443,20,,2,0.35858585858585856,
20,2,car,crv,118,1317,389,817,1199,428,0.40577245,20,,2,1.2916666666666667,
21,2,car,crv,250,758,446,743,508,297,0.94312155,20,,2,1.2916666666666667,
22,2,car,crv,121,1303,387,817,1182,430,0.23037793,20,,2,0.3637901861252115,
23,2,car,crv,250,752,444,747,502,303,0.973318,20,,2,0.3637901861252115,
24,2,car,crv,129,1309,395,806,1180,411,0.31128713,20,,2,0.3483050847457627,
25,2,car,crv,248,761,449,740,513,291,0.95252526,20,,2,0.3483050847457627,
26,2,car,crv,121,1303,389,815,1182,426,0.23151965,20,,2,0.3604060913705584,
27,2,car,crv,245,754,445,744,509,299,0.9742757,20,,2,0.3604060913705584,
28,2,car,crv,124,1302,388,819,1178,431,0.20558608,20,,2,0.36587436332767403,
29,2,car,crv,252,759,447,740,507,293,0.971343,20,,2,0.36587436332767403,
30,2,car,crv,120,1318,389,815,1198,426,0.37832162,20,,2,1.24,
31,2,car,crv,248,758,449,738,510,289,0.9015974,20,,2,1.24,
32,2,car,crv,123,1313,389,813,1190,424,0.38111085,20,,2,1.24,
33,2,car,crv,247,755,446,744,508,298,0.8986612,20,,2,1.24,
34,2,car,crv,117,1315,387,816,1198,429,0.4219676,20,,2,1.2307692307692308,
35,2,car,crv,251,757,449,740,506,291,0.9306962,20,,2,1.2307692307692308,
36,2,car,crv,119,1318,391,816,1199,425,0.41724253,20,,2,1.3333333333333333,
37,2,car,crv,247,759,447,741,512,294,0.9398525,20,,2,1.3333333333333333,
38,2,car,crv,128,1307,392,813,1179,421,0.25620303,20,,2,0.3570822731128075,
39,2,car,crv,251,756,447,741,505,294,0.9512551,20,,2,0.3570822731128075,
40,2,car,crv,119,1314,386,816,1195,430,0.45291424,20,,2,1.2916666666666667,
41,2,car,crv,250,759,449,744,509,295,0.90196574,20,,2,1.2916666666666667,
42,2,car,crv,126,1304,388,820,1178,432,0.2519957,20,,2,0.366723259762309,
43,2,car,crv,253,757,448,737,504,289,0.9349736,20,,2,0.366723259762309,
44,2,car,crv,122,1317,387,818,1195,431,0.38155946,20,,2,1.24,
45,2,car,crv,248,756,447,743,508,296,0.9098617,20,,2,1.24,
46,2,car,crv,120,1319,389,808,1199,419,0.49123806,20,,2,1.24,
47,2,car,crv,241,764,446,743,523,297,0.8688812,20,,2,1.24,
48,2,car,crv,251,754,448,736,503,288,0.9627608,20,,2,1.28,
49,2,car,crv,114,1312,387,822,1198,435,0.2406673,20,,2,0.3631051752921536,
50,2,car,crv,253,758,447,739,505,292,0.9361756,20,,2,0.3631051752921536,
51,2,car,crv,121,1313,387,820,1192,433,0.26400292,20,,2,1.24,
52,2,car,crv,246,754,446,742,508,296,0.95298326,20,,2,1.24,
53,2,car,crv,131,1305,389,817,1174,428,0.29075116,20,,2,0.3645655877342419,
54,2,car,crv,252,754,448,743,502,295,0.94248277,20,,2,0.3645655877342419,
55,2,car,crv,130,1307,389,819,1177,430,0.2569041,20,,2,1.24,
56,2,car,crv,256,753,448,740,497,292,0.955823,20,,2,1.24,
57,2,car,crv,127,1305,390,811,1178,421,0.25976446,20,,2,0.35738539898132426,
58,2,car,crv,250,757,443,743,507,300,0.9547171,20,,2,0.35738539898132426,
59,2,car,crv,123,1309,392,810,1186,418,0.28978387,20,,2,1.24,
60,2,car,crv,248,758,446,738,510,292,0.96847486,20,,2,1.24,
61,2,car,crv,123,1304,388,814,1181,426,0.2588897,20,,2,0.3607112616426757,
62,2,car,crv,250,759,447,742,509,295,0.9416412,20,,2,0.3607112616426757,
63,2,car,crv,130,1306,391,810,1176,419,0.26097575,20,,2,0.3562925170068027,
64,2,car,crv,250,756,447,739,506,292,0.95065075,20,,2,0.3562925170068027,
65,2,car,crv,123,1309,389,813,1186,424,0.31858423,20,,2,1.24,
66,2,car,crv,248,758,447,745,510,298,0.9534346,20,,2,1.24,
67,2,car,crv,121,1305,386,819,1184,433,0.24762785,20,,2,0.3657094594594595,
68,2,car,crv,248,759,448,745,511,297,0.96054053,20,,2,0.3657094594594595,
69,2,car,crv,251,754,443,743,503,300,0.96310854,20,,2,1.24,
70,2,car,crv,117,1318,387,822,1201,435,0.42310923,20,,2,1.2916666666666667,
71,2,car,crv,248,763,450,742,515,292,0.92204607,20,,2,1.2916666666666667,
72,2,car,crv,119,1311,391,813,1192,422,0.25885653,20,,2,1.25,
73,2,car,crv,246,752,446,739,506,293,0.95473194,20,,2,1.25,
74,2,car,crv,128,1304,388,815,1176,427,0.30647025,20,,2,1.28,
75,2,car,crv,251,758,443,746,507,303,0.93285924,20,,2,1.28,
76,2,car,crv,250,754,447,738,504,291,0.9767751,20,,2,1.24,
77,2,car,crv,109,1318,388,813,1209,425,0.32027155,20,,2,1.28,
78,2,car,crv,245,760,445,741,515,296,0.9680706,20,,2,1.28,
79,2,car,crv,127,1308,391,816,1181,425,0.2964813,20,,2,1.2916666666666667,
80,2,car,crv,250,757,447,742,507,295,0.9490655,20,,2,1.2916666666666667,
81,2,car,crv,125,1314,388,816,1189,428,0.42268884,20,,2,1.28,
82,2,car,crv,248,760,449,737,512,288,0.90941703,20,,2,1.28,
83,2,car,crv,129,1304,390,814,1175,424,0.26254445,20,,2,1.2916666666666667,
84,2,car,crv,252,755,447,740,503,293,0.94612926,20,,2,1.2916666666666667,
85,2,car,crv,114,1320,387,815,1206,428,0.30274954,20,,2,1.24,
86,2,car,crv,248,753,446,740,505,294,0.8954264,20,,2,1.24,
87,2,car,crv,127,1307,391,814,1180,423,0.278648,20,,2,0.35847457627118645,
88,2,car,crv,250,755,447,744,505,297,0.95984495,20,,2,0.35847457627118645,
89,2,car,crv,127,1302,386,816,1175,430,0.37110242,20,,2,1.28,
90,2,car,crv,246,757,444,747,511,303,0.96607155,20,,2,1.28,
91,2,car,crv,119,1307,387,816,1188,429,0.28644451,20,,2,0.3611111111111111,
92,2,car,crv,248,759,443,747,511,304,0.9593547,20,,2,0.3611111111111111,
93,2,car,crv,127,1306,389,820,1179,431,0.37050778,20,,2,1.24,
94,2,car,crv,252,758,449,742,506,293,0.9203835,20,,2,1.24,
95,2,car,crv,126,1306,387,819,1180,432,0.24266188,20,,2,0.36610169491525424,
96,2,car,crv,247,754,449,740,507,291,0.94762105,20,,2,0.36610169491525424,
97,2,car,crv,113,1317,388,815,1204,427,0.36209753,20,,2,1.24,
98,2,car,crv,247,755,446,738,508,292,0.93217456,20,,2,1.24,
99,2,car,crv,116,1312,386,813,1196,427,0.26130736,20,,2,0.35702341137123744,
100,2,car,crv,249,755,445,740,506,295,0.95275867,20,,2,0.35702341137123744,
101,2,car,crv,250,753,445,746,503,301,0.97777426,20,,2,1.24,
102,2,car,crv,117,1316,390,813,1199,423,0.30318785,20,,2,0.35279399499582986,
103,2,car,crv,239,759,447,740,520,293,0.956478,20,,2,0.35279399499582986,
104,2,car,crv,126,1307,387,813,1181,426,0.3400013,20,,2,1.24,
105,2,car,crv,250,757,446,745,507,299,0.93553233,20,,2,1.24,
106,2,car,crv,118,1316,385,817,1198,432,0.46192503,20,,2,1.24,
107,2,car,crv,242,760,449,744,518,295,0.9251644,20,,2,1.24,
108,2,car,crv,125,1310,389,811,1185,422,0.32076746,20,,2,0.3561181434599156,
109,2,car,crv,250,758,446,739,508,293,0.9462212,20,,2,0.3561181434599156,
110,2,car,crv,250,754,444,740,504,296,0.96969557,20,,2,1.24,
111,2,car,crv,113,1313,388,814,1200,426,0.2754978,20,,2,1.24,
112,2,car,crv,244,756,445,743,512,298,0.96916515,20,,2,1.24,
113,2,car,crv,123,1309,388,814,1186,426,0.2760011,20,,2,1.24,
114,2,car,crv,249,758,446,740,509,294,0.950518,20,,2,1.24,
115,2,car,crv,253,754,447,737,501,290,0.94723046,20,,2,1.24,
116,2,car,crv,121,1308,387,817,1187,430,0.21458383,20,,2,0.36225779275484415,
117,2,car,crv,250,754,447,740,504,293,0.9610552,20,,2,0.36225779275484415,
118,2,car,crv,119,1317,388,814,1198,426,0.4732625,20,,2,1.24,
119,2,car,crv,245,758,448,742,513,294,0.94409996,20,,2,1.24,
120,2,car,crv,121,1308,388,815,1187,427,0.21448645,20,,2,0.35973041280539175,
121,2,car,crv,249,753,445,746,504,301,0.9724925,20,,2,0.35973041280539175,
122,2,car,crv,135,1302,387,821,1167,434,0.35179994,20,,2,1.2916666666666667,
123,2,car,crv,250,760,450,741,510,291,0.8736024,20,,2,1.2916666666666667,
124,2,car,crv,117,1313,390,812,1196,422,0.32242462,20,,2,1.2916666666666667,
125,2,car,crv,243,759,447,742,516,295,0.9675998,20,,2,1.2916666666666667,
126,2,car,crv,122,1311,387,814,1189,427,0.36553156,20,,2,1.2916666666666667,
127,2,car,crv,250,757,444,744,507,300,0.9479286,20,,2,1.2916666666666667,
128,2,car,crv,115,1321,388,815,1206,427,0.3674716,20,,2,1.24,
129,2,car,crv,248,756,446,740,508,294,0.92142504,20,,2,1.24,
130,2,car,crv,109,1315,384,827,1206,443,0.2820505,20,,2,1.24,
131,2,car,crv,249,758,449,736,509,287,0.91024953,20,,2,1.24,
132,2,car,crv,122,1310,388,817,1188,429,0.29904467,20,,2,0.3611111111111111,
133,2,car,crv,250,760,448,741,510,293,0.927252,20,,2,0.3611111111111111,
134,2,car,crv,129,1303,389,814,1174,425,0.27334884,20,,2,1.28,
135,2,car,crv,247,760,448,741,513,293,0.9333165,20,,2,1.28,
136,2,car,crv,122,1311,385,813,1189,428,0.35830083,20,,2,1.24,
137,2,car,crv,246,757,442,746,511,304,0.9668414,20,,2,1.24,
138,2,car,crv,122,1312,391,808,1190,417,0.34383425,20,,2,1.28,
139,2,car,crv,248,755,446,741,507,295,0.90284395,20,,2,1.28,
140,2,car,crv,129,1303,386,819,1174,433,0.2341652,20,,2,0.368824531516184,
141,2,car,crv,252,756,447,744,504,297,0.9354642,20,,2,0.368824531516184,
142,2,car,crv,253,756,446,744,503,298,0.97629297,20,,2,1.24,
143,2,car,crv,128,1307,388,817,1179,429,0.32914877,20,,2,1.2916666666666667,
144,2,car,crv,247,762,447,741,515,294,0.9441378,20,,2,1.2916666666666667,
145,2,car,crv,117,1313,388,818,1196,430,0.27251616,20,,2,0.3595317725752508,
146,2,car,crv,247,762,449,740,515,291,0.96550846,20,,2,0.3595317725752508,
147,2,car,crv,124,1305,387,820,1181,433,0.27402008,20,,2,0.36663844199830653,
148,2,car,crv,252,750,447,746,498,299,0.9501165,20,,2,0.36663844199830653,
149,2,car,crv,111,1317,390,812,1206,422,0.27479288,20,,2,0.34991708126036486,
150,2,car,crv,251,753,447,740,502,293,0.9438285,20,,2,0.34991708126036486,
151,2,car,crv,126,1309,390,814,1183,424,0.30222148,20,,2,1.2916666666666667,
152,2,car,crv,249,757,448,740,508,292,0.91383094,20,,2,1.2916666666666667,
153,2,car,crv,111,1317,390,811,1206,421,0.2941505,20,,2,0.3490878938640133,
154,2,car,crv,247,756,446,741,509,295,0.96245986,20,,2,0.3490878938640133,
155,2,car,crv,134,1300,387,818,1166,431,0.35928637,20,,2,1.28,
156,2,car,crv,251,757,447,743,506,296,0.9412378,20,,2,1.28,
157,2,car,crv,126,1312,388,815,1186,427,0.3965622,20,,2,1.24,
158,2,car,crv,252,758,446,743,506,297,0.9420341,20,,2,1.24,
159,2,car,crv,121,1316,389,809,1195,420,0.4096516,20,,2,1.24,
160,2,car,crv,244,761,447,742,517,295,0.9289579,20,,2,1.24,
161,2,car,crv,125,1312,392,805,1187,413,0.30284005,20,,2,1.24,
162,2,car,crv,245,760,447,739,515,292,0.9596912,20,,2,1.24,
163,2,car,crv,131,1307,388,812,1176,424,0.43397242,20,,2,1.2916666666666667,
164,2,car,crv,247,764,447,744,517,297,0.9014591,20,,2,1.2916666666666667,
165,2,car,crv,123,1315,388,811,1192,423,0.4968379,20,,2,1.24,
166,2,car,crv,246,758,446,743,512,297,0.87933147,20,,2,1.24,
167,2,car,crv,118,1312,389,813,1194,424,0.25691053,20,,2,0.35510887772194305,
168,2,car,crv,249,756,447,742,507,295,0.96910256,20,,2,0.35510887772194305,
169,2,car,crv,118,1319,389,813,1201,424,0.4023961,20,,2,1.28,
170,2,car,crv,243,757,448,743,514,295,0.94143236,20,,2,1.28,
171,2,car,crv,119,1322,385,815,1203,430,0.42900166,20,,2,1.24,
172,2,car,crv,246,762,447,741,516,294,0.790523,20,,2,1.24,
173,2,car,crv,119,1319,386,815,1200,429,0.44753623,20,,2,1.28,
174,2,car,crv,248,759,450,741,511,291,0.8263495,20,,2,1.28,
175,2,car,crv,114,1318,387,813,1204,426,0.43434885,20,,2,1.2916666666666667,
176,2,car,crv,246,759,446,744,513,298,0.9186257,20,,2,1.2916666666666667,
177,2,car,crv,119,1325,389,808,1206,419,0.46840343,20,,2,1.24,
178,2,car,crv,244,759,447,741,515,294,0.83414143,20,,2,1.24,
179,2,car,crv,116,1322,388,811,1206,423,0.44209528,20,,2,1.28,
180,2,car,crv,241,764,450,741,523,291,0.8834957,20,,2,1.28,
181,2,car,crv,334,710,446,701,376,255,0.92716336,3,0,2,0.6781914893617021,
182,2,car,crv,336,711,446,700,375,254,0.9036748,3,0,2,0.6773333333333333,
183,2,car,crv,335,709,444,701,374,257,0.9452533,3,0,2,0.6871657754010695,
0,2,car,crv,119,1305,388,818,1186,430,0.24092749,20,,2,0.3625632377740304,
1,2,car,crv,251,757,445,745,506,300,0.9550495,20,,2,0.3625632377740304,
2,2,car,crv,121,1309,389,816,1188,427,0.2116592,20,,2,0.35942760942760943,
3,2,car,crv,249,759,445,743,510,298,0.9460417,20,,2,0.35942760942760943,
4,2,car,crv,118,1319,389,817,1201,428,0.37113744,20,,2,1.2916666666666667,
5,2,car,crv,247,758,450,737,511,287,0.9113323,20,,2,1.2916666666666667,
6,2,car,crv,123,1308,390,814,1185,424,0.3166677,20,,2,1.24,
7,2,car,crv,247,758,447,742,511,295,0.9435399,20,,2,1.24,
8,2,car,crv,120,1318,392,810,1198,418,0.37392586,20,,2,1.2916666666666667,
9,2,car,crv,248,758,450,739,510,289,0.9237008,20,,2,1.2916666666666667,
10,2,car,crv,110,1316,390,815,1206,425,0.20233919,20,,2,0.3524046434494196,
11,2,car,crv,250,753,447,736,503,289,0.9751715,20,,2,0.3524046434494196,
12,2,car,crv,129,1310,386,816,1181,430,0.3428058,20,,2,1.2916666666666667,
13,2,car,crv,247,760,447,740,513,293,0.8918332,20,,2,1.2916666666666667,
14,2,car,crv,122,1317,391,811,1195,420,0.44330603,20,,2,1.24,
15,2,car,crv,243,763,449,737,520,288,0.921945,20,,2,1.24,
16,2,car,crv,120,1307,387,819,1187,432,0.29826218,20,,2,0.36394271272114576,
17,2,car,crv,251,756,446,743,505,297,0.96940076,20,,2,0.36394271272114576,
18,2,car,crv,129,1303,385,817,1174,432,0.33652014,20,,2,1.25,
19,2,car,crv,247,762,444,744,515,300,0.95280766,20,,2,1.25,
20,2,car,crv,121,1309,390,816,1188,426,0.26945764,20,,2,0.35858585858585856,
21,2,car,crv,250,755,447,742,505,295,0.97232443,20,,2,0.35858585858585856,
22,2,car,crv,118,1317,389,817,1199,428,0.40577245,20,,2,1.2916666666666667,
23,2,car,crv,250,758,446,743,508,297,0.94312155,20,,2,1.2916666666666667,
24,2,car,crv,121,1303,387,817,1182,430,0.23037793,20,,2,0.3637901861252115,
25,2,car,crv,250,752,444,747,502,303,0.973318,20,,2,0.3637901861252115,
26,2,car,crv,129,1309,395,806,1180,411,0.31128713,20,,2,0.3483050847457627,
27,2,car,crv,248,761,449,740,513,291,0.95252526,20,,2,0.3483050847457627,
28,2,car,crv,121,1303,389,815,1182,426,0.23151965,20,,2,0.3604060913705584,
29,2,car,crv,245,754,445,744,509,299,0.9742757,20,,2,0.3604060913705584,
30,2,car,crv,124,1302,388,819,1178,431,0.20558608,20,,2,0.36587436332767403,
31,2,car,crv,252,759,447,740,507,293,0.971343,20,,2,0.36587436332767403,
32,2,car,crv,120,1318,389,815,1198,426,0.37832162,20,,2,1.24,
33,2,car,crv,248,758,449,738,510,289,0.9015974,20,,2,1.24,
34,2,car,crv,123,1313,389,813,1190,424,0.38111085,20,,2,1.24,
35,2,car,crv,247,755,446,744,508,298,0.8986612,20,,2,1.24,
36,2,car,crv,117,1315,387,816,1198,429,0.4219676,20,,2,1.2307692307692308,
37,2,car,crv,251,757,449,740,506,291,0.9306962,20,,2,1.2307692307692308,
38,2,car,crv,119,1318,391,816,1199,425,0.41724253,20,,2,1.3333333333333333,
39,2,car,crv,247,759,447,741,512,294,0.9398525,20,,2,1.3333333333333333,
40,2,car,crv,128,1307,392,813,1179,421,0.25620303,20,,2,0.3570822731128075,
41,2,car,crv,251,756,447,741,505,294,0.9512551,20,,2,0.3570822731128075,
42,2,car,crv,119,1314,386,816,1195,430,0.45291424,20,,2,1.2916666666666667,
43,2,car,crv,250,759,449,744,509,295,0.90196574,20,,2,1.2916666666666667,
44,2,car,crv,126,1304,388,820,1178,432,0.2519957,20,,2,0.366723259762309,
45,2,car,crv,253,757,448,737,504,289,0.9349736,20,,2,0.366723259762309,
46,2,car,crv,122,1317,387,818,1195,431,0.38155946,20,,2,1.24,
47,2,car,crv,248,756,447,743,508,296,0.9098617,20,,2,1.24,
48,2,car,crv,120,1319,389,808,1199,419,0.49123806,20,,2,1.24,
49,2,car,crv,241,764,446,743,523,297,0.8688812,20,,2,1.24,
50,2,car,crv,251,754,448,736,503,288,0.9627608,20,,2,1.28,
51,2,car,crv,114,1312,387,822,1198,435,0.2406673,20,,2,0.3631051752921536,
52,2,car,crv,253,758,447,739,505,292,0.9361756,20,,2,0.3631051752921536,
53,2,car,crv,121,1313,387,820,1192,433,0.26400292,20,,2,1.24,
54,2,car,crv,246,754,446,742,508,296,0.95298326,20,,2,1.24,
55,2,car,crv,131,1305,389,817,1174,428,0.29075116,20,,2,0.3645655877342419,
56,2,car,crv,252,754,448,743,502,295,0.94248277,20,,2,0.3645655877342419,
57,2,car,crv,130,1307,389,819,1177,430,0.2569041,20,,2,1.24,
58,2,car,crv,256,753,448,740,497,292,0.955823,20,,2,1.24,
59,2,car,crv,127,1305,390,811,1178,421,0.25976446,20,,2,0.35738539898132426,
60,2,car,crv,250,757,443,743,507,300,0.9547171,20,,2,0.35738539898132426,
61,2,car,crv,123,1309,392,810,1186,418,0.28978387,20,,2,1.24,
62,2,car,crv,248,758,446,738,510,292,0.96847486,20,,2,1.24,
63,2,car,crv,123,1304,388,814,1181,426,0.2588897,20,,2,0.3607112616426757,
64,2,car,crv,250,759,447,742,509,295,0.9416412,20,,2,0.3607112616426757,
65,2,car,crv,130,1306,391,810,1176,419,0.26097575,20,,2,0.3562925170068027,
66,2,car,crv,250,756,447,739,506,292,0.95065075,20,,2,0.3562925170068027,
67,2,car,crv,123,1309,389,813,1186,424,0.31858423,20,,2,1.24,
68,2,car,crv,248,758,447,745,510,298,0.9534346,20,,2,1.24,
69,2,car,crv,121,1305,386,819,1184,433,0.24762785,20,,2,0.3657094594594595,
70,2,car,crv,248,759,448,745,511,297,0.96054053,20,,2,0.3657094594594595,
71,2,car,crv,251,754,443,743,503,300,0.96310854,20,,2,1.24,
72,2,car,crv,117,1318,387,822,1201,435,0.42310923,20,,2,1.2916666666666667,
73,2,car,crv,248,763,450,742,515,292,0.92204607,20,,2,1.2916666666666667,
74,2,car,crv,119,1311,391,813,1192,422,0.25885653,20,,2,1.25,
75,2,car,crv,246,752,446,739,506,293,0.95473194,20,,2,1.25,
76,2,car,crv,128,1304,388,815,1176,427,0.30647025,20,,2,1.28,
77,2,car,crv,251,758,443,746,507,303,0.93285924,20,,2,1.28,
78,2,car,crv,250,754,447,738,504,291,0.9767751,20,,2,1.24,
79,2,car,crv,109,1318,388,813,1209,425,0.32027155,20,,2,1.28,
80,2,car,crv,245,760,445,741,515,296,0.9680706,20,,2,1.28,
81,2,car,crv,127,1308,391,816,1181,425,0.2964813,20,,2,1.2916666666666667,
82,2,car,crv,250,757,447,742,507,295,0.9490655,20,,2,1.2916666666666667,
83,2,car,crv,125,1314,388,816,1189,428,0.42268884,20,,2,1.28,
84,2,car,crv,248,760,449,737,512,288,0.90941703,20,,2,1.28,
85,2,car,crv,129,1304,390,814,1175,424,0.26254445,20,,2,1.2916666666666667,
86,2,car,crv,252,755,447,740,503,293,0.94612926,20,,2,1.2916666666666667,
87,2,car,crv,114,1320,387,815,1206,428,0.30274954,20,,2,1.24,
88,2,car,crv,248,753,446,740,505,294,0.8954264,20,,2,1.24,
89,2,car,crv,127,1307,391,814,1180,423,0.278648,20,,2,0.35847457627118645,
90,2,car,crv,250,755,447,744,505,297,0.95984495,20,,2,0.35847457627118645,
91,2,car,crv,127,1302,386,816,1175,430,0.37110242,20,,2,1.28,
92,2,car,crv,246,757,444,747,511,303,0.96607155,20,,2,1.28,
93,2,car,crv,119,1307,387,816,1188,429,0.28644451,20,,2,0.3611111111111111,
94,2,car,crv,248,759,443,747,511,304,0.9593547,20,,2,0.3611111111111111,
95,2,car,crv,127,1306,389,820,1179,431,0.37050778,20,,2,1.24,
96,2,car,crv,252,758,449,742,506,293,0.9203835,20,,2,1.24,
97,2,car,crv,126,1306,387,819,1180,432,0.24266188,20,,2,0.36610169491525424,
98,2,car,crv,247,754,449,740,507,291,0.94762105,20,,2,0.36610169491525424,
99,2,car,crv,113,1317,388,815,1204,427,0.36209753,20,,2,1.24,
100,2,car,crv,247,755,446,738,508,292,0.93217456,20,,2,1.24,
101,2,car,crv,116,1312,386,813,1196,427,0.26130736,20,,2,0.35702341137123744,
102,2,car,crv,249,755,445,740,506,295,0.95275867,20,,2,0.35702341137123744,
103,2,car,crv,250,753,445,746,503,301,0.97777426,20,,2,1.24,
104,2,car,crv,117,1316,390,813,1199,423,0.30318785,20,,2,0.35279399499582986,
105,2,car,crv,239,759,447,740,520,293,0.956478,20,,2,0.35279399499582986,
106,2,car,crv,126,1307,387,813,1181,426,0.3400013,20,,2,1.24,
107,2,car,crv,250,757,446,745,507,299,0.93553233,20,,2,1.24,
108,2,car,crv,118,1316,385,817,1198,432,0.46192503,20,,2,1.24,
109,2,car,crv,242,760,449,744,518,295,0.9251644,20,,2,1.24,
110,2,car,crv,125,1310,389,811,1185,422,0.32076746,20,,2,0.3561181434599156,
111,2,car,crv,250,758,446,739,508,293,0.9462212,20,,2,0.3561181434599156,
112,2,car,crv,250,754,444,740,504,296,0.96969557,20,,2,1.24,
113,2,car,crv,113,1313,388,814,1200,426,0.2754978,20,,2,1.24,
114,2,car,crv,244,756,445,743,512,298,0.96916515,20,,2,1.24,
115,2,car,crv,123,1309,388,814,1186,426,0.2760011,20,,2,1.24,
116,2,car,crv,249,758,446,740,509,294,0.950518,20,,2,1.24,
117,2,car,crv,253,754,447,737,501,290,0.94723046,20,,2,1.24,
118,2,car,crv,121,1308,387,817,1187,430,0.21458383,20,,2,0.36225779275484415,
119,2,car,crv,250,754,447,740,504,293,0.9610552,20,,2,0.36225779275484415,
120,2,car,crv,119,1317,388,814,1198,426,0.4732625,20,,2,1.24,
121,2,car,crv,245,758,448,742,513,294,0.94409996,20,,2,1.24,
122,2,car,crv,121,1308,388,815,1187,427,0.21448645,20,,2,0.35973041280539175,
123,2,car,crv,249,753,445,746,504,301,0.9724925,20,,2,0.35973041280539175,
124,2,car,crv,135,1302,387,821,1167,434,0.35179994,20,,2,1.2916666666666667,
125,2,car,crv,250,760,450,741,510,291,0.8736024,20,,2,1.2916666666666667,
126,2,car,crv,117,1313,390,812,1196,422,0.32242462,20,,2,1.2916666666666667,
127,2,car,crv,243,759,447,742,516,295,0.9675998,20,,2,1.2916666666666667,
128,2,car,crv,122,1311,387,814,1189,427,0.36553156,20,,2,1.2916666666666667,
129,2,car,crv,250,757,444,744,507,300,0.9479286,20,,2,1.2916666666666667,
130,2,car,crv,115,1321,388,815,1206,427,0.3674716,20,,2,1.24,
131,2,car,crv,248,756,446,740,508,294,0.92142504,20,,2,1.24,
132,2,car,crv,109,1315,384,827,1206,443,0.2820505,20,,2,1.24,
133,2,car,crv,249,758,449,736,509,287,0.91024953,20,,2,1.24,
134,2,car,crv,122,1310,388,817,1188,429,0.29904467,20,,2,0.3611111111111111,
135,2,car,crv,250,760,448,741,510,293,0.927252,20,,2,0.3611111111111111,
136,2,car,crv,129,1303,389,814,1174,425,0.27334884,20,,2,1.28,
137,2,car,crv,247,760,448,741,513,293,0.9333165,20,,2,1.28,
138,2,car,crv,122,1311,385,813,1189,428,0.35830083,20,,2,1.24,
139,2,car,crv,246,757,442,746,511,304,0.9668414,20,,2,1.24,
140,2,car,crv,122,1312,391,808,1190,417,0.34383425,20,,2,1.28,
141,2,car,crv,248,755,446,741,507,295,0.90284395,20,,2,1.28,
142,2,car,crv,129,1303,386,819,1174,433,0.2341652,20,,2,0.368824531516184,
143,2,car,crv,252,756,447,744,504,297,0.9354642,20,,2,0.368824531516184,
144,2,car,crv,253,756,446,744,503,298,0.97629297,20,,2,1.24,
145,2,car,crv,128,1307,388,817,1179,429,0.32914877,20,,2,1.2916666666666667,
146,2,car,crv,247,762,447,741,515,294,0.9441378,20,,2,1.2916666666666667,
147,2,car,crv,117,1313,388,818,1196,430,0.27251616,20,,2,0.3595317725752508,
148,2,car,crv,247,762,449,740,515,291,0.96550846,20,,2,0.3595317725752508,
149,2,car,crv,124,1305,387,820,1181,433,0.27402008,20,,2,0.36663844199830653,
150,2,car,crv,252,750,447,746,498,299,0.9501165,20,,2,0.36663844199830653,
151,2,car,crv,111,1317,390,812,1206,422,0.27479288,20,,2,0.34991708126036486,
152,2,car,crv,251,753,447,740,502,293,0.9438285,20,,2,0.34991708126036486,
153,2,car,crv,126,1309,390,814,1183,424,0.30222148,20,,2,1.2916666666666667,
154,2,car,crv,249,757,448,740,508,292,0.91383094,20,,2,1.2916666666666667,
155,2,car,crv,111,1317,390,811,1206,421,0.2941505,20,,2,0.3490878938640133,
156,2,car,crv,247,756,446,741,509,295,0.96245986,20,,2,0.3490878938640133,
157,2,car,crv,134,1300,387,818,1166,431,0.35928637,20,,2,1.28,
158,2,car,crv,251,757,447,743,506,296,0.9412378,20,,2,1.28,
159,2,car,crv,126,1312,388,815,1186,427,0.3965622,20,,2,1.24,
160,2,car,crv,252,758,446,743,506,297,0.9420341,20,,2,1.24,
161,2,car,crv,121,1316,389,809,1195,420,0.4096516,20,,2,1.24,
162,2,car,crv,244,761,447,742,517,295,0.9289579,20,,2,1.24,
163,2,car,crv,125,1312,392,805,1187,413,0.30284005,20,,2,1.24,
164,2,car,crv,245,760,447,739,515,292,0.9596912,20,,2,1.24,
165,2,car,crv,131,1307,388,812,1176,424,0.43397242,20,,2,1.2916666666666667,
166,2,car,crv,247,764,447,744,517,297,0.9014591,20,,2,1.2916666666666667,
167,2,car,crv,123,1315,388,811,1192,423,0.4968379,20,,2,1.24,
168,2,car,crv,246,758,446,743,512,297,0.87933147,20,,2,1.24,
169,2,car,crv,118,1312,389,813,1194,424,0.25691053,20,,2,0.35510887772194305,
170,2,car,crv,249,756,447,742,507,295,0.96910256,20,,2,0.35510887772194305,
171,2,car,crv,118,1319,389,813,1201,424,0.4023961,20,,2,1.28,
172,2,car,crv,243,757,448,743,514,295,0.94143236,20,,2,1.28,
173,2,car,crv,119,1322,385,815,1203,430,0.42900166,20,,2,1.24,
174,2,car,crv,246,762,447,741,516,294,0.790523,20,,2,1.24,
175,2,car,crv,119,1319,386,815,1200,429,0.44753623,20,,2,1.28,
176,2,car,crv,248,759,450,741,511,291,0.8263495,20,,2,1.28,
177,2,car,crv,114,1318,387,813,1204,426,0.43434885,20,,2,1.2916666666666667,
178,2,car,crv,246,759,446,744,513,298,0.9186257,20,,2,1.2916666666666667,
179,2,car,crv,119,1325,389,808,1206,419,0.46840343,20,,2,1.24,
180,2,car,crv,244,759,447,741,515,294,0.83414143,20,,2,1.24,
181,2,car,crv,116,1322,388,811,1206,423,0.44209528,20,,2,1.28,
182,2,car,crv,241,764,450,741,523,291,0.8834957,20,,2,1.28,
183,2,car,crv,334,710,446,701,376,255,0.92716336,3,0,2,0.6781914893617021,
184,2,car,crv,336,711,446,700,375,254,0.9036748,3,0,2,0.6773333333333333,
185,2,car,crv,335,709,444,701,374,257,0.9452533,3,0,2,0.6871657754010695,
0,2,car,crv,121,1313,388,819,1192,431,0.3470766,20,,2,1.25,
1,2,car,crv,242,759,447,738,517,291,0.95671165,20,,2,1.25,
2,2,car,crv,119,1305,388,818,1186,430,0.24092749,20,,2,0.3625632377740304,
3,2,car,crv,251,757,445,745,506,300,0.9550495,20,,2,0.3625632377740304,
4,2,car,crv,121,1309,389,816,1188,427,0.2116592,20,,2,0.35942760942760943,
5,2,car,crv,249,759,445,743,510,298,0.9460417,20,,2,0.35942760942760943,
6,2,car,crv,118,1319,389,817,1201,428,0.37113744,20,,2,1.2916666666666667,
7,2,car,crv,247,758,450,737,511,287,0.9113323,20,,2,1.2916666666666667,
8,2,car,crv,123,1308,390,814,1185,424,0.3166677,20,,2,1.24,
9,2,car,crv,247,758,447,742,511,295,0.9435399,20,,2,1.24,
10,2,car,crv,120,1318,392,810,1198,418,0.37392586,20,,2,1.2916666666666667,
11,2,car,crv,248,758,450,739,510,289,0.9237008,20,,2,1.2916666666666667,
12,2,car,crv,110,1316,390,815,1206,425,0.20233919,20,,2,0.3524046434494196,
13,2,car,crv,250,753,447,736,503,289,0.9751715,20,,2,0.3524046434494196,
14,2,car,crv,129,1310,386,816,1181,430,0.3428058,20,,2,1.2916666666666667,
15,2,car,crv,247,760,447,740,513,293,0.8918332,20,,2,1.2916666666666667,
16,2,car,crv,122,1317,391,811,1195,420,0.44330603,20,,2,1.24,
17,2,car,crv,243,763,449,737,520,288,0.921945,20,,2,1.24,
18,2,car,crv,120,1307,387,819,1187,432,0.29826218,20,,2,0.36394271272114576,
19,2,car,crv,251,756,446,743,505,297,0.96940076,20,,2,0.36394271272114576,
20,2,car,crv,129,1303,385,817,1174,432,0.33652014,20,,2,1.25,
21,2,car,crv,247,762,444,744,515,300,0.95280766,20,,2,1.25,
22,2,car,crv,121,1309,390,816,1188,426,0.26945764,20,,2,0.35858585858585856,
23,2,car,crv,250,755,447,742,505,295,0.97232443,20,,2,0.35858585858585856,
24,2,car,crv,118,1317,389,817,1199,428,0.40577245,20,,2,1.2916666666666667,
25,2,car,crv,250,758,446,743,508,297,0.94312155,20,,2,1.2916666666666667,
26,2,car,crv,121,1303,387,817,1182,430,0.23037793,20,,2,0.3637901861252115,
27,2,car,crv,250,752,444,747,502,303,0.973318,20,,2,0.3637901861252115,
28,2,car,crv,129,1309,395,806,1180,411,0.31128713,20,,2,0.3483050847457627,
29,2,car,crv,248,761,449,740,513,291,0.95252526,20,,2,0.3483050847457627,
30,2,car,crv,121,1303,389,815,1182,426,0.23151965,20,,2,0.3604060913705584,
31,2,car,crv,245,754,445,744,509,299,0.9742757,20,,2,0.3604060913705584,
32,2,car,crv,124,1302,388,819,1178,431,0.20558608,20,,2,0.36587436332767403,
33,2,car,crv,252,759,447,740,507,293,0.971343,20,,2,0.36587436332767403,
34,2,car,crv,120,1318,389,815,1198,426,0.37832162,20,,2,1.24,
35,2,car,crv,248,758,449,738,510,289,0.9015974,20,,2,1.24,
36,2,car,crv,123,1313,389,813,1190,424,0.38111085,20,,2,1.24,
37,2,car,crv,247,755,446,744,508,298,0.8986612,20,,2,1.24,
38,2,car,crv,117,1315,387,816,1198,429,0.4219676,20,,2,1.2307692307692308,
39,2,car,crv,251,757,449,740,506,291,0.9306962,20,,2,1.2307692307692308,
40,2,car,crv,119,1318,391,816,1199,425,0.41724253,20,,2,1.3333333333333333,
41,2,car,crv,247,759,447,741,512,294,0.9398525,20,,2,1.3333333333333333,
42,2,car,crv,128,1307,392,813,1179,421,0.25620303,20,,2,0.3570822731128075,
43,2,car,crv,251,756,447,741,505,294,0.9512551,20,,2,0.3570822731128075,
44,2,car,crv,119,1314,386,816,1195,430,0.45291424,20,,2,1.2916666666666667,
45,2,car,crv,250,759,449,744,509,295,0.90196574,20,,2,1.2916666666666667,
46,2,car,crv,126,1304,388,820,1178,432,0.2519957,20,,2,0.366723259762309,
47,2,car,crv,253,757,448,737,504,289,0.9349736,20,,2,0.366723259762309,
48,2,car,crv,122,1317,387,818,1195,431,0.38155946,20,,2,1.24,
49,2,car,crv,248,756,447,743,508,296,0.9098617,20,,2,1.24,
50,2,car,crv,120,1319,389,808,1199,419,0.49123806,20,,2,1.24,
51,2,car,crv,241,764,446,743,523,297,0.8688812,20,,2,1.24,
52,2,car,crv,251,754,448,736,503,288,0.9627608,20,,2,1.28,
53,2,car,crv,114,1312,387,822,1198,435,0.2406673,20,,2,0.3631051752921536,
54,2,car,crv,253,758,447,739,505,292,0.9361756,20,,2,0.3631051752921536,
55,2,car,crv,121,1313,387,820,1192,433,0.26400292,20,,2,1.24,
56,2,car,crv,246,754,446,742,508,296,0.95298326,20,,2,1.24,
57,2,car,crv,131,1305,389,817,1174,428,0.29075116,20,,2,0.3645655877342419,
58,2,car,crv,252,754,448,743,502,295,0.94248277,20,,2,0.3645655877342419,
59,2,car,crv,130,1307,389,819,1177,430,0.2569041,20,,2,1.24,
60,2,car,crv,256,753,448,740,497,292,0.955823,20,,2,1.24,
61,2,car,crv,127,1305,390,811,1178,421,0.25976446,20,,2,0.35738539898132426,
62,2,car,crv,250,757,443,743,507,300,0.9547171,20,,2,0.35738539898132426,
63,2,car,crv,123,1309,392,810,1186,418,0.28978387,20,,2,1.24,
64,2,car,crv,248,758,446,738,510,292,0.96847486,20,,2,1.24,
65,2,car,crv,123,1304,388,814,1181,426,0.2588897,20,,2,0.3607112616426757,
66,2,car,crv,250,759,447,742,509,295,0.9416412,20,,2,0.3607112616426757,
67,2,car,crv,130,1306,391,810,1176,419,0.26097575,20,,2,0.3562925170068027,
68,2,car,crv,250,756,447,739,506,292,0.95065075,20,,2,0.3562925170068027,
69,2,car,crv,123,1309,389,813,1186,424,0.31858423,20,,2,1.24,
70,2,car,crv,248,758,447,745,510,298,0.9534346,20,,2,1.24,
71,2,car,crv,121,1305,386,819,1184,433,0.24762785,20,,2,0.3657094594594595,
72,2,car,crv,248,759,448,745,511,297,0.96054053,20,,2,0.3657094594594595,
73,2,car,crv,251,754,443,743,503,300,0.96310854,20,,2,1.24,
74,2,car,crv,117,1318,387,822,1201,435,0.42310923,20,,2,1.2916666666666667,
75,2,car,crv,248,763,450,742,515,292,0.92204607,20,,2,1.2916666666666667,
76,2,car,crv,119,1311,391,813,1192,422,0.25885653,20,,2,1.25,
77,2,car,crv,246,752,446,739,506,293,0.95473194,20,,2,1.25,
78,2,car,crv,128,1304,388,815,1176,427,0.30647025,20,,2,1.28,
79,2,car,crv,251,758,443,746,507,303,0.93285924,20,,2,1.28,
80,2,car,crv,250,754,447,738,504,291,0.9767751,20,,2,1.24,
81,2,car,crv,109,1318,388,813,1209,425,0.32027155,20,,2,1.28,
82,2,car,crv,245,760,445,741,515,296,0.9680706,20,,2,1.28,
83,2,car,crv,127,1308,391,816,1181,425,0.2964813,20,,2,1.2916666666666667,
84,2,car,crv,250,757,447,742,507,295,0.9490655,20,,2,1.2916666666666667,
85,2,car,crv,125,1314,388,816,1189,428,0.42268884,20,,2,1.28,
86,2,car,crv,248,760,449,737,512,288,0.90941703,20,,2,1.28,
87,2,car,crv,129,1304,390,814,1175,424,0.26254445,20,,2,1.2916666666666667,
88,2,car,crv,252,755,447,740,503,293,0.94612926,20,,2,1.2916666666666667,
89,2,car,crv,114,1320,387,815,1206,428,0.30274954,20,,2,1.24,
90,2,car,crv,248,753,446,740,505,294,0.8954264,20,,2,1.24,
91,2,car,crv,127,1307,391,814,1180,423,0.278648,20,,2,0.35847457627118645,
92,2,car,crv,250,755,447,744,505,297,0.95984495,20,,2,0.35847457627118645,
93,2,car,crv,127,1302,386,816,1175,430,0.37110242,20,,2,1.28,
94,2,car,crv,246,757,444,747,511,303,0.96607155,20,,2,1.28,
95,2,car,crv,119,1307,387,816,1188,429,0.28644451,20,,2,0.3611111111111111,
96,2,car,crv,248,759,443,747,511,304,0.9593547,20,,2,0.3611111111111111,
97,2,car,crv,127,1306,389,820,1179,431,0.37050778,20,,2,1.24,
98,2,car,crv,252,758,449,742,506,293,0.9203835,20,,2,1.24,
99,2,car,crv,126,1306,387,819,1180,432,0.24266188,20,,2,0.36610169491525424,
100,2,car,crv,247,754,449,740,507,291,0.94762105,20,,2,0.36610169491525424,
101,2,car,crv,113,1317,388,815,1204,427,0.36209753,20,,2,1.24,
102,2,car,crv,247,755,446,738,508,292,0.93217456,20,,2,1.24,
103,2,car,crv,116,1312,386,813,1196,427,0.26130736,20,,2,0.35702341137123744,
104,2,car,crv,249,755,445,740,506,295,0.95275867,20,,2,0.35702341137123744,
105,2,car,crv,250,753,445,746,503,301,0.97777426,20,,2,1.24,
106,2,car,crv,117,1316,390,813,1199,423,0.30318785,20,,2,0.35279399499582986,
107,2,car,crv,239,759,447,740,520,293,0.956478,20,,2,0.35279399499582986,
108,2,car,crv,126,1307,387,813,1181,426,0.3400013,20,,2,1.24,
109,2,car,crv,250,757,446,745,507,299,0.93553233,20,,2,1.24,
110,2,car,crv,118,1316,385,817,1198,432,0.46192503,20,,2,1.24,
111,2,car,crv,242,760,449,744,518,295,0.9251644,20,,2,1.24,
112,2,car,crv,125,1310,389,811,1185,422,0.32076746,20,,2,0.3561181434599156,
113,2,car,crv,250,758,446,739,508,293,0.9462212,20,,2,0.3561181434599156,
114,2,car,crv,250,754,444,740,504,296,0.96969557,20,,2,1.24,
115,2,car,crv,113,1313,388,814,1200,426,0.2754978,20,,2,1.24,
116,2,car,crv,244,756,445,743,512,298,0.96916515,20,,2,1.24,
117,2,car,crv,123,1309,388,814,1186,426,0.2760011,20,,2,1.24,
118,2,car,crv,249,758,446,740,509,294,0.950518,20,,2,1.24,
119,2,car,crv,253,754,447,737,501,290,0.94723046,20,,2,1.24,
120,2,car,crv,121,1308,387,817,1187,430,0.21458383,20,,2,0.36225779275484415,
121,2,car,crv,250,754,447,740,504,293,0.9610552,20,,2,0.36225779275484415,
122,2,car,crv,119,1317,388,814,1198,426,0.4732625,20,,2,1.24,
123,2,car,crv,245,758,448,742,513,294,0.94409996,20,,2,1.24,
124,2,car,crv,121,1308,388,815,1187,427,0.21448645,20,,2,0.35973041280539175,
125,2,car,crv,249,753,445,746,504,301,0.9724925,20,,2,0.35973041280539175,
126,2,car,crv,135,1302,387,821,1167,434,0.35179994,20,,2,1.2916666666666667,
127,2,car,crv,250,760,450,741,510,291,0.8736024,20,,2,1.2916666666666667,
128,2,car,crv,117,1313,390,812,1196,422,0.32242462,20,,2,1.2916666666666667,
129,2,car,crv,243,759,447,742,516,295,0.9675998,20,,2,1.2916666666666667,
130,2,car,crv,122,1311,387,814,1189,427,0.36553156,20,,2,1.2916666666666667,
131,2,car,crv,250,757,444,744,507,300,0.9479286,20,,2,1.2916666666666667,
132,2,car,crv,115,1321,388,815,1206,427,0.3674716,20,,2,1.24,
133,2,car,crv,248,756,446,740,508,294,0.92142504,20,,2,1.24,
134,2,car,crv,109,1315,384,827,1206,443,0.2820505,20,,2,1.24,
135,2,car,crv,249,758,449,736,509,287,0.91024953,20,,2,1.24,
136,2,car,crv,122,1310,388,817,1188,429,0.29904467,20,,2,0.3611111111111111,
137,2,car,crv,250,760,448,741,510,293,0.927252,20,,2,0.3611111111111111,
138,2,car,crv,129,1303,389,814,1174,425,0.27334884,20,,2,1.28,
139,2,car,crv,247,760,448,741,513,293,0.9333165,20,,2,1.28,
140,2,car,crv,122,1311,385,813,1189,428,0.35830083,20,,2,1.24,
141,2,car,crv,246,757,442,746,511,304,0.9668414,20,,2,1.24,
142,2,car,crv,122,1312,391,808,1190,417,0.34383425,20,,2,1.28,
143,2,car,crv,248,755,446,741,507,295,0.90284395,20,,2,1.28,
144,2,car,crv,129,1303,386,819,1174,433,0.2341652,20,,2,0.368824531516184,
145,2,car,crv,252,756,447,744,504,297,0.9354642,20,,2,0.368824531516184,
146,2,car,crv,253,756,446,744,503,298,0.97629297,20,,2,1.24,
147,2,car,crv,128,1307,388,817,1179,429,0.32914877,20,,2,1.2916666666666667,
148,2,car,crv,247,762,447,741,515,294,0.9441378,20,,2,1.2916666666666667,
149,2,car,crv,117,1313,388,818,1196,430,0.27251616,20,,2,0.3595317725752508,
150,2,car,crv,247,762,449,740,515,291,0.96550846,20,,2,0.3595317725752508,
151,2,car,crv,124,1305,387,820,1181,433,0.27402008,20,,2,0.36663844199830653,
152,2,car,crv,252,750,447,746,498,299,0.9501165,20,,2,0.36663844199830653,
153,2,car,crv,111,1317,390,812,1206,422,0.27479288,20,,2,0.34991708126036486,
154,2,car,crv,251,753,447,740,502,293,0.9438285,20,,2,0.34991708126036486,
155,2,car,crv,126,1309,390,814,1183,424,0.30222148,20,,2,1.2916666666666667,
156,2,car,crv,249,757,448,740,508,292,0.91383094,20,,2,1.2916666666666667,
157,2,car,crv,111,1317,390,811,1206,421,0.2941505,20,,2,0.3490878938640133,
158,2,car,crv,247,756,446,741,509,295,0.96245986,20,,2,0.3490878938640133,
159,2,car,crv,134,1300,387,818,1166,431,0.35928637,20,,2,1.28,
160,2,car,crv,251,757,447,743,506,296,0.9412378,20,,2,1.28,
161,2,car,crv,126,1312,388,815,1186,427,0.3965622,20,,2,1.24,
162,2,car,crv,252,758,446,743,506,297,0.9420341,20,,2,1.24,
163,2,car,crv,121,1316,389,809,1195,420,0.4096516,20,,2,1.24,
164,2,car,crv,244,761,447,742,517,295,0.9289579,20,,2,1.24,
165,2,car,crv,125,1312,392,805,1187,413,0.30284005,20,,2,1.24,
166,2,car,crv,245,760,447,739,515,292,0.9596912,20,,2,1.24,
167,2,car,crv,131,1307,388,812,1176,424,0.43397242,20,,2,1.2916666666666667,
168,2,car,crv,247,764,447,744,517,297,0.9014591,20,,2,1.2916666666666667,
169,2,car,crv,123,1315,388,811,1192,423,0.4968379,20,,2,1.24,
170,2,car,crv,246,758,446,743,512,297,0.87933147,20,,2,1.24,
171,2,car,crv,118,1312,389,813,1194,424,0.25691053,20,,2,0.35510887772194305,
172,2,car,crv,249,756,447,742,507,295,0.96910256,20,,2,0.35510887772194305,
173,2,car,crv,118,1319,389,813,1201,424,0.4023961,20,,2,1.28,
174,2,car,crv,243,757,448,743,514,295,0.94143236,20,,2,1.28,
175,2,car,crv,119,1322,385,815,1203,430,0.42900166,20,,2,1.24,
176,2,car,crv,246,762,447,741,516,294,0.790523,20,,2,1.24,
177,2,car,crv,119,1319,386,815,1200,429,0.44753623,20,,2,1.28,
178,2,car,crv,248,759,450,741,511,291,0.8263495,20,,2,1.28,
179,2,car,crv,114,1318,387,813,1204,426,0.43434885,20,,2,1.2916666666666667,
180,2,car,crv,246,759,446,744,513,298,0.9186257,20,,2,1.2916666666666667,
181,2,car,crv,119,1325,389,808,1206,419,0.46840343,20,,2,1.24,
182,2,car,crv,244,759,447,741,515,294,0.83414143,20,,2,1.24,
183,2,car,crv,116,1322,388,811,1206,423,0.44209528,20,,2,1.28,
184,2,car,crv,241,764,450,741,523,291,0.8834957,20,,2,1.28,
185,2,car,crv,334,710,446,701,376,255,0.92716336,3,0,2,0.6781914893617021,
186,2,car,crv,336,711,446,700,375,254,0.9036748,3,0,2,0.6773333333333333,
187,2,car,crv,335,709,444,701,374,257,0.9452533,3,0,2,0.6871657754010695,
0,2,car,crv,131,1307,390,815,1176,425,0.34321743,20,,2,1.25,
1,2,car,crv,249,755,445,742,506,297,0.95228106,20,,2,1.25,
2,2,car,crv,121,1313,388,819,1192,431,0.3470766,20,,2,1.25,
3,2,car,crv,242,759,447,738,517,291,0.95671165,20,,2,1.25,
4,2,car,crv,119,1305,388,818,1186,430,0.24092749,20,,2,0.3625632377740304,
5,2,car,crv,251,757,445,745,506,300,0.9550495,20,,2,0.3625632377740304,
6,2,car,crv,121,1309,389,816,1188,427,0.2116592,20,,2,0.35942760942760943,
7,2,car,crv,249,759,445,743,510,298,0.9460417,20,,2,0.35942760942760943,
8,2,car,crv,118,1319,389,817,1201,428,0.37113744,20,,2,1.2916666666666667,
9,2,car,crv,247,758,450,737,511,287,0.9113323,20,,2,1.2916666666666667,
10,2,car,crv,123,1308,390,814,1185,424,0.3166677,20,,2,1.24,
11,2,car,crv,247,758,447,742,511,295,0.9435399,20,,2,1.24,
12,2,car,crv,120,1318,392,810,1198,418,0.37392586,20,,2,1.2916666666666667,
13,2,car,crv,248,758,450,739,510,289,0.9237008,20,,2,1.2916666666666667,
14,2,car,crv,110,1316,390,815,1206,425,0.20233919,20,,2,0.3524046434494196,
15,2,car,crv,250,753,447,736,503,289,0.9751715,20,,2,0.3524046434494196,
16,2,car,crv,129,1310,386,816,1181,430,0.3428058,20,,2,1.2916666666666667,
17,2,car,crv,247,760,447,740,513,293,0.8918332,20,,2,1.2916666666666667,
18,2,car,crv,122,1317,391,811,1195,420,0.44330603,20,,2,1.24,
19,2,car,crv,243,763,449,737,520,288,0.921945,20,,2,1.24,
20,2,car,crv,120,1307,387,819,1187,432,0.29826218,20,,2,0.36394271272114576,
21,2,car,crv,251,756,446,743,505,297,0.96940076,20,,2,0.36394271272114576,
22,2,car,crv,129,1303,385,817,1174,432,0.33652014,20,,2,1.25,
23,2,car,crv,247,762,444,744,515,300,0.95280766,20,,2,1.25,
24,2,car,crv,121,1309,390,816,1188,426,0.26945764,20,,2,0.35858585858585856,
25,2,car,crv,250,755,447,742,505,295,0.97232443,20,,2,0.35858585858585856,
26,2,car,crv,118,1317,389,817,1199,428,0.40577245,20,,2,1.2916666666666667,
27,2,car,crv,250,758,446,743,508,297,0.94312155,20,,2,1.2916666666666667,
28,2,car,crv,121,1303,387,817,1182,430,0.23037793,20,,2,0.3637901861252115,
29,2,car,crv,250,752,444,747,502,303,0.973318,20,,2,0.3637901861252115,
30,2,car,crv,129,1309,395,806,1180,411,0.31128713,20,,2,0.3483050847457627,
31,2,car,crv,248,761,449,740,513,291,0.95252526,20,,2,0.3483050847457627,
32,2,car,crv,121,1303,389,815,1182,426,0.23151965,20,,2,0.3604060913705584,
33,2,car,crv,245,754,445,744,509,299,0.9742757,20,,2,0.3604060913705584,
34,2,car,crv,124,1302,388,819,1178,431,0.20558608,20,,2,0.36587436332767403,
35,2,car,crv,252,759,447,740,507,293,0.971343,20,,2,0.36587436332767403,
36,2,car,crv,120,1318,389,815,1198,426,0.37832162,20,,2,1.24,
37,2,car,crv,248,758,449,738,510,289,0.9015974,20,,2,1.24,
38,2,car,crv,123,1313,389,813,1190,424,0.38111085,20,,2,1.24,
39,2,car,crv,247,755,446,744,508,298,0.8986612,20,,2,1.24,
40,2,car,crv,117,1315,387,816,1198,429,0.4219676,20,,2,1.2307692307692308,
41,2,car,crv,251,757,449,740,506,291,0.9306962,20,,2,1.2307692307692308,
42,2,car,crv,119,1318,391,816,1199,425,0.41724253,20,,2,1.3333333333333333,
43,2,car,crv,247,759,447,741,512,294,0.9398525,20,,2,1.3333333333333333,
44,2,car,crv,128,1307,392,813,1179,421,0.25620303,20,,2,0.3570822731128075,
45,2,car,crv,251,756,447,741,505,294,0.9512551,20,,2,0.3570822731128075,
46,2,car,crv,119,1314,386,816,1195,430,0.45291424,20,,2,1.2916666666666667,
47,2,car,crv,250,759,449,744,509,295,0.90196574,20,,2,1.2916666666666667,
48,2,car,crv,126,1304,388,820,1178,432,0.2519957,20,,2,0.366723259762309,
49,2,car,crv,253,757,448,737,504,289,0.9349736,20,,2,0.366723259762309,
50,2,car,crv,122,1317,387,818,1195,431,0.38155946,20,,2,1.24,
51,2,car,crv,248,756,447,743,508,296,0.9098617,20,,2,1.24,
52,2,car,crv,120,1319,389,808,1199,419,0.49123806,20,,2,1.24,
53,2,car,crv,241,764,446,743,523,297,0.8688812,20,,2,1.24,
54,2,car,crv,251,754,448,736,503,288,0.9627608,20,,2,1.28,
55,2,car,crv,114,1312,387,822,1198,435,0.2406673,20,,2,0.3631051752921536,
56,2,car,crv,253,758,447,739,505,292,0.9361756,20,,2,0.3631051752921536,
57,2,car,crv,121,1313,387,820,1192,433,0.26400292,20,,2,1.24,
58,2,car,crv,246,754,446,742,508,296,0.95298326,20,,2,1.24,
59,2,car,crv,131,1305,389,817,1174,428,0.29075116,20,,2,0.3645655877342419,
60,2,car,crv,252,754,448,743,502,295,0.94248277,20,,2,0.3645655877342419,
61,2,car,crv,130,1307,389,819,1177,430,0.2569041,20,,2,1.24,
62,2,car,crv,256,753,448,740,497,292,0.955823,20,,2,1.24,
63,2,car,crv,127,1305,390,811,1178,421,0.25976446,20,,2,0.35738539898132426,
64,2,car,crv,250,757,443,743,507,300,0.9547171,20,,2,0.35738539898132426,
65,2,car,crv,123,1309,392,810,1186,418,0.28978387,20,,2,1.24,
66,2,car,crv,248,758,446,738,510,292,0.96847486,20,,2,1.24,
67,2,car,crv,123,1304,388,814,1181,426,0.2588897,20,,2,0.3607112616426757,
68,2,car,crv,250,759,447,742,509,295,0.9416412,20,,2,0.3607112616426757,
69,2,car,crv,130,1306,391,810,1176,419,0.26097575,20,,2,0.3562925170068027,
70,2,car,crv,250,756,447,739,506,292,0.95065075,20,,2,0.3562925170068027,
71,2,car,crv,123,1309,389,813,1186,424,0.31858423,20,,2,1.24,
72,2,car,crv,248,758,447,745,510,298,0.9534346,20,,2,1.24,
73,2,car,crv,121,1305,386,819,1184,433,0.24762785,20,,2,0.3657094594594595,
74,2,car,crv,248,759,448,745,511,297,0.96054053,20,,2,0.3657094594594595,
75,2,car,crv,251,754,443,743,503,300,0.96310854,20,,2,1.24,
76,2,car,crv,117,1318,387,822,1201,435,0.42310923,20,,2,1.2916666666666667,
77,2,car,crv,248,763,450,742,515,292,0.92204607,20,,2,1.2916666666666667,
78,2,car,crv,119,1311,391,813,1192,422,0.25885653,20,,2,1.25,
79,2,car,crv,246,752,446,739,506,293,0.95473194,20,,2,1.25,
80,2,car,crv,128,1304,388,815,1176,427,0.30647025,20,,2,1.28,
81,2,car,crv,251,758,443,746,507,303,0.93285924,20,,2,1.28,
82,2,car,crv,250,754,447,738,504,291,0.9767751,20,,2,1.24,
83,2,car,crv,109,1318,388,813,1209,425,0.32027155,20,,2,1.28,
84,2,car,crv,245,760,445,741,515,296,0.9680706,20,,2,1.28,
85,2,car,crv,127,1308,391,816,1181,425,0.2964813,20,,2,1.2916666666666667,
86,2,car,crv,250,757,447,742,507,295,0.9490655,20,,2,1.2916666666666667,
87,2,car,crv,125,1314,388,816,1189,428,0.42268884,20,,2,1.28,
88,2,car,crv,248,760,449,737,512,288,0.90941703,20,,2,1.28,
89,2,car,crv,129,1304,390,814,1175,424,0.26254445,20,,2,1.2916666666666667,
90,2,car,crv,252,755,447,740,503,293,0.94612926,20,,2,1.2916666666666667,
91,2,car,crv,114,1320,387,815,1206,428,0.30274954,20,,2,1.24,
92,2,car,crv,248,753,446,740,505,294,0.8954264,20,,2,1.24,
93,2,car,crv,127,1307,391,814,1180,423,0.278648,20,,2,0.35847457627118645,
94,2,car,crv,250,755,447,744,505,297,0.95984495,20,,2,0.35847457627118645,
95,2,car,crv,127,1302,386,816,1175,430,0.37110242,20,,2,1.28,
96,2,car,crv,246,757,444,747,511,303,0.96607155,20,,2,1.28,
97,2,car,crv,119,1307,387,816,1188,429,0.28644451,20,,2,0.3611111111111111,
98,2,car,crv,248,759,443,747,511,304,0.9593547,20,,2,0.3611111111111111,
99,2,car,crv,127,1306,389,820,1179,431,0.37050778,20,,2,1.24,
100,2,car,crv,252,758,449,742,506,293,0.9203835,20,,2,1.24,
101,2,car,crv,126,1306,387,819,1180,432,0.24266188,20,,2,0.36610169491525424,
102,2,car,crv,247,754,449,740,507,291,0.94762105,20,,2,0.36610169491525424,
103,2,car,crv,113,1317,388,815,1204,427,0.36209753,20,,2,1.24,
104,2,car,crv,247,755,446,738,508,292,0.93217456,20,,2,1.24,
105,2,car,crv,116,1312,386,813,1196,427,0.26130736,20,,2,0.35702341137123744,
106,2,car,crv,249,755,445,740,506,295,0.95275867,20,,2,0.35702341137123744,
107,2,car,crv,250,753,445,746,503,301,0.97777426,20,,2,1.24,
108,2,car,crv,117,1316,390,813,1199,423,0.30318785,20,,2,0.35279399499582986,
109,2,car,crv,239,759,447,740,520,293,0.956478,20,,2,0.35279399499582986,
110,2,car,crv,126,1307,387,813,1181,426,0.3400013,20,,2,1.24,
111,2,car,crv,250,757,446,745,507,299,0.93553233,20,,2,1.24,
112,2,car,crv,118,1316,385,817,1198,432,0.46192503,20,,2,1.24,
113,2,car,crv,242,760,449,744,518,295,0.9251644,20,,2,1.24,
114,2,car,crv,125,1310,389,811,1185,422,0.32076746,20,,2,0.3561181434599156,
115,2,car,crv,250,758,446,739,508,293,0.9462212,20,,2,0.3561181434599156,
116,2,car,crv,250,754,444,740,504,296,0.96969557,20,,2,1.24,
117,2,car,crv,113,1313,388,814,1200,426,0.2754978,20,,2,1.24,
118,2,car,crv,244,756,445,743,512,298,0.96916515,20,,2,1.24,
119,2,car,crv,123,1309,388,814,1186,426,0.2760011,20,,2,1.24,
120,2,car,crv,249,758,446,740,509,294,0.950518,20,,2,1.24,
121,2,car,crv,253,754,447,737,501,290,0.94723046,20,,2,1.24,
122,2,car,crv,121,1308,387,817,1187,430,0.21458383,20,,2,0.36225779275484415,
123,2,car,crv,250,754,447,740,504,293,0.9610552,20,,2,0.36225779275484415,
124,2,car,crv,119,1317,388,814,1198,426,0.4732625,20,,2,1.24,
125,2,car,crv,245,758,448,742,513,294,0.94409996,20,,2,1.24,
126,2,car,crv,121,1308,388,815,1187,427,0.21448645,20,,2,0.35973041280539175,
127,2,car,crv,249,753,445,746,504,301,0.9724925,20,,2,0.35973041280539175,
128,2,car,crv,135,1302,387,821,1167,434,0.35179994,20,,2,1.2916666666666667,
129,2,car,crv,250,760,450,741,510,291,0.8736024,20,,2,1.2916666666666667,
130,2,car,crv,117,1313,390,812,1196,422,0.32242462,20,,2,1.2916666666666667,
131,2,car,crv,243,759,447,742,516,295,0.9675998,20,,2,1.2916666666666667,
132,2,car,crv,122,1311,387,814,1189,427,0.36553156,20,,2,1.2916666666666667,
133,2,car,crv,250,757,444,744,507,300,0.9479286,20,,2,1.2916666666666667,
134,2,car,crv,115,1321,388,815,1206,427,0.3674716,20,,2,1.24,
135,2,car,crv,248,756,446,740,508,294,0.92142504,20,,2,1.24,
136,2,car,crv,109,1315,384,827,1206,443,0.2820505,20,,2,1.24,
137,2,car,crv,249,758,449,736,509,287,0.91024953,20,,2,1.24,
138,2,car,crv,122,1310,388,817,1188,429,0.29904467,20,,2,0.3611111111111111,
139,2,car,crv,250,760,448,741,510,293,0.927252,20,,2,0.3611111111111111,
140,2,car,crv,129,1303,389,814,1174,425,0.27334884,20,,2,1.28,
141,2,car,crv,247,760,448,741,513,293,0.9333165,20,,2,1.28,
142,2,car,crv,122,1311,385,813,1189,428,0.35830083,20,,2,1.24,
143,2,car,crv,246,757,442,746,511,304,0.9668414,20,,2,1.24,
144,2,car,crv,122,1312,391,808,1190,417,0.34383425,20,,2,1.28,
145,2,car,crv,248,755,446,741,507,295,0.90284395,20,,2,1.28,
146,2,car,crv,129,1303,386,819,1174,433,0.2341652,20,,2,0.368824531516184,
147,2,car,crv,252,756,447,744,504,297,0.9354642,20,,2,0.368824531516184,
148,2,car,crv,253,756,446,744,503,298,0.97629297,20,,2,1.24,
149,2,car,crv,128,1307,388,817,1179,429,0.32914877,20,,2,1.2916666666666667,
150,2,car,crv,247,762,447,741,515,294,0.9441378,20,,2,1.2916666666666667,
151,2,car,crv,117,1313,388,818,1196,430,0.27251616,20,,2,0.3595317725752508,
152,2,car,crv,247,762,449,740,515,291,0.96550846,20,,2,0.3595317725752508,
153,2,car,crv,124,1305,387,820,1181,433,0.27402008,20,,2,0.36663844199830653,
154,2,car,crv,252,750,447,746,498,299,0.9501165,20,,2,0.36663844199830653,
155,2,car,crv,111,1317,390,812,1206,422,0.27479288,20,,2,0.34991708126036486,
156,2,car,crv,251,753,447,740,502,293,0.9438285,20,,2,0.34991708126036486,
157,2,car,crv,126,1309,390,814,1183,424,0.30222148,20,,2,1.2916666666666667,
158,2,car,crv,249,757,448,740,508,292,0.91383094,20,,2,1.2916666666666667,
159,2,car,crv,111,1317,390,811,1206,421,0.2941505,20,,2,0.3490878938640133,
160,2,car,crv,247,756,446,741,509,295,0.96245986,20,,2,0.3490878938640133,
161,2,car,crv,134,1300,387,818,1166,431,0.35928637,20,,2,1.28,
162,2,car,crv,251,757,447,743,506,296,0.9412378,20,,2,1.28,
163,2,car,crv,126,1312,388,815,1186,427,0.3965622,20,,2,1.24,
164,2,car,crv,252,758,446,743,506,297,0.9420341,20,,2,1.24,
165,2,car,crv,121,1316,389,809,1195,420,0.4096516,20,,2,1.24,
166,2,car,crv,244,761,447,742,517,295,0.9289579,20,,2,1.24,
167,2,car,crv,125,1312,392,805,1187,413,0.30284005,20,,2,1.24,
168,2,car,crv,245,760,447,739,515,292,0.9596912,20,,2,1.24,
169,2,car,crv,131,1307,388,812,1176,424,0.43397242,20,,2,1.2916666666666667,
170,2,car,crv,247,764,447,744,517,297,0.9014591,20,,2,1.2916666666666667,
171,2,car,crv,123,1315,388,811,1192,423,0.4968379,20,,2,1.24,
172,2,car,crv,246,758,446,743,512,297,0.87933147,20,,2,1.24,
173,2,car,crv,118,1312,389,813,1194,424,0.25691053,20,,2,0.35510887772194305,
174,2,car,crv,249,756,447,742,507,295,0.96910256,20,,2,0.35510887772194305,
175,2,car,crv,118,1319,389,813,1201,424,0.4023961,20,,2,1.28,
176,2,car,crv,243,757,448,743,514,295,0.94143236,20,,2,1.28,
177,2,car,crv,119,1322,385,815,1203,430,0.42900166,20,,2,1.24,
178,2,car,crv,246,762,447,741,516,294,0.790523,20,,2,1.24,
179,2,car,crv,119,1319,386,815,1200,429,0.44753623,20,,2,1.28,
180,2,car,crv,248,759,450,741,511,291,0.8263495,20,,2,1.28,
181,2,car,crv,114,1318,387,813,1204,426,0.43434885,20,,2,1.2916666666666667,
182,2,car,crv,246,759,446,744,513,298,0.9186257,20,,2,1.2916666666666667,
183,2,car,crv,119,1325,389,808,1206,419,0.46840343,20,,2,1.24,
184,2,car,crv,244,759,447,741,515,294,0.83414143,20,,2,1.24,
185,2,car,crv,116,1322,388,811,1206,423,0.44209528,20,,2,1.28,
186,2,car,crv,241,764,450,741,523,291,0.8834957,20,,2,1.28,
187,2,car,crv,334,710,446,701,376,255,0.92716336,3,0,2,0.6781914893617021,
188,2,car,crv,336,711,446,700,375,254,0.9036748,3,0,2,0.6773333333333333,
189,2,car,crv,335,709,444,701,374,257,0.9452533,3,0,2,0.6871657754010695,
0,2,car,crv,121,1313,386,818,1192,432,0.34316352,20,,2,1.2916666666666667,
1,2,car,crv,242,764,447,737,522,290,0.8828646,20,,2,1.2916666666666667,
2,2,car,crv,131,1307,390,815,1176,425,0.34321743,20,,2,1.25,
3,2,car,crv,249,755,445,742,506,297,0.95228106,20,,2,1.25,
4,2,car,crv,121,1313,388,819,1192,431,0.3470766,20,,2,1.25,
5,2,car,crv,242,759,447,738,517,291,0.95671165,20,,2,1.25,
6,2,car,crv,119,1305,388,818,1186,430,0.24092749,20,,2,0.3625632377740304,
7,2,car,crv,251,757,445,745,506,300,0.9550495,20,,2,0.3625632377740304,
8,2,car,crv,121,1309,389,816,1188,427,0.2116592,20,,2,0.35942760942760943,
9,2,car,crv,249,759,445,743,510,298,0.9460417,20,,2,0.35942760942760943,
10,2,car,crv,118,1319,389,817,1201,428,0.37113744,20,,2,1.2916666666666667,
11,2,car,crv,247,758,450,737,511,287,0.9113323,20,,2,1.2916666666666667,
12,2,car,crv,123,1308,390,814,1185,424,0.3166677,20,,2,1.24,
13,2,car,crv,247,758,447,742,511,295,0.9435399,20,,2,1.24,
14,2,car,crv,120,1318,392,810,1198,418,0.37392586,20,,2,1.2916666666666667,
15,2,car,crv,248,758,450,739,510,289,0.9237008,20,,2,1.2916666666666667,
16,2,car,crv,110,1316,390,815,1206,425,0.20233919,20,,2,0.3524046434494196,
17,2,car,crv,250,753,447,736,503,289,0.9751715,20,,2,0.3524046434494196,
18,2,car,crv,129,1310,386,816,1181,430,0.3428058,20,,2,1.2916666666666667,
19,2,car,crv,247,760,447,740,513,293,0.8918332,20,,2,1.2916666666666667,
20,2,car,crv,122,1317,391,811,1195,420,0.44330603,20,,2,1.24,
21,2,car,crv,243,763,449,737,520,288,0.921945,20,,2,1.24,
22,2,car,crv,120,1307,387,819,1187,432,0.29826218,20,,2,0.36394271272114576,
23,2,car,crv,251,756,446,743,505,297,0.96940076,20,,2,0.36394271272114576,
24,2,car,crv,129,1303,385,817,1174,432,0.33652014,20,,2,1.25,
25,2,car,crv,247,762,444,744,515,300,0.95280766,20,,2,1.25,
26,2,car,crv,121,1309,390,816,1188,426,0.26945764,20,,2,0.35858585858585856,
27,2,car,crv,250,755,447,742,505,295,0.97232443,20,,2,0.35858585858585856,
28,2,car,crv,118,1317,389,817,1199,428,0.40577245,20,,2,1.2916666666666667,
29,2,car,crv,250,758,446,743,508,297,0.94312155,20,,2,1.2916666666666667,
30,2,car,crv,121,1303,387,817,1182,430,0.23037793,20,,2,0.3637901861252115,
31,2,car,crv,250,752,444,747,502,303,0.973318,20,,2,0.3637901861252115,
32,2,car,crv,129,1309,395,806,1180,411,0.31128713,20,,2,0.3483050847457627,
33,2,car,crv,248,761,449,740,513,291,0.95252526,20,,2,0.3483050847457627,
34,2,car,crv,121,1303,389,815,1182,426,0.23151965,20,,2,0.3604060913705584,
35,2,car,crv,245,754,445,744,509,299,0.9742757,20,,2,0.3604060913705584,
36,2,car,crv,124,1302,388,819,1178,431,0.20558608,20,,2,0.36587436332767403,
37,2,car,crv,252,759,447,740,507,293,0.971343,20,,2,0.36587436332767403,
38,2,car,crv,120,1318,389,815,1198,426,0.37832162,20,,2,1.24,
39,2,car,crv,248,758,449,738,510,289,0.9015974,20,,2,1.24,
40,2,car,crv,123,1313,389,813,1190,424,0.38111085,20,,2,1.24,
41,2,car,crv,247,755,446,744,508,298,0.8986612,20,,2,1.24,
42,2,car,crv,117,1315,387,816,1198,429,0.4219676,20,,2,1.2307692307692308,
43,2,car,crv,251,757,449,740,506,291,0.9306962,20,,2,1.2307692307692308,
44,2,car,crv,119,1318,391,816,1199,425,0.41724253,20,,2,1.3333333333333333,
45,2,car,crv,247,759,447,741,512,294,0.9398525,20,,2,1.3333333333333333,
46,2,car,crv,128,1307,392,813,1179,421,0.25620303,20,,2,0.3570822731128075,
47,2,car,crv,251,756,447,741,505,294,0.9512551,20,,2,0.3570822731128075,
48,2,car,crv,119,1314,386,816,1195,430,0.45291424,20,,2,1.2916666666666667,
49,2,car,crv,250,759,449,744,509,295,0.90196574,20,,2,1.2916666666666667,
50,2,car,crv,126,1304,388,820,1178,432,0.2519957,20,,2,0.366723259762309,
51,2,car,crv,253,757,448,737,504,289,0.9349736,20,,2,0.366723259762309,
52,2,car,crv,122,1317,387,818,1195,431,0.38155946,20,,2,1.24,
53,2,car,crv,248,756,447,743,508,296,0.9098617,20,,2,1.24,
54,2,car,crv,120,1319,389,808,1199,419,0.49123806,20,,2,1.24,
55,2,car,crv,241,764,446,743,523,297,0.8688812,20,,2,1.24,
56,2,car,crv,251,754,448,736,503,288,0.9627608,20,,2,1.28,
57,2,car,crv,114,1312,387,822,1198,435,0.2406673,20,,2,0.3631051752921536,
58,2,car,crv,253,758,447,739,505,292,0.9361756,20,,2,0.3631051752921536,
59,2,car,crv,121,1313,387,820,1192,433,0.26400292,20,,2,1.24,
60,2,car,crv,246,754,446,742,508,296,0.95298326,20,,2,1.24,
61,2,car,crv,131,1305,389,817,1174,428,0.29075116,20,,2,0.3645655877342419,
62,2,car,crv,252,754,448,743,502,295,0.94248277,20,,2,0.3645655877342419,
63,2,car,crv,130,1307,389,819,1177,430,0.2569041,20,,2,1.24,
64,2,car,crv,256,753,448,740,497,292,0.955823,20,,2,1.24,
65,2,car,crv,127,1305,390,811,1178,421,0.25976446,20,,2,0.35738539898132426,
66,2,car,crv,250,757,443,743,507,300,0.9547171,20,,2,0.35738539898132426,
67,2,car,crv,123,1309,392,810,1186,418,0.28978387,20,,2,1.24,
68,2,car,crv,248,758,446,738,510,292,0.96847486,20,,2,1.24,
69,2,car,crv,123,1304,388,814,1181,426,0.2588897,20,,2,0.3607112616426757,
70,2,car,crv,250,759,447,742,509,295,0.9416412,20,,2,0.3607112616426757,
71,2,car,crv,130,1306,391,810,1176,419,0.26097575,20,,2,0.3562925170068027,
72,2,car,crv,250,756,447,739,506,292,0.95065075,20,,2,0.3562925170068027,
73,2,car,crv,123,1309,389,813,1186,424,0.31858423,20,,2,1.24,
74,2,car,crv,248,758,447,745,510,298,0.9534346,20,,2,1.24,
75,2,car,crv,121,1305,386,819,1184,433,0.24762785,20,,2,0.3657094594594595,
76,2,car,crv,248,759,448,745,511,297,0.96054053,20,,2,0.3657094594594595,
77,2,car,crv,251,754,443,743,503,300,0.96310854,20,,2,1.24,
78,2,car,crv,117,1318,387,822,1201,435,0.42310923,20,,2,1.2916666666666667,
79,2,car,crv,248,763,450,742,515,292,0.92204607,20,,2,1.2916666666666667,
80,2,car,crv,119,1311,391,813,1192,422,0.25885653,20,,2,1.25,
81,2,car,crv,246,752,446,739,506,293,0.95473194,20,,2,1.25,
82,2,car,crv,128,1304,388,815,1176,427,0.30647025,20,,2,1.28,
83,2,car,crv,251,758,443,746,507,303,0.93285924,20,,2,1.28,
84,2,car,crv,250,754,447,738,504,291,0.9767751,20,,2,1.24,
85,2,car,crv,109,1318,388,813,1209,425,0.32027155,20,,2,1.28,
86,2,car,crv,245,760,445,741,515,296,0.9680706,20,,2,1.28,
87,2,car,crv,127,1308,391,816,1181,425,0.2964813,20,,2,1.2916666666666667,
88,2,car,crv,250,757,447,742,507,295,0.9490655,20,,2,1.2916666666666667,
89,2,car,crv,125,1314,388,816,1189,428,0.42268884,20,,2,1.28,
90,2,car,crv,248,760,449,737,512,288,0.90941703,20,,2,1.28,
91,2,car,crv,129,1304,390,814,1175,424,0.26254445,20,,2,1.2916666666666667,
92,2,car,crv,252,755,447,740,503,293,0.94612926,20,,2,1.2916666666666667,
93,2,car,crv,114,1320,387,815,1206,428,0.30274954,20,,2,1.24,
94,2,car,crv,248,753,446,740,505,294,0.8954264,20,,2,1.24,
95,2,car,crv,127,1307,391,814,1180,423,0.278648,20,,2,0.35847457627118645,
96,2,car,crv,250,755,447,744,505,297,0.95984495,20,,2,0.35847457627118645,
97,2,car,crv,127,1302,386,816,1175,430,0.37110242,20,,2,1.28,
98,2,car,crv,246,757,444,747,511,303,0.96607155,20,,2,1.28,
99,2,car,crv,119,1307,387,816,1188,429,0.28644451,20,,2,0.3611111111111111,
100,2,car,crv,248,759,443,747,511,304,0.9593547,20,,2,0.3611111111111111,
101,2,car,crv,127,1306,389,820,1179,431,0.37050778,20,,2,1.24,
102,2,car,crv,252,758,449,742,506,293,0.9203835,20,,2,1.24,
103,2,car,crv,126,1306,387,819,1180,432,0.24266188,20,,2,0.36610169491525424,
104,2,car,crv,247,754,449,740,507,291,0.94762105,20,,2,0.36610169491525424,
105,2,car,crv,113,1317,388,815,1204,427,0.36209753,20,,2,1.24,
106,2,car,crv,247,755,446,738,508,292,0.93217456,20,,2,1.24,
107,2,car,crv,116,1312,386,813,1196,427,0.26130736,20,,2,0.35702341137123744,
108,2,car,crv,249,755,445,740,506,295,0.95275867,20,,2,0.35702341137123744,
109,2,car,crv,250,753,445,746,503,301,0.97777426,20,,2,1.24,
110,2,car,crv,117,1316,390,813,1199,423,0.30318785,20,,2,0.35279399499582986,
111,2,car,crv,239,759,447,740,520,293,0.956478,20,,2,0.35279399499582986,
112,2,car,crv,126,1307,387,813,1181,426,0.3400013,20,,2,1.24,
113,2,car,crv,250,757,446,745,507,299,0.93553233,20,,2,1.24,
114,2,car,crv,118,1316,385,817,1198,432,0.46192503,20,,2,1.24,
115,2,car,crv,242,760,449,744,518,295,0.9251644,20,,2,1.24,
116,2,car,crv,125,1310,389,811,1185,422,0.32076746,20,,2,0.3561181434599156,
117,2,car,crv,250,758,446,739,508,293,0.9462212,20,,2,0.3561181434599156,
118,2,car,crv,250,754,444,740,504,296,0.96969557,20,,2,1.24,
119,2,car,crv,113,1313,388,814,1200,426,0.2754978,20,,2,1.24,
120,2,car,crv,244,756,445,743,512,298,0.96916515,20,,2,1.24,
121,2,car,crv,123,1309,388,814,1186,426,0.2760011,20,,2,1.24,
122,2,car,crv,249,758,446,740,509,294,0.950518,20,,2,1.24,
123,2,car,crv,253,754,447,737,501,290,0.94723046,20,,2,1.24,
124,2,car,crv,121,1308,387,817,1187,430,0.21458383,20,,2,0.36225779275484415,
125,2,car,crv,250,754,447,740,504,293,0.9610552,20,,2,0.36225779275484415,
126,2,car,crv,119,1317,388,814,1198,426,0.4732625,20,,2,1.24,
127,2,car,crv,245,758,448,742,513,294,0.94409996,20,,2,1.24,
128,2,car,crv,121,1308,388,815,1187,427,0.21448645,20,,2,0.35973041280539175,
129,2,car,crv,249,753,445,746,504,301,0.9724925,20,,2,0.35973041280539175,
130,2,car,crv,135,1302,387,821,1167,434,0.35179994,20,,2,1.2916666666666667,
131,2,car,crv,250,760,450,741,510,291,0.8736024,20,,2,1.2916666666666667,
132,2,car,crv,117,1313,390,812,1196,422,0.32242462,20,,2,1.2916666666666667,
133,2,car,crv,243,759,447,742,516,295,0.9675998,20,,2,1.2916666666666667,
134,2,car,crv,122,1311,387,814,1189,427,0.36553156,20,,2,1.2916666666666667,
135,2,car,crv,250,757,444,744,507,300,0.9479286,20,,2,1.2916666666666667,
136,2,car,crv,115,1321,388,815,1206,427,0.3674716,20,,2,1.24,
137,2,car,crv,248,756,446,740,508,294,0.92142504,20,,2,1.24,
138,2,car,crv,109,1315,384,827,1206,443,0.2820505,20,,2,1.24,
139,2,car,crv,249,758,449,736,509,287,0.91024953,20,,2,1.24,
140,2,car,crv,122,1310,388,817,1188,429,0.29904467,20,,2,0.3611111111111111,
141,2,car,crv,250,760,448,741,510,293,0.927252,20,,2,0.3611111111111111,
142,2,car,crv,129,1303,389,814,1174,425,0.27334884,20,,2,1.28,
143,2,car,crv,247,760,448,741,513,293,0.9333165,20,,2,1.28,
144,2,car,crv,122,1311,385,813,1189,428,0.35830083,20,,2,1.24,
145,2,car,crv,246,757,442,746,511,304,0.9668414,20,,2,1.24,
146,2,car,crv,122,1312,391,808,1190,417,0.34383425,20,,2,1.28,
147,2,car,crv,248,755,446,741,507,295,0.90284395,20,,2,1.28,
148,2,car,crv,129,1303,386,819,1174,433,0.2341652,20,,2,0.368824531516184,
149,2,car,crv,252,756,447,744,504,297,0.9354642,20,,2,0.368824531516184,
150,2,car,crv,253,756,446,744,503,298,0.97629297,20,,2,1.24,
151,2,car,crv,128,1307,388,817,1179,429,0.32914877,20,,2,1.2916666666666667,
152,2,car,crv,247,762,447,741,515,294,0.9441378,20,,2,1.2916666666666667,
153,2,car,crv,117,1313,388,818,1196,430,0.27251616,20,,2,0.3595317725752508,
154,2,car,crv,247,762,449,740,515,291,0.96550846,20,,2,0.3595317725752508,
155,2,car,crv,124,1305,387,820,1181,433,0.27402008,20,,2,0.36663844199830653,
156,2,car,crv,252,750,447,746,498,299,0.9501165,20,,2,0.36663844199830653,
157,2,car,crv,111,1317,390,812,1206,422,0.27479288,20,,2,0.34991708126036486,
158,2,car,crv,251,753,447,740,502,293,0.9438285,20,,2,0.34991708126036486,
159,2,car,crv,126,1309,390,814,1183,424,0.30222148,20,,2,1.2916666666666667,
160,2,car,crv,249,757,448,740,508,292,0.91383094,20,,2,1.2916666666666667,
161,2,car,crv,111,1317,390,811,1206,421,0.2941505,20,,2,0.3490878938640133,
162,2,car,crv,247,756,446,741,509,295,0.96245986,20,,2,0.3490878938640133,
163,2,car,crv,134,1300,387,818,1166,431,0.35928637,20,,2,1.28,
164,2,car,crv,251,757,447,743,506,296,0.9412378,20,,2,1.28,
165,2,car,crv,126,1312,388,815,1186,427,0.3965622,20,,2,1.24,
166,2,car,crv,252,758,446,743,506,297,0.9420341,20,,2,1.24,
167,2,car,crv,121,1316,389,809,1195,420,0.4096516,20,,2,1.24,
168,2,car,crv,244,761,447,742,517,295,0.9289579,20,,2,1.24,
169,2,car,crv,125,1312,392,805,1187,413,0.30284005,20,,2,1.24,
170,2,car,crv,245,760,447,739,515,292,0.9596912,20,,2,1.24,
171,2,car,crv,131,1307,388,812,1176,424,0.43397242,20,,2,1.2916666666666667,
172,2,car,crv,247,764,447,744,517,297,0.9014591,20,,2,1.2916666666666667,
173,2,car,crv,123,1315,388,811,1192,423,0.4968379,20,,2,1.24,
174,2,car,crv,246,758,446,743,512,297,0.87933147,20,,2,1.24,
175,2,car,crv,118,1312,389,813,1194,424,0.25691053,20,,2,0.35510887772194305,
176,2,car,crv,249,756,447,742,507,295,0.96910256,20,,2,0.35510887772194305,
177,2,car,crv,118,1319,389,813,1201,424,0.4023961,20,,2,1.28,
178,2,car,crv,243,757,448,743,514,295,0.94143236,20,,2,1.28,
179,2,car,crv,119,1322,385,815,1203,430,0.42900166,20,,2,1.24,
180,2,car,crv,246,762,447,741,516,294,0.790523,20,,2,1.24,
181,2,car,crv,119,1319,386,815,1200,429,0.44753623,20,,2,1.28,
182,2,car,crv,248,759,450,741,511,291,0.8263495,20,,2,1.28,
183,2,car,crv,114,1318,387,813,1204,426,0.43434885,20,,2,1.2916666666666667,
184,2,car,crv,246,759,446,744,513,298,0.9186257,20,,2,1.2916666666666667,
185,2,car,crv,119,1325,389,808,1206,419,0.46840343,20,,2,1.24,
186,2,car,crv,244,759,447,741,515,294,0.83414143,20,,2,1.24,
187,2,car,crv,116,1322,388,811,1206,423,0.44209528,20,,2,1.28,
188,2,car,crv,241,764,450,741,523,291,0.8834957,20,,2,1.28,
189,2,car,crv,334,710,446,701,376,255,0.92716336,3,0,2,0.6781914893617021,
190,2,car,crv,336,711,446,700,375,254,0.9036748,3,0,2,0.6773333333333333,
191,2,car,crv,335,709,444,701,374,257,0.9452533,3,0,2,0.6871657754010695,
