,cid,label,vehicle,left,right,top,bottom,width,height,score,distance_estimate,angle_estimate,real_distance,ratio,elapsed_time
0,2,car,van,590,946,439,698,356,259,0.96922255,3,0,2,0.7275280898876404,
0,2,car,van,589,949,437,697,360,260,0.98192203,3,0,2,0.7222222222222222,
1,2,car,van,590,946,439,698,356,259,0.96922255,3,0,2,0.7275280898876404,
0,2,car,van,590,944,439,693,354,254,0.9859484,3,0,2,0.7175141242937854,
1,2,car,van,589,949,437,697,360,260,0.98192203,3,0,2,0.7222222222222222,
2,2,car,van,590,946,439,698,356,259,0.96922255,3,0,2,0.7275280898876404,
0,2,car,van,482,952,419,760,470,341,0.9468499,3,0,2,0.725531914893617,
1,2,car,van,590,944,439,693,354,254,0.9859484,3,0,2,0.7175141242937854,
2,2,car,van,589,949,437,697,360,260,0.98192203,3,0,2,0.7222222222222222,
3,2,car,van,590,946,439,698,356,259,0.96922255,3,0,2,0.7275280898876404,
0,2,car,van,490,956,413,763,466,350,0.9481417,3,0,2,0.7510729613733905,
1,2,car,van,482,952,419,760,470,341,0.9468499,3,0,2,0.725531914893617,
2,2,car,van,590,944,439,693,354,254,0.9859484,3,0,2,0.7175141242937854,
3,2,car,van,589,949,437,697,360,260,0.98192203,3,0,2,0.7222222222222222,
4,2,car,van,590,946,439,698,356,259,0.96922255,3,0,2,0.7275280898876404,
0,2,car,van,488,936,413,735,448,322,0.9737919,3,0,2,0.71875,
1,2,car,van,490,956,413,763,466,350,0.9481417,3,0,2,0.7510729613733905,
2,2,car,van,482,952,419,760,470,341,0.9468499,3,0,2,0.725531914893617,
3,2,car,van,590,944,439,693,354,254,0.9859484,3,0,2,0.7175141242937854,
4,2,car,van,589,949,437,697,360,260,0.98192203,3,0,2,0.7222222222222222,
5,2,car,van,590,946,439,698,356,259,0.96922255,3,0,2,0.7275280898876404,
0,2,car,van,484,940,413,733,456,320,0.97553414,3,0,2,0.7017543859649122,
1,2,car,van,488,936,413,735,448,322,0.9737919,3,0,2,0.71875,
2,2,car,van,490,956,413,763,466,350,0.9481417,3,0,2,0.7510729613733905,
3,2,car,van,482,952,419,760,470,341,0.9468499,3,0,2,0.725531914893617,
4,2,car,van,590,944,439,693,354,254,0.9859484,3,0,2,0.7175141242937854,
5,2,car,van,589,949,437,697,360,260,0.98192203,3,0,2,0.7222222222222222,
6,2,car,van,590,946,439,698,356,259,0.96922255,3,0,2,0.7275280898876404,
0,2,car,van,489,956,411,768,467,357,0.906528,3,0,2,0.7644539614561028,
1,2,car,van,484,940,413,733,456,320,0.97553414,3,0,2,0.7017543859649122,
2,2,car,van,488,936,413,735,448,322,0.9737919,3,0,2,0.71875,
3,2,car,van,490,956,413,763,466,350,0.9481417,3,0,2,0.7510729613733905,
4,2,car,van,482,952,419,760,470,341,0.9468499,3,0,2,0.725531914893617,
5,2,car,van,590,944,439,693,354,254,0.9859484,3,0,2,0.7175141242937854,
6,2,car,van,589,949,437,697,360,260,0.98192203,3,0,2,0.7222222222222222,
7,2,car,van,590,946,439,698,356,259,0.96922255,3,0,2,0.7275280898876404,
0,2,car,van,492,948,412,767,456,355,0.9304319,3,0,2,0.7785087719298246,
1,2,car,van,489,956,411,768,467,357,0.906528,3,0,2,0.7644539614561028,
2,2,car,van,484,940,413,733,456,320,0.97553414,3,0,2,0.7017543859649122,
3,2,car,van,488,936,413,735,448,322,0.9737919,3,0,2,0.71875,
4,2,car,van,490,956,413,763,466,350,0.9481417,3,0,2,0.7510729613733905,
5,2,car,van,482,952,419,760,470,341,0.9468499,3,0,2,0.725531914893617,
6,2,car,van,590,944,439,693,354,254,0.9859484,3,0,2,0.7175141242937854,
7,2,car,van,589,949,437,697,360,260,0.98192203,3,0,2,0.7222222222222222,
8,2,car,van,590,946,439,698,356,259,0.96922255,3,0,2,0.7275280898876404,
0,2,car,van,486,953,415,763,467,348,0.95723224,3,0,2,0.7451820128479657,
1,2,car,van,492,948,412,767,456,355,0.9304319,3,0,2,0.7785087719298246,
2,2,car,van,489,956,411,768,467,357,0.906528,3,0,2,0.7644539614561028,
3,2,car,van,484,940,413,733,456,320,0.97553414,3,0,2,0.7017543859649122,
4,2,car,van,488,936,413,735,448,322,0.9737919,3,0,2,0.71875,
5,2,car,van,490,956,413,763,466,350,0.9481417,3,0,2,0.7510729613733905,
6,2,car,van,482,952,419,760,470,341,0.9468499,3,0,2,0.725531914893617,
7,2,car,van,590,944,439,693,354,254,0.9859484,3,0,2,0.7175141242937854,
8,2,car,van,589,949,437,697,360,260,0.98192203,3,0,2,0.7222222222222222,
9,2,car,van,590,946,439,698,356,259,0.96922255,3,0,2,0.7275280898876404,
0,2,car,van,480,940,415,734,460,319,0.96075284,3,0,2,0.6934782608695652,
1,2,car,van,486,953,415,763,467,348,0.95723224,3,0,2,0.7451820128479657,
2,2,car,van,492,948,412,767,456,355,0.9304319,3,0,2,0.7785087719298246,
3,2,car,van,489,956,411,768,467,357,0.906528,3,0,2,0.7644539614561028,
4,2,car,van,484,940,413,733,456,320,0.97553414,3,0,2,0.7017543859649122,
5,2,car,van,488,936,413,735,448,322,0.9737919,3,0,2,0.71875,
6,2,car,van,490,956,413,763,466,350,0.9481417,3,0,2,0.7510729613733905,
7,2,car,van,482,952,419,760,470,341,0.9468499,3,0,2,0.725531914893617,
8,2,car,van,590,944,439,693,354,254,0.9859484,3,0,2,0.7175141242937854,
9,2,car,van,589,949,437,697,360,260,0.98192203,3,0,2,0.7222222222222222,
10,2,car,van,590,946,439,698,356,259,0.96922255,3,0,2,0.7275280898876404,
0,2,car,van,482,944,410,736,462,326,0.97273606,3,0,2,0.7056277056277056,
1,2,car,van,480,940,415,734,460,319,0.96075284,3,0,2,0.6934782608695652,
2,2,car,van,486,953,415,763,467,348,0.95723224,3,0,2,0.7451820128479657,
3,2,car,van,492,948,412,767,456,355,0.9304319,3,0,2,0.7785087719298246,
4,2,car,van,489,956,411,768,467,357,0.906528,3,0,2,0.7644539614561028,
5,2,car,van,484,940,413,733,456,320,0.97553414,3,0,2,0.7017543859649122,
6,2,car,van,488,936,413,735,448,322,0.9737919,3,0,2,0.71875,
7,2,car,van,490,956,413,763,466,350,0.9481417,3,0,2,0.7510729613733905,
8,2,car,van,482,952,419,760,470,341,0.9468499,3,0,2,0.725531914893617,
9,2,car,van,590,944,439,693,354,254,0.9859484,3,0,2,0.7175141242937854,
10,2,car,van,589,949,437,697,360,260,0.98192203,3,0,2,0.7222222222222222,
11,2,car,van,590,946,439,698,356,259,0.96922255,3,0,2,0.7275280898876404,
0,2,car,van,484,935,412,738,451,326,0.9526533,3,0,2,0.7228381374722838,
1,2,car,van,482,944,410,736,462,326,0.97273606,3,0,2,0.7056277056277056,
2,2,car,van,480,940,415,734,460,319,0.96075284,3,0,2,0.6934782608695652,
3,2,car,van,486,953,415,763,467,348,0.95723224,3,0,2,0.7451820128479657,
4,2,car,van,492,948,412,767,456,355,0.9304319,3,0,2,0.7785087719298246,
5,2,car,van,489,956,411,768,467,357,0.906528,3,0,2,0.7644539614561028,
6,2,car,van,484,940,413,733,456,320,0.97553414,3,0,2,0.7017543859649122,
7,2,car,van,488,936,413,735,448,322,0.9737919,3,0,2,0.71875,
8,2,car,van,490,956,413,763,466,350,0.9481417,3,0,2,0.7510729613733905,
9,2,car,van,482,952,419,760,470,341,0.9468499,3,0,2,0.725531914893617,
10,2,car,van,590,944,439,693,354,254,0.9859484,3,0,2,0.7175141242937854,
11,2,car,van,589,949,437,697,360,260,0.98192203,3,0,2,0.7222222222222222,
12,2,car,van,590,946,439,698,356,259,0.96922255,3,0,2,0.7275280898876404,
0,2,car,van,479,962,412,769,483,357,0.95937186,3,0,2,0.7391304347826086,
1,2,car,van,484,935,412,738,451,326,0.9526533,3,0,2,0.7228381374722838,
2,2,car,van,482,944,410,736,462,326,0.97273606,3,0,2,0.7056277056277056,
3,2,car,van,480,940,415,734,460,319,0.96075284,3,0,2,0.6934782608695652,
4,2,car,van,486,953,415,763,467,348,0.95723224,3,0,2,0.7451820128479657,
5,2,car,van,492,948,412,767,456,355,0.9304319,3,0,2,0.7785087719298246,
6,2,car,van,489,956,411,768,467,357,0.906528,3,0,2,0.7644539614561028,
7,2,car,van,484,940,413,733,456,320,0.97553414,3,0,2,0.7017543859649122,
8,2,car,van,488,936,413,735,448,322,0.9737919,3,0,2,0.71875,
9,2,car,van,490,956,413,763,466,350,0.9481417,3,0,2,0.7510729613733905,
10,2,car,van,482,952,419,760,470,341,0.9468499,3,0,2,0.725531914893617,
11,2,car,van,590,944,439,693,354,254,0.9859484,3,0,2,0.7175141242937854,
12,2,car,van,589,949,437,697,360,260,0.98192203,3,0,2,0.7222222222222222,
13,2,car,van,590,946,439,698,356,259,0.96922255,3,0,2,0.7275280898876404,
0,2,car,van,487,960,415,764,473,349,0.9687263,3,0,2,0.7378435517970402,
1,2,car,van,479,962,412,769,483,357,0.95937186,3,0,2,0.7391304347826086,
2,2,car,van,484,935,412,738,451,326,0.9526533,3,0,2,0.7228381374722838,
3,2,car,van,482,944,410,736,462,326,0.97273606,3,0,2,0.7056277056277056,
4,2,car,van,480,940,415,734,460,319,0.96075284,3,0,2,0.6934782608695652,
5,2,car,van,486,953,415,763,467,348,0.95723224,3,0,2,0.7451820128479657,
6,2,car,van,492,948,412,767,456,355,0.9304319,3,0,2,0.7785087719298246,
7,2,car,van,489,956,411,768,467,357,0.906528,3,0,2,0.7644539614561028,
8,2,car,van,484,940,413,733,456,320,0.97553414,3,0,2,0.7017543859649122,
9,2,car,van,488,936,413,735,448,322,0.9737919,3,0,2,0.71875,
10,2,car,van,490,956,413,763,466,350,0.9481417,3,0,2,0.7510729613733905,
11,2,car,van,482,952,419,760,470,341,0.9468499,3,0,2,0.725531914893617,
12,2,car,van,590,944,439,693,354,254,0.9859484,3,0,2,0.7175141242937854,
13,2,car,van,589,949,437,697,360,260,0.98192203,3,0,2,0.7222222222222222,
14,2,car,van,590,946,439,698,356,259,0.96922255,3,0,2,0.7275280898876404,
0,2,car,van,494,951,409,769,457,360,0.95296556,3,0,2,0.787746170678337,
1,2,car,van,487,960,415,764,473,349,0.9687263,3,0,2,0.7378435517970402,
2,2,car,van,479,962,412,769,483,357,0.95937186,3,0,2,0.7391304347826086,
3,2,car,van,484,935,412,738,451,326,0.9526533,3,0,2,0.7228381374722838,
4,2,car,van,482,944,410,736,462,326,0.97273606,3,0,2,0.7056277056277056,
5,2,car,van,480,940,415,734,460,319,0.96075284,3,0,2,0.6934782608695652,
6,2,car,van,486,953,415,763,467,348,0.95723224,3,0,2,0.7451820128479657,
7,2,car,van,492,948,412,767,456,355,0.9304319,3,0,2,0.7785087719298246,
8,2,car,van,489,956,411,768,467,357,0.906528,3,0,2,0.7644539614561028,
9,2,car,van,484,940,413,733,456,320,0.97553414,3,0,2,0.7017543859649122,
10,2,car,van,488,936,413,735,448,322,0.9737919,3,0,2,0.71875,
11,2,car,van,490,956,413,763,466,350,0.9481417,3,0,2,0.7510729613733905,
12,2,car,van,482,952,419,760,470,341,0.9468499,3,0,2,0.725531914893617,
13,2,car,van,590,944,439,693,354,254,0.9859484,3,0,2,0.7175141242937854,
14,2,car,van,589,949,437,697,360,260,0.98192203,3,0,2,0.7222222222222222,
15,2,car,van,590,946,439,698,356,259,0.96922255,3,0,2,0.7275280898876404,
0,2,car,van,482,955,419,756,473,337,0.94365954,3,0,2,0.7124735729386892,
1,2,car,van,494,951,409,769,457,360,0.95296556,3,0,2,0.787746170678337,
2,2,car,van,487,960,415,764,473,349,0.9687263,3,0,2,0.7378435517970402,
3,2,car,van,479,962,412,769,483,357,0.95937186,3,0,2,0.7391304347826086,
4,2,car,van,484,935,412,738,451,326,0.9526533,3,0,2,0.7228381374722838,
5,2,car,van,482,944,410,736,462,326,0.97273606,3,0,2,0.7056277056277056,
6,2,car,van,480,940,415,734,460,319,0.96075284,3,0,2,0.6934782608695652,
7,2,car,van,486,953,415,763,467,348,0.95723224,3,0,2,0.7451820128479657,
8,2,car,van,492,948,412,767,456,355,0.9304319,3,0,2,0.7785087719298246,
9,2,car,van,489,956,411,768,467,357,0.906528,3,0,2,0.7644539614561028,
10,2,car,van,484,940,413,733,456,320,0.97553414,3,0,2,0.7017543859649122,
11,2,car,van,488,936,413,735,448,322,0.9737919,3,0,2,0.71875,
12,2,car,van,490,956,413,763,466,350,0.9481417,3,0,2,0.7510729613733905,
13,2,car,van,482,952,419,760,470,341,0.9468499,3,0,2,0.725531914893617,
14,2,car,van,590,944,439,693,354,254,0.9859484,3,0,2,0.7175141242937854,
15,2,car,van,589,949,437,697,360,260,0.98192203,3,0,2,0.7222222222222222,
16,2,car,van,590,946,439,698,356,259,0.96922255,3,0,2,0.7275280898876404,
0,2,car,van,488,939,416,730,451,314,0.9661252,3,0,2,0.6962305986696231,
1,2,car,van,482,955,419,756,473,337,0.94365954,3,0,2,0.7124735729386892,
2,2,car,van,494,951,409,769,457,360,0.95296556,3,0,2,0.787746170678337,
3,2,car,van,487,960,415,764,473,349,0.9687263,3,0,2,0.7378435517970402,
4,2,car,van,479,962,412,769,483,357,0.95937186,3,0,2,0.7391304347826086,
5,2,car,van,484,935,412,738,451,326,0.9526533,3,0,2,0.7228381374722838,
6,2,car,van,482,944,410,736,462,326,0.97273606,3,0,2,0.7056277056277056,
7,2,car,van,480,940,415,734,460,319,0.96075284,3,0,2,0.6934782608695652,
8,2,car,van,486,953,415,763,467,348,0.95723224,3,0,2,0.7451820128479657,
9,2,car,van,492,948,412,767,456,355,0.9304319,3,0,2,0.7785087719298246,
10,2,car,van,489,956,411,768,467,357,0.906528,3,0,2,0.7644539614561028,
11,2,car,van,484,940,413,733,456,320,0.97553414,3,0,2,0.7017543859649122,
12,2,car,van,488,936,413,735,448,322,0.9737919,3,0,2,0.71875,
13,2,car,van,490,956,413,763,466,350,0.9481417,3,0,2,0.7510729613733905,
14,2,car,van,482,952,419,760,470,341,0.9468499,3,0,2,0.725531914893617,
15,2,car,van,590,944,439,693,354,254,0.9859484,3,0,2,0.7175141242937854,
16,2,car,van,589,949,437,697,360,260,0.98192203,3,0,2,0.7222222222222222,
17,2,car,van,590,946,439,698,356,259,0.96922255,3,0,2,0.7275280898876404,
0,2,car,van,492,952,410,768,460,358,0.9421822,3,0,2,0.7782608695652173,
1,2,car,van,488,939,416,730,451,314,0.9661252,3,0,2,0.6962305986696231,
2,2,car,van,482,955,419,756,473,337,0.94365954,3,0,2,0.7124735729386892,
3,2,car,van,494,951,409,769,457,360,0.95296556,3,0,2,0.787746170678337,
4,2,car,van,487,960,415,764,473,349,0.9687263,3,0,2,0.7378435517970402,
5,2,car,van,479,962,412,769,483,357,0.95937186,3,0,2,0.7391304347826086,
6,2,car,van,484,935,412,738,451,326,0.9526533,3,0,2,0.7228381374722838,
7,2,car,van,482,944,410,736,462,326,0.97273606,3,0,2,0.7056277056277056,
8,2,car,van,480,940,415,734,460,319,0.96075284,3,0,2,0.6934782608695652,
9,2,car,van,486,953,415,763,467,348,0.95723224,3,0,2,0.7451820128479657,
10,2,car,van,492,948,412,767,456,355,0.9304319,3,0,2,0.7785087719298246,
11,2,car,van,489,956,411,768,467,357,0.906528,3,0,2,0.7644539614561028,
12,2,car,van,484,940,413,733,456,320,0.97553414,3,0,2,0.7017543859649122,
13,2,car,van,488,936,413,735,448,322,0.9737919,3,0,2,0.71875,
14,2,car,van,490,956,413,763,466,350,0.9481417,3,0,2,0.7510729613733905,
15,2,car,van,482,952,419,760,470,341,0.9468499,3,0,2,0.725531914893617,
16,2,car,van,590,944,439,693,354,254,0.9859484,3,0,2,0.7175141242937854,
17,2,car,van,589,949,437,697,360,260,0.98192203,3,0,2,0.7222222222222222,
18,2,car,van,590,946,439,698,356,259,0.96922255,3,0,2,0.7275280898876404,
0,2,car,van,487,955,420,758,468,338,0.9463203,3,0,2,0.7222222222222222,
1,2,car,van,492,952,410,768,460,358,0.9421822,3,0,2,0.7782608695652173,
2,2,car,van,488,939,416,730,451,314,0.9661252,3,0,2,0.6962305986696231,
3,2,car,van,482,955,419,756,473,337,0.94365954,3,0,2,0.7124735729386892,
4,2,car,van,494,951,409,769,457,360,0.95296556,3,0,2,0.787746170678337,
5,2,car,van,487,960,415,764,473,349,0.9687263,3,0,2,0.7378435517970402,
6,2,car,van,479,962,412,769,483,357,0.95937186,3,0,2,0.7391304347826086,
7,2,car,van,484,935,412,738,451,326,0.9526533,3,0,2,0.7228381374722838,
8,2,car,van,482,944,410,736,462,326,0.97273606,3,0,2,0.7056277056277056,
9,2,car,van,480,940,415,734,460,319,0.96075284,3,0,2,0.6934782608695652,
10,2,car,van,486,953,415,763,467,348,0.95723224,3,0,2,0.7451820128479657,
11,2,car,van,492,948,412,767,456,355,0.9304319,3,0,2,0.7785087719298246,
12,2,car,van,489,956,411,768,467,357,0.906528,3,0,2,0.7644539614561028,
13,2,car,van,484,940,413,733,456,320,0.97553414,3,0,2,0.7017543859649122,
14,2,car,van,488,936,413,735,448,322,0.9737919,3,0,2,0.71875,
15,2,car,van,490,956,413,763,466,350,0.9481417,3,0,2,0.7510729613733905,
16,2,car,van,482,952,419,760,470,341,0.9468499,3,0,2,0.725531914893617,
17,2,car,van,590,944,439,693,354,254,0.9859484,3,0,2,0.7175141242937854,
18,2,car,van,589,949,437,697,360,260,0.98192203,3,0,2,0.7222222222222222,
19,2,car,van,590,946,439,698,356,259,0.96922255,3,0,2,0.7275280898876404,
0,2,car,van,482,959,414,763,477,349,0.888824,3,0,2,0.7316561844863732,
1,2,car,van,487,955,420,758,468,338,0.9463203,3,0,2,0.7222222222222222,
2,2,car,van,492,952,410,768,460,358,0.9421822,3,0,2,0.7782608695652173,
3,2,car,van,488,939,416,730,451,314,0.9661252,3,0,2,0.6962305986696231,
4,2,car,van,482,955,419,756,473,337,0.94365954,3,0,2,0.7124735729386892,
5,2,car,van,494,951,409,769,457,360,0.95296556,3,0,2,0.787746170678337,
6,2,car,van,487,960,415,764,473,349,0.9687263,3,0,2,0.7378435517970402,
7,2,car,van,479,962,412,769,483,357,0.95937186,3,0,2,0.7391304347826086,
8,2,car,van,484,935,412,738,451,326,0.9526533,3,0,2,0.7228381374722838,
9,2,car,van,482,944,410,736,462,326,0.97273606,3,0,2,0.7056277056277056,
10,2,car,van,480,940,415,734,460,319,0.96075284,3,0,2,0.6934782608695652,
11,2,car,van,486,953,415,763,467,348,0.95723224,3,0,2,0.7451820128479657,
12,2,car,van,492,948,412,767,456,355,0.9304319,3,0,2,0.7785087719298246,
13,2,car,van,489,956,411,768,467,357,0.906528,3,0,2,0.7644539614561028,
14,2,car,van,484,940,413,733,456,320,0.97553414,3,0,2,0.7017543859649122,
15,2,car,van,488,936,413,735,448,322,0.9737919,3,0,2,0.71875,
16,2,car,van,490,956,413,763,466,350,0.9481417,3,0,2,0.7510729613733905,
17,2,car,van,482,952,419,760,470,341,0.9468499,3,0,2,0.725531914893617,
18,2,car,van,590,944,439,693,354,254,0.9859484,3,0,2,0.7175141242937854,
19,2,car,van,589,949,437,697,360,260,0.98192203,3,0,2,0.7222222222222222,
20,2,car,van,590,946,439,698,356,259,0.96922255,3,0,2,0.7275280898876404,
0,2,car,van,488,949,417,759,461,342,0.9826786,3,0,2,0.7418655097613883,
1,2,car,van,482,959,414,763,477,349,0.888824,3,0,2,0.7316561844863732,
2,2,car,van,487,955,420,758,468,338,0.9463203,3,0,2,0.7222222222222222,
3,2,car,van,492,952,410,768,460,358,0.9421822,3,0,2,0.7782608695652173,
4,2,car,van,488,939,416,730,451,314,0.9661252,3,0,2,0.6962305986696231,
5,2,car,van,482,955,419,756,473,337,0.94365954,3,0,2,0.7124735729386892,
6,2,car,van,494,951,409,769,457,360,0.95296556,3,0,2,0.787746170678337,
7,2,car,van,487,960,415,764,473,349,0.9687263,3,0,2,0.7378435517970402,
8,2,car,van,479,962,412,769,483,357,0.95937186,3,0,2,0.7391304347826086,
9,2,car,van,484,935,412,738,451,326,0.9526533,3,0,2,0.7228381374722838,
10,2,car,van,482,944,410,736,462,326,0.97273606,3,0,2,0.7056277056277056,
11,2,car,van,480,940,415,734,460,319,0.96075284,3,0,2,0.6934782608695652,
12,2,car,van,486,953,415,763,467,348,0.95723224,3,0,2,0.7451820128479657,
13,2,car,van,492,948,412,767,456,355,0.9304319,3,0,2,0.7785087719298246,
14,2,car,van,489,956,411,768,467,357,0.906528,3,0,2,0.7644539614561028,
15,2,car,van,484,940,413,733,456,320,0.97553414,3,0,2,0.7017543859649122,
16,2,car,van,488,936,413,735,448,322,0.9737919,3,0,2,0.71875,
17,2,car,van,490,956,413,763,466,350,0.9481417,3,0,2,0.7510729613733905,
18,2,car,van,482,952,419,760,470,341,0.9468499,3,0,2,0.725531914893617,
19,2,car,van,590,944,439,693,354,254,0.9859484,3,0,2,0.7175141242937854,
20,2,car,van,589,949,437,697,360,260,0.98192203,3,0,2,0.7222222222222222,
21,2,car,van,590,946,439,698,356,259,0.96922255,3,0,2,0.7275280898876404,
0,2,car,van,484,957,412,766,473,354,0.95933455,3,0,2,0.7484143763213531,
1,2,car,van,488,949,417,759,461,342,0.9826786,3,0,2,0.7418655097613883,
2,2,car,van,482,959,414,763,477,349,0.888824,3,0,2,0.7316561844863732,
3,2,car,van,487,955,420,758,468,338,0.9463203,3,0,2,0.7222222222222222,
4,2,car,van,492,952,410,768,460,358,0.9421822,3,0,2,0.7782608695652173,
5,2,car,van,488,939,416,730,451,314,0.9661252,3,0,2,0.6962305986696231,
6,2,car,van,482,955,419,756,473,337,0.94365954,3,0,2,0.7124735729386892,
7,2,car,van,494,951,409,769,457,360,0.95296556,3,0,2,0.787746170678337,
8,2,car,van,487,960,415,764,473,349,0.9687263,3,0,2,0.7378435517970402,
9,2,car,van,479,962,412,769,483,357,0.95937186,3,0,2,0.7391304347826086,
10,2,car,van,484,935,412,738,451,326,0.9526533,3,0,2,0.7228381374722838,
11,2,car,van,482,944,410,736,462,326,0.97273606,3,0,2,0.7056277056277056,
12,2,car,van,480,940,415,734,460,319,0.96075284,3,0,2,0.6934782608695652,
13,2,car,van,486,953,415,763,467,348,0.95723224,3,0,2,0.7451820128479657,
14,2,car,van,492,948,412,767,456,355,0.9304319,3,0,2,0.7785087719298246,
15,2,car,van,489,956,411,768,467,357,0.906528,3,0,2,0.7644539614561028,
16,2,car,van,484,940,413,733,456,320,0.97553414,3,0,2,0.7017543859649122,
17,2,car,van,488,936,413,735,448,322,0.9737919,3,0,2,0.71875,
18,2,car,van,490,956,413,763,466,350,0.9481417,3,0,2,0.7510729613733905,
19,2,car,van,482,952,419,760,470,341,0.9468499,3,0,2,0.725531914893617,
20,2,car,van,590,944,439,693,354,254,0.9859484,3,0,2,0.7175141242937854,
21,2,car,van,589,949,437,697,360,260,0.98192203,3,0,2,0.7222222222222222,
22,2,car,van,590,946,439,698,356,259,0.96922255,3,0,2,0.7275280898876404,
0,2,car,van,488,940,412,737,452,325,0.9648091,3,0,2,0.7190265486725663,
1,2,car,van,484,957,412,766,473,354,0.95933455,3,0,2,0.7484143763213531,
2,2,car,van,488,949,417,759,461,342,0.9826786,3,0,2,0.7418655097613883,
3,2,car,van,482,959,414,763,477,349,0.888824,3,0,2,0.7316561844863732,
4,2,car,van,487,955,420,758,468,338,0.9463203,3,0,2,0.7222222222222222,
5,2,car,van,492,952,410,768,460,358,0.9421822,3,0,2,0.7782608695652173,
6,2,car,van,488,939,416,730,451,314,0.9661252,3,0,2,0.6962305986696231,
7,2,car,van,482,955,419,756,473,337,0.94365954,3,0,2,0.7124735729386892,
8,2,car,van,494,951,409,769,457,360,0.95296556,3,0,2,0.787746170678337,
9,2,car,van,487,960,415,764,473,349,0.9687263,3,0,2,0.7378435517970402,
10,2,car,van,479,962,412,769,483,357,0.95937186,3,0,2,0.7391304347826086,
11,2,car,van,484,935,412,738,451,326,0.9526533,3,0,2,0.7228381374722838,
12,2,car,van,482,944,410,736,462,326,0.97273606,3,0,2,0.7056277056277056,
13,2,car,van,480,940,415,734,460,319,0.96075284,3,0,2,0.6934782608695652,
14,2,car,van,486,953,415,763,467,348,0.95723224,3,0,2,0.7451820128479657,
15,2,car,van,492,948,412,767,456,355,0.9304319,3,0,2,0.7785087719298246,
16,2,car,van,489,956,411,768,467,357,0.906528,3,0,2,0.7644539614561028,
17,2,car,van,484,940,413,733,456,320,0.97553414,3,0,2,0.7017543859649122,
18,2,car,van,488,936,413,735,448,322,0.9737919,3,0,2,0.71875,
19,2,car,van,490,956,413,763,466,350,0.9481417,3,0,2,0.7510729613733905,
20,2,car,van,482,952,419,760,470,341,0.9468499,3,0,2,0.725531914893617,
21,2,car,van,590,944,439,693,354,254,0.9859484,3,0,2,0.7175141242937854,
22,2,car,van,589,949,437,697,360,260,0.98192203,3,0,2,0.7222222222222222,
23,2,car,van,590,946,439,698,356,259,0.96922255,3,0,2,0.7275280898876404,
0,2,car,van,483,955,415,763,472,348,0.9583383,3,0,2,0.7372881355932204,
1,2,car,van,488,940,412,737,452,325,0.9648091,3,0,2,0.7190265486725663,
2,2,car,van,484,957,412,766,473,354,0.95933455,3,0,2,0.7484143763213531,
3,2,car,van,488,949,417,759,461,342,0.9826786,3,0,2,0.7418655097613883,
4,2,car,van,482,959,414,763,477,349,0.888824,3,0,2,0.7316561844863732,
5,2,car,van,487,955,420,758,468,338,0.9463203,3,0,2,0.7222222222222222,
6,2,car,van,492,952,410,768,460,358,0.9421822,3,0,2,0.7782608695652173,
7,2,car,van,488,939,416,730,451,314,0.9661252,3,0,2,0.6962305986696231,
8,2,car,van,482,955,419,756,473,337,0.94365954,3,0,2,0.7124735729386892,
9,2,car,van,494,951,409,769,457,360,0.95296556,3,0,2,0.787746170678337,
10,2,car,van,487,960,415,764,473,349,0.9687263,3,0,2,0.7378435517970402,
11,2,car,van,479,962,412,769,483,357,0.95937186,3,0,2,0.7391304347826086,
12,2,car,van,484,935,412,738,451,326,0.9526533,3,0,2,0.7228381374722838,
13,2,car,van,482,944,410,736,462,326,0.97273606,3,0,2,0.7056277056277056,
14,2,car,van,480,940,415,734,460,319,0.96075284,3,0,2,0.6934782608695652,
15,2,car,van,486,953,415,763,467,348,0.95723224,3,0,2,0.7451820128479657,
16,2,car,van,492,948,412,767,456,355,0.9304319,3,0,2,0.7785087719298246,
17,2,car,van,489,956,411,768,467,357,0.906528,3,0,2,0.7644539614561028,
18,2,car,van,484,940,413,733,456,320,0.97553414,3,0,2,0.7017543859649122,
19,2,car,van,488,936,413,735,448,322,0.9737919,3,0,2,0.71875,
20,2,car,van,490,956,413,763,466,350,0.9481417,3,0,2,0.7510729613733905,
21,2,car,van,482,952,419,760,470,341,0.9468499,3,0,2,0.725531914893617,
22,2,car,van,590,944,439,693,354,254,0.9859484,3,0,2,0.7175141242937854,
23,2,car,van,589,949,437,697,360,260,0.98192203,3,0,2,0.7222222222222222,
24,2,car,van,590,946,439,698,356,259,0.96922255,3,0,2,0.7275280898876404,
0,2,car,van,488,953,416,761,465,345,0.97468466,3,0,2,0.7419354838709677,
1,2,car,van,483,955,415,763,472,348,0.9583383,3,0,2,0.7372881355932204,
2,2,car,van,488,940,412,737,452,325,0.9648091,3,0,2,0.7190265486725663,
3,2,car,van,484,957,412,766,473,354,0.95933455,3,0,2,0.7484143763213531,
4,2,car,van,488,949,417,759,461,342,0.9826786,3,0,2,0.7418655097613883,
5,2,car,van,482,959,414,763,477,349,0.888824,3,0,2,0.7316561844863732,
6,2,car,van,487,955,420,758,468,338,0.9463203,3,0,2,0.7222222222222222,
7,2,car,van,492,952,410,768,460,358,0.9421822,3,0,2,0.7782608695652173,
8,2,car,van,488,939,416,730,451,314,0.9661252,3,0,2,0.6962305986696231,
9,2,car,van,482,955,419,756,473,337,0.94365954,3,0,2,0.7124735729386892,
10,2,car,van,494,951,409,769,457,360,0.95296556,3,0,2,0.787746170678337,
11,2,car,van,487,960,415,764,473,349,0.9687263,3,0,2,0.7378435517970402,
12,2,car,van,479,962,412,769,483,357,0.95937186,3,0,2,0.7391304347826086,
13,2,car,van,484,935,412,738,451,326,0.9526533,3,0,2,0.7228381374722838,
14,2,car,van,482,944,410,736,462,326,0.97273606,3,0,2,0.7056277056277056,
15,2,car,van,480,940,415,734,460,319,0.96075284,3,0,2,0.6934782608695652,
16,2,car,van,486,953,415,763,467,348,0.95723224,3,0,2,0.7451820128479657,
17,2,car,van,492,948,412,767,456,355,0.9304319,3,0,2,0.7785087719298246,
18,2,car,van,489,956,411,768,467,357,0.906528,3,0,2,0.7644539614561028,
19,2,car,van,484,940,413,733,456,320,0.97553414,3,0,2,0.7017543859649122,
20,2,car,van,488,936,413,735,448,322,0.9737919,3,0,2,0.71875,
21,2,car,van,490,956,413,763,466,350,0.9481417,3,0,2,0.7510729613733905,
22,2,car,van,482,952,419,760,470,341,0.9468499,3,0,2,0.725531914893617,
23,2,car,van,590,944,439,693,354,254,0.9859484,3,0,2,0.7175141242937854,
24,2,car,van,589,949,437,697,360,260,0.98192203,3,0,2,0.7222222222222222,
25,2,car,van,590,946,439,698,356,259,0.96922255,3,0,2,0.7275280898876404,
0,2,car,van,496,948,415,764,452,349,0.9718963,3,0,2,0.7721238938053098,
1,2,car,van,488,953,416,761,465,345,0.97468466,3,0,2,0.7419354838709677,
2,2,car,van,483,955,415,763,472,348,0.9583383,3,0,2,0.7372881355932204,
3,2,car,van,488,940,412,737,452,325,0.9648091,3,0,2,0.7190265486725663,
4,2,car,van,484,957,412,766,473,354,0.95933455,3,0,2,0.7484143763213531,
5,2,car,van,488,949,417,759,461,342,0.9826786,3,0,2,0.7418655097613883,
6,2,car,van,482,959,414,763,477,349,0.888824,3,0,2,0.7316561844863732,
7,2,car,van,487,955,420,758,468,338,0.9463203,3,0,2,0.7222222222222222,
8,2,car,van,492,952,410,768,460,358,0.9421822,3,0,2,0.7782608695652173,
9,2,car,van,488,939,416,730,451,314,0.9661252,3,0,2,0.6962305986696231,
10,2,car,van,482,955,419,756,473,337,0.94365954,3,0,2,0.7124735729386892,
11,2,car,van,494,951,409,769,457,360,0.95296556,3,0,2,0.787746170678337,
12,2,car,van,487,960,415,764,473,349,0.9687263,3,0,2,0.7378435517970402,
13,2,car,van,479,962,412,769,483,357,0.95937186,3,0,2,0.7391304347826086,
14,2,car,van,484,935,412,738,451,326,0.9526533,3,0,2,0.7228381374722838,
15,2,car,van,482,944,410,736,462,326,0.97273606,3,0,2,0.7056277056277056,
16,2,car,van,480,940,415,734,460,319,0.96075284,3,0,2,0.6934782608695652,
17,2,car,van,486,953,415,763,467,348,0.95723224,3,0,2,0.7451820128479657,
18,2,car,van,492,948,412,767,456,355,0.9304319,3,0,2,0.7785087719298246,
19,2,car,van,489,956,411,768,467,357,0.906528,3,0,2,0.7644539614561028,
20,2,car,van,484,940,413,733,456,320,0.97553414,3,0,2,0.7017543859649122,
21,2,car,van,488,936,413,735,448,322,0.9737919,3,0,2,0.71875,
22,2,car,van,490,956,413,763,466,350,0.9481417,3,0,2,0.7510729613733905,
23,2,car,van,482,952,419,760,470,341,0.9468499,3,0,2,0.725531914893617,
24,2,car,van,590,944,439,693,354,254,0.9859484,3,0,2,0.7175141242937854,
25,2,car,van,589,949,437,697,360,260,0.98192203,3,0,2,0.7222222222222222,
26,2,car,van,590,946,439,698,356,259,0.96922255,3,0,2,0.7275280898876404,
0,2,car,van,489,955,409,769,466,360,0.95695746,3,0,2,0.7725321888412017,
1,2,car,van,496,948,415,764,452,349,0.9718963,3,0,2,0.7721238938053098,
2,2,car,van,488,953,416,761,465,345,0.97468466,3,0,2,0.7419354838709677,
3,2,car,van,483,955,415,763,472,348,0.9583383,3,0,2,0.7372881355932204,
4,2,car,van,488,940,412,737,452,325,0.9648091,3,0,2,0.7190265486725663,
5,2,car,van,484,957,412,766,473,354,0.95933455,3,0,2,0.7484143763213531,
6,2,car,van,488,949,417,759,461,342,0.9826786,3,0,2,0.7418655097613883,
7,2,car,van,482,959,414,763,477,349,0.888824,3,0,2,0.7316561844863732,
8,2,car,van,487,955,420,758,468,338,0.9463203,3,0,2,0.7222222222222222,
9,2,car,van,492,952,410,768,460,358,0.9421822,3,0,2,0.7782608695652173,
10,2,car,van,488,939,416,730,451,314,0.9661252,3,0,2,0.6962305986696231,
11,2,car,van,482,955,419,756,473,337,0.94365954,3,0,2,0.7124735729386892,
12,2,car,van,494,951,409,769,457,360,0.95296556,3,0,2,0.787746170678337,
13,2,car,van,487,960,415,764,473,349,0.9687263,3,0,2,0.7378435517970402,
14,2,car,van,479,962,412,769,483,357,0.95937186,3,0,2,0.7391304347826086,
15,2,car,van,484,935,412,738,451,326,0.9526533,3,0,2,0.7228381374722838,
16,2,car,van,482,944,410,736,462,326,0.97273606,3,0,2,0.7056277056277056,
17,2,car,van,480,940,415,734,460,319,0.96075284,3,0,2,0.6934782608695652,
18,2,car,van,486,953,415,763,467,348,0.95723224,3,0,2,0.7451820128479657,
19,2,car,van,492,948,412,767,456,355,0.9304319,3,0,2,0.7785087719298246,
20,2,car,van,489,956,411,768,467,357,0.906528,3,0,2,0.7644539614561028,
21,2,car,van,484,940,413,733,456,320,0.97553414,3,0,2,0.7017543859649122,
22,2,car,van,488,936,413,735,448,322,0.9737919,3,0,2,0.71875,
23,2,car,van,490,956,413,763,466,350,0.9481417,3,0,2,0.7510729613733905,
24,2,car,van,482,952,419,760,470,341,0.9468499,3,0,2,0.725531914893617,
25,2,car,van,590,944,439,693,354,254,0.9859484,3,0,2,0.7175141242937854,
26,2,car,van,589,949,437,697,360,260,0.98192203,3,0,2,0.7222222222222222,
27,2,car,van,590,946,439,698,356,259,0.96922255,3,0,2,0.7275280898876404,
0,2,car,van,487,951,414,764,464,350,0.95158833,3,0,2,0.7543103448275862,
1,2,car,van,489,955,409,769,466,360,0.95695746,3,0,2,0.7725321888412017,
2,2,car,van,496,948,415,764,452,349,0.9718963,3,0,2,0.7721238938053098,
3,2,car,van,488,953,416,761,465,345,0.97468466,3,0,2,0.7419354838709677,
4,2,car,van,483,955,415,763,472,348,0.9583383,3,0,2,0.7372881355932204,
5,2,car,van,488,940,412,737,452,325,0.9648091,3,0,2,0.7190265486725663,
6,2,car,van,484,957,412,766,473,354,0.95933455,3,0,2,0.7484143763213531,
7,2,car,van,488,949,417,759,461,342,0.9826786,3,0,2,0.7418655097613883,
8,2,car,van,482,959,414,763,477,349,0.888824,3,0,2,0.7316561844863732,
9,2,car,van,487,955,420,758,468,338,0.9463203,3,0,2,0.7222222222222222,
10,2,car,van,492,952,410,768,460,358,0.9421822,3,0,2,0.7782608695652173,
11,2,car,van,488,939,416,730,451,314,0.9661252,3,0,2,0.6962305986696231,
12,2,car,van,482,955,419,756,473,337,0.94365954,3,0,2,0.7124735729386892,
13,2,car,van,494,951,409,769,457,360,0.95296556,3,0,2,0.787746170678337,
14,2,car,van,487,960,415,764,473,349,0.9687263,3,0,2,0.7378435517970402,
15,2,car,van,479,962,412,769,483,357,0.95937186,3,0,2,0.7391304347826086,
16,2,car,van,484,935,412,738,451,326,0.9526533,3,0,2,0.7228381374722838,
17,2,car,van,482,944,410,736,462,326,0.97273606,3,0,2,0.7056277056277056,
18,2,car,van,480,940,415,734,460,319,0.96075284,3,0,2,0.6934782608695652,
19,2,car,van,486,953,415,763,467,348,0.95723224,3,0,2,0.7451820128479657,
20,2,car,van,492,948,412,767,456,355,0.9304319,3,0,2,0.7785087719298246,
21,2,car,van,489,956,411,768,467,357,0.906528,3,0,2,0.7644539614561028,
22,2,car,van,484,940,413,733,456,320,0.97553414,3,0,2,0.7017543859649122,
23,2,car,van,488,936,413,735,448,322,0.9737919,3,0,2,0.71875,
24,2,car,van,490,956,413,763,466,350,0.9481417,3,0,2,0.7510729613733905,
25,2,car,van,482,952,419,760,470,341,0.9468499,3,0,2,0.725531914893617,
26,2,car,van,590,944,439,693,354,254,0.9859484,3,0,2,0.7175141242937854,
27,2,car,van,589,949,437,697,360,260,0.98192203,3,0,2,0.7222222222222222,
28,2,car,van,590,946,439,698,356,259,0.96922255,3,0,2,0.7275280898876404,
0,2,car,van,485,942,410,739,457,329,0.94875216,3,0,2,0.7199124726477024,
1,2,car,van,487,951,414,764,464,350,0.95158833,3,0,2,0.7543103448275862,
2,2,car,van,489,955,409,769,466,360,0.95695746,3,0,2,0.7725321888412017,
3,2,car,van,496,948,415,764,452,349,0.9718963,3,0,2,0.7721238938053098,
4,2,car,van,488,953,416,761,465,345,0.97468466,3,0,2,0.7419354838709677,
5,2,car,van,483,955,415,763,472,348,0.9583383,3,0,2,0.7372881355932204,
6,2,car,van,488,940,412,737,452,325,0.9648091,3,0,2,0.7190265486725663,
7,2,car,van,484,957,412,766,473,354,0.95933455,3,0,2,0.7484143763213531,
8,2,car,van,488,949,417,759,461,342,0.9826786,3,0,2,0.7418655097613883,
9,2,car,van,482,959,414,763,477,349,0.888824,3,0,2,0.7316561844863732,
10,2,car,van,487,955,420,758,468,338,0.9463203,3,0,2,0.7222222222222222,
11,2,car,van,492,952,410,768,460,358,0.9421822,3,0,2,0.7782608695652173,
12,2,car,van,488,939,416,730,451,314,0.9661252,3,0,2,0.6962305986696231,
13,2,car,van,482,955,419,756,473,337,0.94365954,3,0,2,0.7124735729386892,
14,2,car,van,494,951,409,769,457,360,0.95296556,3,0,2,0.787746170678337,
15,2,car,van,487,960,415,764,473,349,0.9687263,3,0,2,0.7378435517970402,
16,2,car,van,479,962,412,769,483,357,0.95937186,3,0,2,0.7391304347826086,
17,2,car,van,484,935,412,738,451,326,0.9526533,3,0,2,0.7228381374722838,
18,2,car,van,482,944,410,736,462,326,0.97273606,3,0,2,0.7056277056277056,
19,2,car,van,480,940,415,734,460,319,0.96075284,3,0,2,0.6934782608695652,
20,2,car,van,486,953,415,763,467,348,0.95723224,3,0,2,0.7451820128479657,
21,2,car,van,492,948,412,767,456,355,0.9304319,3,0,2,0.7785087719298246,
22,2,car,van,489,956,411,768,467,357,0.906528,3,0,2,0.7644539614561028,
23,2,car,van,484,940,413,733,456,320,0.97553414,3,0,2,0.7017543859649122,
24,2,car,van,488,936,413,735,448,322,0.9737919,3,0,2,0.71875,
25,2,car,van,490,956,413,763,466,350,0.9481417,3,0,2,0.7510729613733905,
26,2,car,van,482,952,419,760,470,341,0.9468499,3,0,2,0.725531914893617,
27,2,car,van,590,944,439,693,354,254,0.9859484,3,0,2,0.7175141242937854,
28,2,car,van,589,949,437,697,360,260,0.98192203,3,0,2,0.7222222222222222,
29,2,car,van,590,946,439,698,356,259,0.96922255,3,0,2,0.7275280898876404,
0,2,car,van,485,948,416,761,463,345,0.95564747,3,0,2,0.7451403887688985,
1,2,car,van,485,942,410,739,457,329,0.94875216,3,0,2,0.7199124726477024,
2,2,car,van,487,951,414,764,464,350,0.95158833,3,0,2,0.7543103448275862,
3,2,car,van,489,955,409,769,466,360,0.95695746,3,0,2,0.7725321888412017,
4,2,car,van,496,948,415,764,452,349,0.9718963,3,0,2,0.7721238938053098,
5,2,car,van,488,953,416,761,465,345,0.97468466,3,0,2,0.7419354838709677,
6,2,car,van,483,955,415,763,472,348,0.9583383,3,0,2,0.7372881355932204,
7,2,car,van,488,940,412,737,452,325,0.9648091,3,0,2,0.7190265486725663,
8,2,car,van,484,957,412,766,473,354,0.95933455,3,0,2,0.7484143763213531,
9,2,car,van,488,949,417,759,461,342,0.9826786,3,0,2,0.7418655097613883,
10,2,car,van,482,959,414,763,477,349,0.888824,3,0,2,0.7316561844863732,
11,2,car,van,487,955,420,758,468,338,0.9463203,3,0,2,0.7222222222222222,
12,2,car,van,492,952,410,768,460,358,0.9421822,3,0,2,0.7782608695652173,
13,2,car,van,488,939,416,730,451,314,0.9661252,3,0,2,0.6962305986696231,
14,2,car,van,482,955,419,756,473,337,0.94365954,3,0,2,0.7124735729386892,
15,2,car,van,494,951,409,769,457,360,0.95296556,3,0,2,0.787746170678337,
16,2,car,van,487,960,415,764,473,349,0.9687263,3,0,2,0.7378435517970402,
17,2,car,van,479,962,412,769,483,357,0.95937186,3,0,2,0.7391304347826086,
18,2,car,van,484,935,412,738,451,326,0.9526533,3,0,2,0.7228381374722838,
19,2,car,van,482,944,410,736,462,326,0.97273606,3,0,2,0.7056277056277056,
20,2,car,van,480,940,415,734,460,319,0.96075284,3,0,2,0.6934782608695652,
21,2,car,van,486,953,415,763,467,348,0.95723224,3,0,2,0.7451820128479657,
22,2,car,van,492,948,412,767,456,355,0.9304319,3,0,2,0.7785087719298246,
23,2,car,van,489,956,411,768,467,357,0.906528,3,0,2,0.7644539614561028,
24,2,car,van,484,940,413,733,456,320,0.97553414,3,0,2,0.7017543859649122,
25,2,car,van,488,936,413,735,448,322,0.9737919,3,0,2,0.71875,
26,2,car,van,490,956,413,763,466,350,0.9481417,3,0,2,0.7510729613733905,
27,2,car,van,482,952,419,760,470,341,0.9468499,3,0,2,0.725531914893617,
28,2,car,van,590,944,439,693,354,254,0.9859484,3,0,2,0.7175141242937854,
29,2,car,van,589,949,437,697,360,260,0.98192203,3,0,2,0.7222222222222222,
30,2,car,van,590,946,439,698,356,259,0.96922255,3,0,2,0.7275280898876404,
0,2,car,van,485,941,414,730,456,316,0.9736741,3,0,2,0.6929824561403509,
1,2,car,van,485,948,416,761,463,345,0.95564747,3,0,2,0.7451403887688985,
2,2,car,van,485,942,410,739,457,329,0.94875216,3,0,2,0.7199124726477024,
3,2,car,van,487,951,414,764,464,350,0.95158833,3,0,2,0.7543103448275862,
4,2,car,van,489,955,409,769,466,360,0.95695746,3,0,2,0.7725321888412017,
5,2,car,van,496,948,415,764,452,349,0.9718963,3,0,2,0.7721238938053098,
6,2,car,van,488,953,416,761,465,345,0.97468466,3,0,2,0.7419354838709677,
7,2,car,van,483,955,415,763,472,348,0.9583383,3,0,2,0.7372881355932204,
8,2,car,van,488,940,412,737,452,325,0.9648091,3,0,2,0.7190265486725663,
9,2,car,van,484,957,412,766,473,354,0.95933455,3,0,2,0.7484143763213531,
10,2,car,van,488,949,417,759,461,342,0.9826786,3,0,2,0.7418655097613883,
11,2,car,van,482,959,414,763,477,349,0.888824,3,0,2,0.7316561844863732,
12,2,car,van,487,955,420,758,468,338,0.9463203,3,0,2,0.7222222222222222,
13,2,car,van,492,952,410,768,460,358,0.9421822,3,0,2,0.7782608695652173,
14,2,car,van,488,939,416,730,451,314,0.9661252,3,0,2,0.6962305986696231,
15,2,car,van,482,955,419,756,473,337,0.94365954,3,0,2,0.7124735729386892,
16,2,car,van,494,951,409,769,457,360,0.95296556,3,0,2,0.787746170678337,
17,2,car,van,487,960,415,764,473,349,0.9687263,3,0,2,0.7378435517970402,
18,2,car,van,479,962,412,769,483,357,0.95937186,3,0,2,0.7391304347826086,
19,2,car,van,484,935,412,738,451,326,0.9526533,3,0,2,0.7228381374722838,
20,2,car,van,482,944,410,736,462,326,0.97273606,3,0,2,0.7056277056277056,
21,2,car,van,480,940,415,734,460,319,0.96075284,3,0,2,0.6934782608695652,
22,2,car,van,486,953,415,763,467,348,0.95723224,3,0,2,0.7451820128479657,
23,2,car,van,492,948,412,767,456,355,0.9304319,3,0,2,0.7785087719298246,
24,2,car,van,489,956,411,768,467,357,0.906528,3,0,2,0.7644539614561028,
25,2,car,van,484,940,413,733,456,320,0.97553414,3,0,2,0.7017543859649122,
26,2,car,van,488,936,413,735,448,322,0.9737919,3,0,2,0.71875,
27,2,car,van,490,956,413,763,466,350,0.9481417,3,0,2,0.7510729613733905,
28,2,car,van,482,952,419,760,470,341,0.9468499,3,0,2,0.725531914893617,
29,2,car,van,590,944,439,693,354,254,0.9859484,3,0,2,0.7175141242937854,
30,2,car,van,589,949,437,697,360,260,0.98192203,3,0,2,0.7222222222222222,
31,2,car,van,590,946,439,698,356,259,0.96922255,3,0,2,0.7275280898876404,
0,2,car,van,485,955,412,768,470,356,0.8783675,3,0,2,0.7574468085106383,
1,2,car,van,485,941,414,730,456,316,0.9736741,3,0,2,0.6929824561403509,
2,2,car,van,485,948,416,761,463,345,0.95564747,3,0,2,0.7451403887688985,
3,2,car,van,485,942,410,739,457,329,0.94875216,3,0,2,0.7199124726477024,
4,2,car,van,487,951,414,764,464,350,0.95158833,3,0,2,0.7543103448275862,
5,2,car,van,489,955,409,769,466,360,0.95695746,3,0,2,0.7725321888412017,
6,2,car,van,496,948,415,764,452,349,0.9718963,3,0,2,0.7721238938053098,
7,2,car,van,488,953,416,761,465,345,0.97468466,3,0,2,0.7419354838709677,
8,2,car,van,483,955,415,763,472,348,0.9583383,3,0,2,0.7372881355932204,
9,2,car,van,488,940,412,737,452,325,0.9648091,3,0,2,0.7190265486725663,
10,2,car,van,484,957,412,766,473,354,0.95933455,3,0,2,0.7484143763213531,
11,2,car,van,488,949,417,759,461,342,0.9826786,3,0,2,0.7418655097613883,
12,2,car,van,482,959,414,763,477,349,0.888824,3,0,2,0.7316561844863732,
13,2,car,van,487,955,420,758,468,338,0.9463203,3,0,2,0.7222222222222222,
14,2,car,van,492,952,410,768,460,358,0.9421822,3,0,2,0.7782608695652173,
15,2,car,van,488,939,416,730,451,314,0.9661252,3,0,2,0.6962305986696231,
16,2,car,van,482,955,419,756,473,337,0.94365954,3,0,2,0.7124735729386892,
17,2,car,van,494,951,409,769,457,360,0.95296556,3,0,2,0.787746170678337,
18,2,car,van,487,960,415,764,473,349,0.9687263,3,0,2,0.7378435517970402,
19,2,car,van,479,962,412,769,483,357,0.95937186,3,0,2,0.7391304347826086,
20,2,car,van,484,935,412,738,451,326,0.9526533,3,0,2,0.7228381374722838,
21,2,car,van,482,944,410,736,462,326,0.97273606,3,0,2,0.7056277056277056,
22,2,car,van,480,940,415,734,460,319,0.96075284,3,0,2,0.6934782608695652,
23,2,car,van,486,953,415,763,467,348,0.95723224,3,0,2,0.7451820128479657,
24,2,car,van,492,948,412,767,456,355,0.9304319,3,0,2,0.7785087719298246,
25,2,car,van,489,956,411,768,467,357,0.906528,3,0,2,0.7644539614561028,
26,2,car,van,484,940,413,733,456,320,0.97553414,3,0,2,0.7017543859649122,
27,2,car,van,488,936,413,735,448,322,0.9737919,3,0,2,0.71875,
28,2,car,van,490,956,413,763,466,350,0.9481417,3,0,2,0.7510729613733905,
29,2,car,van,482,952,419,760,470,341,0.9468499,3,0,2,0.725531914893617,
30,2,car,van,590,944,439,693,354,254,0.9859484,3,0,2,0.7175141242937854,
31,2,car,van,589,949,437,697,360,260,0.98192203,3,0,2,0.7222222222222222,
32,2,car,van,590,946,439,698,356,259,0.96922255,3,0,2,0.7275280898876404,
0,2,car,van,491,949,411,769,458,358,0.9677114,3,0,2,0.7816593886462883,
1,2,car,van,485,955,412,768,470,356,0.8783675,3,0,2,0.7574468085106383,
2,2,car,van,485,941,414,730,456,316,0.9736741,3,0,2,0.6929824561403509,
3,2,car,van,485,948,416,761,463,345,0.95564747,3,0,2,0.7451403887688985,
4,2,car,van,485,942,410,739,457,329,0.94875216,3,0,2,0.7199124726477024,
5,2,car,van,487,951,414,764,464,350,0.95158833,3,0,2,0.7543103448275862,
6,2,car,van,489,955,409,769,466,360,0.95695746,3,0,2,0.7725321888412017,
7,2,car,van,496,948,415,764,452,349,0.9718963,3,0,2,0.7721238938053098,
8,2,car,van,488,953,416,761,465,345,0.97468466,3,0,2,0.7419354838709677,
9,2,car,van,483,955,415,763,472,348,0.9583383,3,0,2,0.7372881355932204,
10,2,car,van,488,940,412,737,452,325,0.9648091,3,0,2,0.7190265486725663,
11,2,car,van,484,957,412,766,473,354,0.95933455,3,0,2,0.7484143763213531,
12,2,car,van,488,949,417,759,461,342,0.9826786,3,0,2,0.7418655097613883,
13,2,car,van,482,959,414,763,477,349,0.888824,3,0,2,0.7316561844863732,
14,2,car,van,487,955,420,758,468,338,0.9463203,3,0,2,0.7222222222222222,
15,2,car,van,492,952,410,768,460,358,0.9421822,3,0,2,0.7782608695652173,
16,2,car,van,488,939,416,730,451,314,0.9661252,3,0,2,0.6962305986696231,
17,2,car,van,482,955,419,756,473,337,0.94365954,3,0,2,0.7124735729386892,
18,2,car,van,494,951,409,769,457,360,0.95296556,3,0,2,0.787746170678337,
19,2,car,van,487,960,415,764,473,349,0.9687263,3,0,2,0.7378435517970402,
20,2,car,van,479,962,412,769,483,357,0.95937186,3,0,2,0.7391304347826086,
21,2,car,van,484,935,412,738,451,326,0.9526533,3,0,2,0.7228381374722838,
22,2,car,van,482,944,410,736,462,326,0.97273606,3,0,2,0.7056277056277056,
23,2,car,van,480,940,415,734,460,319,0.96075284,3,0,2,0.6934782608695652,
24,2,car,van,486,953,415,763,467,348,0.95723224,3,0,2,0.7451820128479657,
25,2,car,van,492,948,412,767,456,355,0.9304319,3,0,2,0.7785087719298246,
26,2,car,van,489,956,411,768,467,357,0.906528,3,0,2,0.7644539614561028,
27,2,car,van,484,940,413,733,456,320,0.97553414,3,0,2,0.7017543859649122,
28,2,car,van,488,936,413,735,448,322,0.9737919,3,0,2,0.71875,
29,2,car,van,490,956,413,763,466,350,0.9481417,3,0,2,0.7510729613733905,
30,2,car,van,482,952,419,760,470,341,0.9468499,3,0,2,0.725531914893617,
31,2,car,van,590,944,439,693,354,254,0.9859484,3,0,2,0.7175141242937854,
32,2,car,van,589,949,437,697,360,260,0.98192203,3,0,2,0.7222222222222222,
33,2,car,van,590,946,439,698,356,259,0.96922255,3,0,2,0.7275280898876404,
0,2,car,van,486,938,416,730,452,314,0.9374376,3,0,2,0.6946902654867256,
1,2,car,van,491,949,411,769,458,358,0.9677114,3,0,2,0.7816593886462883,
2,2,car,van,485,955,412,768,470,356,0.8783675,3,0,2,0.7574468085106383,
3,2,car,van,485,941,414,730,456,316,0.9736741,3,0,2,0.6929824561403509,
4,2,car,van,485,948,416,761,463,345,0.95564747,3,0,2,0.7451403887688985,
5,2,car,van,485,942,410,739,457,329,0.94875216,3,0,2,0.7199124726477024,
6,2,car,van,487,951,414,764,464,350,0.95158833,3,0,2,0.7543103448275862,
7,2,car,van,489,955,409,769,466,360,0.95695746,3,0,2,0.7725321888412017,
8,2,car,van,496,948,415,764,452,349,0.9718963,3,0,2,0.7721238938053098,
9,2,car,van,488,953,416,761,465,345,0.97468466,3,0,2,0.7419354838709677,
10,2,car,van,483,955,415,763,472,348,0.9583383,3,0,2,0.7372881355932204,
11,2,car,van,488,940,412,737,452,325,0.9648091,3,0,2,0.7190265486725663,
12,2,car,van,484,957,412,766,473,354,0.95933455,3,0,2,0.7484143763213531,
13,2,car,van,488,949,417,759,461,342,0.9826786,3,0,2,0.7418655097613883,
14,2,car,van,482,959,414,763,477,349,0.888824,3,0,2,0.7316561844863732,
15,2,car,van,487,955,420,758,468,338,0.9463203,3,0,2,0.7222222222222222,
16,2,car,van,492,952,410,768,460,358,0.9421822,3,0,2,0.7782608695652173,
17,2,car,van,488,939,416,730,451,314,0.9661252,3,0,2,0.6962305986696231,
18,2,car,van,482,955,419,756,473,337,0.94365954,3,0,2,0.7124735729386892,
19,2,car,van,494,951,409,769,457,360,0.95296556,3,0,2,0.787746170678337,
20,2,car,van,487,960,415,764,473,349,0.9687263,3,0,2,0.7378435517970402,
21,2,car,van,479,962,412,769,483,357,0.95937186,3,0,2,0.7391304347826086,
22,2,car,van,484,935,412,738,451,326,0.9526533,3,0,2,0.7228381374722838,
23,2,car,van,482,944,410,736,462,326,0.97273606,3,0,2,0.7056277056277056,
24,2,car,van,480,940,415,734,460,319,0.96075284,3,0,2,0.6934782608695652,
25,2,car,van,486,953,415,763,467,348,0.95723224,3,0,2,0.7451820128479657,
26,2,car,van,492,948,412,767,456,355,0.9304319,3,0,2,0.7785087719298246,
27,2,car,van,489,956,411,768,467,357,0.906528,3,0,2,0.7644539614561028,
28,2,car,van,484,940,413,733,456,320,0.97553414,3,0,2,0.7017543859649122,
29,2,car,van,488,936,413,735,448,322,0.9737919,3,0,2,0.71875,
30,2,car,van,490,956,413,763,466,350,0.9481417,3,0,2,0.7510729613733905,
31,2,car,van,482,952,419,760,470,341,0.9468499,3,0,2,0.725531914893617,
32,2,car,van,590,944,439,693,354,254,0.9859484,3,0,2,0.7175141242937854,
33,2,car,van,589,949,437,697,360,260,0.98192203,3,0,2,0.7222222222222222,
34,2,car,van,590,946,439,698,356,259,0.96922255,3,0,2,0.7275280898876404,
0,2,car,van,487,953,415,761,466,346,0.97434527,3,0,2,0.7424892703862661,
1,2,car,van,486,938,416,730,452,314,0.9374376,3,0,2,0.6946902654867256,
2,2,car,van,491,949,411,769,458,358,0.9677114,3,0,2,0.7816593886462883,
3,2,car,van,485,955,412,768,470,356,0.8783675,3,0,2,0.7574468085106383,
4,2,car,van,485,941,414,730,456,316,0.9736741,3,0,2,0.6929824561403509,
5,2,car,van,485,948,416,761,463,345,0.95564747,3,0,2,0.7451403887688985,
6,2,car,van,485,942,410,739,457,329,0.94875216,3,0,2,0.7199124726477024,
7,2,car,van,487,951,414,764,464,350,0.95158833,3,0,2,0.7543103448275862,
8,2,car,van,489,955,409,769,466,360,0.95695746,3,0,2,0.7725321888412017,
9,2,car,van,496,948,415,764,452,349,0.9718963,3,0,2,0.7721238938053098,
10,2,car,van,488,953,416,761,465,345,0.97468466,3,0,2,0.7419354838709677,
11,2,car,van,483,955,415,763,472,348,0.9583383,3,0,2,0.7372881355932204,
12,2,car,van,488,940,412,737,452,325,0.9648091,3,0,2,0.7190265486725663,
13,2,car,van,484,957,412,766,473,354,0.95933455,3,0,2,0.7484143763213531,
14,2,car,van,488,949,417,759,461,342,0.9826786,3,0,2,0.7418655097613883,
15,2,car,van,482,959,414,763,477,349,0.888824,3,0,2,0.7316561844863732,
16,2,car,van,487,955,420,758,468,338,0.9463203,3,0,2,0.7222222222222222,
17,2,car,van,492,952,410,768,460,358,0.9421822,3,0,2,0.7782608695652173,
18,2,car,van,488,939,416,730,451,314,0.9661252,3,0,2,0.6962305986696231,
19,2,car,van,482,955,419,756,473,337,0.94365954,3,0,2,0.7124735729386892,
20,2,car,van,494,951,409,769,457,360,0.95296556,3,0,2,0.787746170678337,
21,2,car,van,487,960,415,764,473,349,0.9687263,3,0,2,0.7378435517970402,
22,2,car,van,479,962,412,769,483,357,0.95937186,3,0,2,0.7391304347826086,
23,2,car,van,484,935,412,738,451,326,0.9526533,3,0,2,0.7228381374722838,
24,2,car,van,482,944,410,736,462,326,0.97273606,3,0,2,0.7056277056277056,
25,2,car,van,480,940,415,734,460,319,0.96075284,3,0,2,0.6934782608695652,
26,2,car,van,486,953,415,763,467,348,0.95723224,3,0,2,0.7451820128479657,
27,2,car,van,492,948,412,767,456,355,0.9304319,3,0,2,0.7785087719298246,
28,2,car,van,489,956,411,768,467,357,0.906528,3,0,2,0.7644539614561028,
29,2,car,van,484,940,413,733,456,320,0.97553414,3,0,2,0.7017543859649122,
30,2,car,van,488,936,413,735,448,322,0.9737919,3,0,2,0.71875,
31,2,car,van,490,956,413,763,466,350,0.9481417,3,0,2,0.7510729613733905,
32,2,car,van,482,952,419,760,470,341,0.9468499,3,0,2,0.725531914893617,
33,2,car,van,590,944,439,693,354,254,0.9859484,3,0,2,0.7175141242937854,
34,2,car,van,589,949,437,697,360,260,0.98192203,3,0,2,0.7222222222222222,
35,2,car,van,590,946,439,698,356,259,0.96922255,3,0,2,0.7275280898876404,
0,2,car,van,486,941,412,731,455,319,0.9610242,3,0,2,0.701098901098901,
1,2,car,van,487,953,415,761,466,346,0.97434527,3,0,2,0.7424892703862661,
2,2,car,van,486,938,416,730,452,314,0.9374376,3,0,2,0.6946902654867256,
3,2,car,van,491,949,411,769,458,358,0.9677114,3,0,2,0.7816593886462883,
4,2,car,van,485,955,412,768,470,356,0.8783675,3,0,2,0.7574468085106383,
5,2,car,van,485,941,414,730,456,316,0.9736741,3,0,2,0.6929824561403509,
6,2,car,van,485,948,416,761,463,345,0.95564747,3,0,2,0.7451403887688985,
7,2,car,van,485,942,410,739,457,329,0.94875216,3,0,2,0.7199124726477024,
8,2,car,van,487,951,414,764,464,350,0.95158833,3,0,2,0.7543103448275862,
9,2,car,van,489,955,409,769,466,360,0.95695746,3,0,2,0.7725321888412017,
10,2,car,van,496,948,415,764,452,349,0.9718963,3,0,2,0.7721238938053098,
11,2,car,van,488,953,416,761,465,345,0.97468466,3,0,2,0.7419354838709677,
12,2,car,van,483,955,415,763,472,348,0.9583383,3,0,2,0.7372881355932204,
13,2,car,van,488,940,412,737,452,325,0.9648091,3,0,2,0.7190265486725663,
14,2,car,van,484,957,412,766,473,354,0.95933455,3,0,2,0.7484143763213531,
15,2,car,van,488,949,417,759,461,342,0.9826786,3,0,2,0.7418655097613883,
16,2,car,van,482,959,414,763,477,349,0.888824,3,0,2,0.7316561844863732,
17,2,car,van,487,955,420,758,468,338,0.9463203,3,0,2,0.7222222222222222,
18,2,car,van,492,952,410,768,460,358,0.9421822,3,0,2,0.7782608695652173,
19,2,car,van,488,939,416,730,451,314,0.9661252,3,0,2,0.6962305986696231,
20,2,car,van,482,955,419,756,473,337,0.94365954,3,0,2,0.7124735729386892,
21,2,car,van,494,951,409,769,457,360,0.95296556,3,0,2,0.787746170678337,
22,2,car,van,487,960,415,764,473,349,0.9687263,3,0,2,0.7378435517970402,
23,2,car,van,479,962,412,769,483,357,0.95937186,3,0,2,0.7391304347826086,
24,2,car,van,484,935,412,738,451,326,0.9526533,3,0,2,0.7228381374722838,
25,2,car,van,482,944,410,736,462,326,0.97273606,3,0,2,0.7056277056277056,
26,2,car,van,480,940,415,734,460,319,0.96075284,3,0,2,0.6934782608695652,
27,2,car,van,486,953,415,763,467,348,0.95723224,3,0,2,0.7451820128479657,
28,2,car,van,492,948,412,767,456,355,0.9304319,3,0,2,0.7785087719298246,
29,2,car,van,489,956,411,768,467,357,0.906528,3,0,2,0.7644539614561028,
30,2,car,van,484,940,413,733,456,320,0.97553414,3,0,2,0.7017543859649122,
31,2,car,van,488,936,413,735,448,322,0.9737919,3,0,2,0.71875,
32,2,car,van,490,956,413,763,466,350,0.9481417,3,0,2,0.7510729613733905,
33,2,car,van,482,952,419,760,470,341,0.9468499,3,0,2,0.725531914893617,
34,2,car,van,590,944,439,693,354,254,0.9859484,3,0,2,0.7175141242937854,
35,2,car,van,589,949,437,697,360,260,0.98192203,3,0,2,0.7222222222222222,
36,2,car,van,590,946,439,698,356,259,0.96922255,3,0,2,0.7275280898876404,
0,2,car,van,490,943,411,735,453,324,0.9208222,3,0,2,0.7152317880794702,
1,2,car,van,486,941,412,731,455,319,0.9610242,3,0,2,0.701098901098901,
2,2,car,van,487,953,415,761,466,346,0.97434527,3,0,2,0.7424892703862661,
3,2,car,van,486,938,416,730,452,314,0.9374376,3,0,2,0.6946902654867256,
4,2,car,van,491,949,411,769,458,358,0.9677114,3,0,2,0.7816593886462883,
5,2,car,van,485,955,412,768,470,356,0.8783675,3,0,2,0.7574468085106383,
6,2,car,van,485,941,414,730,456,316,0.9736741,3,0,2,0.6929824561403509,
7,2,car,van,485,948,416,761,463,345,0.95564747,3,0,2,0.7451403887688985,
8,2,car,van,485,942,410,739,457,329,0.94875216,3,0,2,0.7199124726477024,
9,2,car,van,487,951,414,764,464,350,0.95158833,3,0,2,0.7543103448275862,
10,2,car,van,489,955,409,769,466,360,0.95695746,3,0,2,0.7725321888412017,
11,2,car,van,496,948,415,764,452,349,0.9718963,3,0,2,0.7721238938053098,
12,2,car,van,488,953,416,761,465,345,0.97468466,3,0,2,0.7419354838709677,
13,2,car,van,483,955,415,763,472,348,0.9583383,3,0,2,0.7372881355932204,
14,2,car,van,488,940,412,737,452,325,0.9648091,3,0,2,0.7190265486725663,
15,2,car,van,484,957,412,766,473,354,0.95933455,3,0,2,0.7484143763213531,
16,2,car,van,488,949,417,759,461,342,0.9826786,3,0,2,0.7418655097613883,
17,2,car,van,482,959,414,763,477,349,0.888824,3,0,2,0.7316561844863732,
18,2,car,van,487,955,420,758,468,338,0.9463203,3,0,2,0.7222222222222222,
19,2,car,van,492,952,410,768,460,358,0.9421822,3,0,2,0.7782608695652173,
20,2,car,van,488,939,416,730,451,314,0.9661252,3,0,2,0.6962305986696231,
21,2,car,van,482,955,419,756,473,337,0.94365954,3,0,2,0.7124735729386892,
22,2,car,van,494,951,409,769,457,360,0.95296556,3,0,2,0.787746170678337,
23,2,car,van,487,960,415,764,473,349,0.9687263,3,0,2,0.7378435517970402,
24,2,car,van,479,962,412,769,483,357,0.95937186,3,0,2,0.7391304347826086,
25,2,car,van,484,935,412,738,451,326,0.9526533,3,0,2,0.7228381374722838,
26,2,car,van,482,944,410,736,462,326,0.97273606,3,0,2,0.7056277056277056,
27,2,car,van,480,940,415,734,460,319,0.96075284,3,0,2,0.6934782608695652,
28,2,car,van,486,953,415,763,467,348,0.95723224,3,0,2,0.7451820128479657,
29,2,car,van,492,948,412,767,456,355,0.9304319,3,0,2,0.7785087719298246,
30,2,car,van,489,956,411,768,467,357,0.906528,3,0,2,0.7644539614561028,
31,2,car,van,484,940,413,733,456,320,0.97553414,3,0,2,0.7017543859649122,
32,2,car,van,488,936,413,735,448,322,0.9737919,3,0,2,0.71875,
33,2,car,van,490,956,413,763,466,350,0.9481417,3,0,2,0.7510729613733905,
34,2,car,van,482,952,419,760,470,341,0.9468499,3,0,2,0.725531914893617,
35,2,car,van,590,944,439,693,354,254,0.9859484,3,0,2,0.7175141242937854,
36,2,car,van,589,949,437,697,360,260,0.98192203,3,0,2,0.7222222222222222,
37,2,car,van,590,946,439,698,356,259,0.96922255,3,0,2,0.7275280898876404,
0,2,car,van,483,955,410,769,472,359,0.95927954,3,0,2,0.760593220338983,
1,2,car,van,490,943,411,735,453,324,0.9208222,3,0,2,0.7152317880794702,
2,2,car,van,486,941,412,731,455,319,0.9610242,3,0,2,0.701098901098901,
3,2,car,van,487,953,415,761,466,346,0.97434527,3,0,2,0.7424892703862661,
4,2,car,van,486,938,416,730,452,314,0.9374376,3,0,2,0.6946902654867256,
5,2,car,van,491,949,411,769,458,358,0.9677114,3,0,2,0.7816593886462883,
6,2,car,van,485,955,412,768,470,356,0.8783675,3,0,2,0.7574468085106383,
7,2,car,van,485,941,414,730,456,316,0.9736741,3,0,2,0.6929824561403509,
8,2,car,van,485,948,416,761,463,345,0.95564747,3,0,2,0.7451403887688985,
9,2,car,van,485,942,410,739,457,329,0.94875216,3,0,2,0.7199124726477024,
10,2,car,van,487,951,414,764,464,350,0.95158833,3,0,2,0.7543103448275862,
11,2,car,van,489,955,409,769,466,360,0.95695746,3,0,2,0.7725321888412017,
12,2,car,van,496,948,415,764,452,349,0.9718963,3,0,2,0.7721238938053098,
13,2,car,van,488,953,416,761,465,345,0.97468466,3,0,2,0.7419354838709677,
14,2,car,van,483,955,415,763,472,348,0.9583383,3,0,2,0.7372881355932204,
15,2,car,van,488,940,412,737,452,325,0.9648091,3,0,2,0.7190265486725663,
16,2,car,van,484,957,412,766,473,354,0.95933455,3,0,2,0.7484143763213531,
17,2,car,van,488,949,417,759,461,342,0.9826786,3,0,2,0.7418655097613883,
18,2,car,van,482,959,414,763,477,349,0.888824,3,0,2,0.7316561844863732,
19,2,car,van,487,955,420,758,468,338,0.9463203,3,0,2,0.7222222222222222,
20,2,car,van,492,952,410,768,460,358,0.9421822,3,0,2,0.7782608695652173,
21,2,car,van,488,939,416,730,451,314,0.9661252,3,0,2,0.6962305986696231,
22,2,car,van,482,955,419,756,473,337,0.94365954,3,0,2,0.7124735729386892,
23,2,car,van,494,951,409,769,457,360,0.95296556,3,0,2,0.787746170678337,
24,2,car,van,487,960,415,764,473,349,0.9687263,3,0,2,0.7378435517970402,
25,2,car,van,479,962,412,769,483,357,0.95937186,3,0,2,0.7391304347826086,
26,2,car,van,484,935,412,738,451,326,0.9526533,3,0,2,0.7228381374722838,
27,2,car,van,482,944,410,736,462,326,0.97273606,3,0,2,0.7056277056277056,
28,2,car,van,480,940,415,734,460,319,0.96075284,3,0,2,0.6934782608695652,
29,2,car,van,486,953,415,763,467,348,0.95723224,3,0,2,0.7451820128479657,
30,2,car,van,492,948,412,767,456,355,0.9304319,3,0,2,0.7785087719298246,
31,2,car,van,489,956,411,768,467,357,0.906528,3,0,2,0.7644539614561028,
32,2,car,van,484,940,413,733,456,320,0.97553414,3,0,2,0.7017543859649122,
33,2,car,van,488,936,413,735,448,322,0.9737919,3,0,2,0.71875,
34,2,car,van,490,956,413,763,466,350,0.9481417,3,0,2,0.7510729613733905,
35,2,car,van,482,952,419,760,470,341,0.9468499,3,0,2,0.725531914893617,
36,2,car,van,590,944,439,693,354,254,0.9859484,3,0,2,0.7175141242937854,
37,2,car,van,589,949,437,697,360,260,0.98192203,3,0,2,0.7222222222222222,
38,2,car,van,590,946,439,698,356,259,0.96922255,3,0,2,0.7275280898876404,
0,2,car,van,483,953,413,767,470,354,0.95913815,3,0,2,0.7531914893617021,
1,2,car,van,483,955,410,769,472,359,0.95927954,3,0,2,0.760593220338983,
2,2,car,van,490,943,411,735,453,324,0.9208222,3,0,2,0.7152317880794702,
3,2,car,van,486,941,412,731,455,319,0.9610242,3,0,2,0.701098901098901,
4,2,car,van,487,953,415,761,466,346,0.97434527,3,0,2,0.7424892703862661,
5,2,car,van,486,938,416,730,452,314,0.9374376,3,0,2,0.6946902654867256,
6,2,car,van,491,949,411,769,458,358,0.9677114,3,0,2,0.7816593886462883,
7,2,car,van,485,955,412,768,470,356,0.8783675,3,0,2,0.7574468085106383,
8,2,car,van,485,941,414,730,456,316,0.9736741,3,0,2,0.6929824561403509,
9,2,car,van,485,948,416,761,463,345,0.95564747,3,0,2,0.7451403887688985,
10,2,car,van,485,942,410,739,457,329,0.94875216,3,0,2,0.7199124726477024,
11,2,car,van,487,951,414,764,464,350,0.95158833,3,0,2,0.7543103448275862,
12,2,car,van,489,955,409,769,466,360,0.95695746,3,0,2,0.7725321888412017,
13,2,car,van,496,948,415,764,452,349,0.9718963,3,0,2,0.7721238938053098,
14,2,car,van,488,953,416,761,465,345,0.97468466,3,0,2,0.7419354838709677,
15,2,car,van,483,955,415,763,472,348,0.9583383,3,0,2,0.7372881355932204,
16,2,car,van,488,940,412,737,452,325,0.9648091,3,0,2,0.7190265486725663,
17,2,car,van,484,957,412,766,473,354,0.95933455,3,0,2,0.7484143763213531,
18,2,car,van,488,949,417,759,461,342,0.9826786,3,0,2,0.7418655097613883,
19,2,car,van,482,959,414,763,477,349,0.888824,3,0,2,0.7316561844863732,
20,2,car,van,487,955,420,758,468,338,0.9463203,3,0,2,0.7222222222222222,
21,2,car,van,492,952,410,768,460,358,0.9421822,3,0,2,0.7782608695652173,
22,2,car,van,488,939,416,730,451,314,0.9661252,3,0,2,0.6962305986696231,
23,2,car,van,482,955,419,756,473,337,0.94365954,3,0,2,0.7124735729386892,
24,2,car,van,494,951,409,769,457,360,0.95296556,3,0,2,0.787746170678337,
25,2,car,van,487,960,415,764,473,349,0.9687263,3,0,2,0.7378435517970402,
26,2,car,van,479,962,412,769,483,357,0.95937186,3,0,2,0.7391304347826086,
27,2,car,van,484,935,412,738,451,326,0.9526533,3,0,2,0.7228381374722838,
28,2,car,van,482,944,410,736,462,326,0.97273606,3,0,2,0.7056277056277056,
29,2,car,van,480,940,415,734,460,319,0.96075284,3,0,2,0.6934782608695652,
30,2,car,van,486,953,415,763,467,348,0.95723224,3,0,2,0.7451820128479657,
31,2,car,van,492,948,412,767,456,355,0.9304319,3,0,2,0.7785087719298246,
32,2,car,van,489,956,411,768,467,357,0.906528,3,0,2,0.7644539614561028,
33,2,car,van,484,940,413,733,456,320,0.97553414,3,0,2,0.7017543859649122,
34,2,car,van,488,936,413,735,448,322,0.9737919,3,0,2,0.71875,
35,2,car,van,490,956,413,763,466,350,0.9481417,3,0,2,0.7510729613733905,
36,2,car,van,482,952,419,760,470,341,0.9468499,3,0,2,0.725531914893617,
37,2,car,van,590,944,439,693,354,254,0.9859484,3,0,2,0.7175141242937854,
38,2,car,van,589,949,437,697,360,260,0.98192203,3,0,2,0.7222222222222222,
39,2,car,van,590,946,439,698,356,259,0.96922255,3,0,2,0.7275280898876404,
0,2,car,van,487,955,409,768,468,359,0.96377707,3,0,2,0.7670940170940171,
1,2,car,van,483,953,413,767,470,354,0.95913815,3,0,2,0.7531914893617021,
2,2,car,van,483,955,410,769,472,359,0.95927954,3,0,2,0.760593220338983,
3,2,car,van,490,943,411,735,453,324,0.9208222,3,0,2,0.7152317880794702,
4,2,car,van,486,941,412,731,455,319,0.9610242,3,0,2,0.701098901098901,
5,2,car,van,487,953,415,761,466,346,0.97434527,3,0,2,0.7424892703862661,
6,2,car,van,486,938,416,730,452,314,0.9374376,3,0,2,0.6946902654867256,
7,2,car,van,491,949,411,769,458,358,0.9677114,3,0,2,0.7816593886462883,
8,2,car,van,485,955,412,768,470,356,0.8783675,3,0,2,0.7574468085106383,
9,2,car,van,485,941,414,730,456,316,0.9736741,3,0,2,0.6929824561403509,
10,2,car,van,485,948,416,761,463,345,0.95564747,3,0,2,0.7451403887688985,
11,2,car,van,485,942,410,739,457,329,0.94875216,3,0,2,0.7199124726477024,
12,2,car,van,487,951,414,764,464,350,0.95158833,3,0,2,0.7543103448275862,
13,2,car,van,489,955,409,769,466,360,0.95695746,3,0,2,0.7725321888412017,
14,2,car,van,496,948,415,764,452,349,0.9718963,3,0,2,0.7721238938053098,
15,2,car,van,488,953,416,761,465,345,0.97468466,3,0,2,0.7419354838709677,
16,2,car,van,483,955,415,763,472,348,0.9583383,3,0,2,0.7372881355932204,
17,2,car,van,488,940,412,737,452,325,0.9648091,3,0,2,0.7190265486725663,
18,2,car,van,484,957,412,766,473,354,0.95933455,3,0,2,0.7484143763213531,
19,2,car,van,488,949,417,759,461,342,0.9826786,3,0,2,0.7418655097613883,
20,2,car,van,482,959,414,763,477,349,0.888824,3,0,2,0.7316561844863732,
21,2,car,van,487,955,420,758,468,338,0.9463203,3,0,2,0.7222222222222222,
22,2,car,van,492,952,410,768,460,358,0.9421822,3,0,2,0.7782608695652173,
23,2,car,van,488,939,416,730,451,314,0.9661252,3,0,2,0.6962305986696231,
24,2,car,van,482,955,419,756,473,337,0.94365954,3,0,2,0.7124735729386892,
25,2,car,van,494,951,409,769,457,360,0.95296556,3,0,2,0.787746170678337,
26,2,car,van,487,960,415,764,473,349,0.9687263,3,0,2,0.7378435517970402,
27,2,car,van,479,962,412,769,483,357,0.95937186,3,0,2,0.7391304347826086,
28,2,car,van,484,935,412,738,451,326,0.9526533,3,0,2,0.7228381374722838,
29,2,car,van,482,944,410,736,462,326,0.97273606,3,0,2,0.7056277056277056,
30,2,car,van,480,940,415,734,460,319,0.96075284,3,0,2,0.6934782608695652,
31,2,car,van,486,953,415,763,467,348,0.95723224,3,0,2,0.7451820128479657,
32,2,car,van,492,948,412,767,456,355,0.9304319,3,0,2,0.7785087719298246,
33,2,car,van,489,956,411,768,467,357,0.906528,3,0,2,0.7644539614561028,
34,2,car,van,484,940,413,733,456,320,0.97553414,3,0,2,0.7017543859649122,
35,2,car,van,488,936,413,735,448,322,0.9737919,3,0,2,0.71875,
36,2,car,van,490,956,413,763,466,350,0.9481417,3,0,2,0.7510729613733905,
37,2,car,van,482,952,419,760,470,341,0.9468499,3,0,2,0.725531914893617,
38,2,car,van,590,944,439,693,354,254,0.9859484,3,0,2,0.7175141242937854,
39,2,car,van,589,949,437,697,360,260,0.98192203,3,0,2,0.7222222222222222,
40,2,car,van,590,946,439,698,356,259,0.96922255,3,0,2,0.7275280898876404,
0,2,car,van,488,954,411,769,466,358,0.9352239,3,0,2,0.7682403433476395,
1,2,car,van,487,955,409,768,468,359,0.96377707,3,0,2,0.7670940170940171,
2,2,car,van,483,953,413,767,470,354,0.95913815,3,0,2,0.7531914893617021,
3,2,car,van,483,955,410,769,472,359,0.95927954,3,0,2,0.760593220338983,
4,2,car,van,490,943,411,735,453,324,0.9208222,3,0,2,0.7152317880794702,
5,2,car,van,486,941,412,731,455,319,0.9610242,3,0,2,0.701098901098901,
6,2,car,van,487,953,415,761,466,346,0.97434527,3,0,2,0.7424892703862661,
7,2,car,van,486,938,416,730,452,314,0.9374376,3,0,2,0.6946902654867256,
8,2,car,van,491,949,411,769,458,358,0.9677114,3,0,2,0.7816593886462883,
9,2,car,van,485,955,412,768,470,356,0.8783675,3,0,2,0.7574468085106383,
10,2,car,van,485,941,414,730,456,316,0.9736741,3,0,2,0.6929824561403509,
11,2,car,van,485,948,416,761,463,345,0.95564747,3,0,2,0.7451403887688985,
12,2,car,van,485,942,410,739,457,329,0.94875216,3,0,2,0.7199124726477024,
13,2,car,van,487,951,414,764,464,350,0.95158833,3,0,2,0.7543103448275862,
14,2,car,van,489,955,409,769,466,360,0.95695746,3,0,2,0.7725321888412017,
15,2,car,van,496,948,415,764,452,349,0.9718963,3,0,2,0.7721238938053098,
16,2,car,van,488,953,416,761,465,345,0.97468466,3,0,2,0.7419354838709677,
17,2,car,van,483,955,415,763,472,348,0.9583383,3,0,2,0.7372881355932204,
18,2,car,van,488,940,412,737,452,325,0.9648091,3,0,2,0.7190265486725663,
19,2,car,van,484,957,412,766,473,354,0.95933455,3,0,2,0.7484143763213531,
20,2,car,van,488,949,417,759,461,342,0.9826786,3,0,2,0.7418655097613883,
21,2,car,van,482,959,414,763,477,349,0.888824,3,0,2,0.7316561844863732,
22,2,car,van,487,955,420,758,468,338,0.9463203,3,0,2,0.7222222222222222,
23,2,car,van,492,952,410,768,460,358,0.9421822,3,0,2,0.7782608695652173,
24,2,car,van,488,939,416,730,451,314,0.9661252,3,0,2,0.6962305986696231,
25,2,car,van,482,955,419,756,473,337,0.94365954,3,0,2,0.7124735729386892,
26,2,car,van,494,951,409,769,457,360,0.95296556,3,0,2,0.787746170678337,
27,2,car,van,487,960,415,764,473,349,0.9687263,3,0,2,0.7378435517970402,
28,2,car,van,479,962,412,769,483,357,0.95937186,3,0,2,0.7391304347826086,
29,2,car,van,484,935,412,738,451,326,0.9526533,3,0,2,0.7228381374722838,
30,2,car,van,482,944,410,736,462,326,0.97273606,3,0,2,0.7056277056277056,
31,2,car,van,480,940,415,734,460,319,0.96075284,3,0,2,0.6934782608695652,
32,2,car,van,486,953,415,763,467,348,0.95723224,3,0,2,0.7451820128479657,
33,2,car,van,492,948,412,767,456,355,0.9304319,3,0,2,0.7785087719298246,
34,2,car,van,489,956,411,768,467,357,0.906528,3,0,2,0.7644539614561028,
35,2,car,van,484,940,413,733,456,320,0.97553414,3,0,2,0.7017543859649122,
36,2,car,van,488,936,413,735,448,322,0.9737919,3,0,2,0.71875,
37,2,car,van,490,956,413,763,466,350,0.9481417,3,0,2,0.7510729613733905,
38,2,car,van,482,952,419,760,470,341,0.9468499,3,0,2,0.725531914893617,
39,2,car,van,590,944,439,693,354,254,0.9859484,3,0,2,0.7175141242937854,
40,2,car,van,589,949,437,697,360,260,0.98192203,3,0,2,0.7222222222222222,
41,2,car,van,590,946,439,698,356,259,0.96922255,3,0,2,0.7275280898876404,
0,2,car,van,489,940,411,737,451,326,0.94711137,3,0,2,0.7228381374722838,
1,2,car,van,488,954,411,769,466,358,0.9352239,3,0,2,0.7682403433476395,
2,2,car,van,487,955,409,768,468,359,0.96377707,3,0,2,0.7670940170940171,
3,2,car,van,483,953,413,767,470,354,0.95913815,3,0,2,0.7531914893617021,
4,2,car,van,483,955,410,769,472,359,0.95927954,3,0,2,0.760593220338983,
5,2,car,van,490,943,411,735,453,324,0.9208222,3,0,2,0.7152317880794702,
6,2,car,van,486,941,412,731,455,319,0.9610242,3,0,2,0.701098901098901,
7,2,car,van,487,953,415,761,466,346,0.97434527,3,0,2,0.7424892703862661,
8,2,car,van,486,938,416,730,452,314,0.9374376,3,0,2,0.6946902654867256,
9,2,car,van,491,949,411,769,458,358,0.9677114,3,0,2,0.7816593886462883,
10,2,car,van,485,955,412,768,470,356,0.8783675,3,0,2,0.7574468085106383,
11,2,car,van,485,941,414,730,456,316,0.9736741,3,0,2,0.6929824561403509,
12,2,car,van,485,948,416,761,463,345,0.95564747,3,0,2,0.7451403887688985,
13,2,car,van,485,942,410,739,457,329,0.94875216,3,0,2,0.7199124726477024,
14,2,car,van,487,951,414,764,464,350,0.95158833,3,0,2,0.7543103448275862,
15,2,car,van,489,955,409,769,466,360,0.95695746,3,0,2,0.7725321888412017,
16,2,car,van,496,948,415,764,452,349,0.9718963,3,0,2,0.7721238938053098,
17,2,car,van,488,953,416,761,465,345,0.97468466,3,0,2,0.7419354838709677,
18,2,car,van,483,955,415,763,472,348,0.9583383,3,0,2,0.7372881355932204,
19,2,car,van,488,940,412,737,452,325,0.9648091,3,0,2,0.7190265486725663,
20,2,car,van,484,957,412,766,473,354,0.95933455,3,0,2,0.7484143763213531,
21,2,car,van,488,949,417,759,461,342,0.9826786,3,0,2,0.7418655097613883,
22,2,car,van,482,959,414,763,477,349,0.888824,3,0,2,0.7316561844863732,
23,2,car,van,487,955,420,758,468,338,0.9463203,3,0,2,0.7222222222222222,
24,2,car,van,492,952,410,768,460,358,0.9421822,3,0,2,0.7782608695652173,
25,2,car,van,488,939,416,730,451,314,0.9661252,3,0,2,0.6962305986696231,
26,2,car,van,482,955,419,756,473,337,0.94365954,3,0,2,0.7124735729386892,
27,2,car,van,494,951,409,769,457,360,0.95296556,3,0,2,0.787746170678337,
28,2,car,van,487,960,415,764,473,349,0.9687263,3,0,2,0.7378435517970402,
29,2,car,van,479,962,412,769,483,357,0.95937186,3,0,2,0.7391304347826086,
30,2,car,van,484,935,412,738,451,326,0.9526533,3,0,2,0.7228381374722838,
31,2,car,van,482,944,410,736,462,326,0.97273606,3,0,2,0.7056277056277056,
32,2,car,van,480,940,415,734,460,319,0.96075284,3,0,2,0.6934782608695652,
33,2,car,van,486,953,415,763,467,348,0.95723224,3,0,2,0.7451820128479657,
34,2,car,van,492,948,412,767,456,355,0.9304319,3,0,2,0.7785087719298246,
35,2,car,van,489,956,411,768,467,357,0.906528,3,0,2,0.7644539614561028,
36,2,car,van,484,940,413,733,456,320,0.97553414,3,0,2,0.7017543859649122,
37,2,car,van,488,936,413,735,448,322,0.9737919,3,0,2,0.71875,
38,2,car,van,490,956,413,763,466,350,0.9481417,3,0,2,0.7510729613733905,
39,2,car,van,482,952,419,760,470,341,0.9468499,3,0,2,0.725531914893617,
40,2,car,van,590,944,439,693,354,254,0.9859484,3,0,2,0.7175141242937854,
41,2,car,van,589,949,437,697,360,260,0.98192203,3,0,2,0.7222222222222222,
42,2,car,van,590,946,439,698,356,259,0.96922255,3,0,2,0.7275280898876404,
0,2,car,van,486,939,414,735,453,321,0.9730841,3,0,2,0.7086092715231788,
1,2,car,van,489,940,411,737,451,326,0.94711137,3,0,2,0.7228381374722838,
2,2,car,van,488,954,411,769,466,358,0.9352239,3,0,2,0.7682403433476395,
3,2,car,van,487,955,409,768,468,359,0.96377707,3,0,2,0.7670940170940171,
4,2,car,van,483,953,413,767,470,354,0.95913815,3,0,2,0.7531914893617021,
5,2,car,van,483,955,410,769,472,359,0.95927954,3,0,2,0.760593220338983,
6,2,car,van,490,943,411,735,453,324,0.9208222,3,0,2,0.7152317880794702,
7,2,car,van,486,941,412,731,455,319,0.9610242,3,0,2,0.701098901098901,
8,2,car,van,487,953,415,761,466,346,0.97434527,3,0,2,0.7424892703862661,
9,2,car,van,486,938,416,730,452,314,0.9374376,3,0,2,0.6946902654867256,
10,2,car,van,491,949,411,769,458,358,0.9677114,3,0,2,0.7816593886462883,
11,2,car,van,485,955,412,768,470,356,0.8783675,3,0,2,0.7574468085106383,
12,2,car,van,485,941,414,730,456,316,0.9736741,3,0,2,0.6929824561403509,
13,2,car,van,485,948,416,761,463,345,0.95564747,3,0,2,0.7451403887688985,
14,2,car,van,485,942,410,739,457,329,0.94875216,3,0,2,0.7199124726477024,
15,2,car,van,487,951,414,764,464,350,0.95158833,3,0,2,0.7543103448275862,
16,2,car,van,489,955,409,769,466,360,0.95695746,3,0,2,0.7725321888412017,
17,2,car,van,496,948,415,764,452,349,0.9718963,3,0,2,0.7721238938053098,
18,2,car,van,488,953,416,761,465,345,0.97468466,3,0,2,0.7419354838709677,
19,2,car,van,483,955,415,763,472,348,0.9583383,3,0,2,0.7372881355932204,
20,2,car,van,488,940,412,737,452,325,0.9648091,3,0,2,0.7190265486725663,
21,2,car,van,484,957,412,766,473,354,0.95933455,3,0,2,0.7484143763213531,
22,2,car,van,488,949,417,759,461,342,0.9826786,3,0,2,0.7418655097613883,
23,2,car,van,482,959,414,763,477,349,0.888824,3,0,2,0.7316561844863732,
24,2,car,van,487,955,420,758,468,338,0.9463203,3,0,2,0.7222222222222222,
25,2,car,van,492,952,410,768,460,358,0.9421822,3,0,2,0.7782608695652173,
26,2,car,van,488,939,416,730,451,314,0.9661252,3,0,2,0.6962305986696231,
27,2,car,van,482,955,419,756,473,337,0.94365954,3,0,2,0.7124735729386892,
28,2,car,van,494,951,409,769,457,360,0.95296556,3,0,2,0.787746170678337,
29,2,car,van,487,960,415,764,473,349,0.9687263,3,0,2,0.7378435517970402,
30,2,car,van,479,962,412,769,483,357,0.95937186,3,0,2,0.7391304347826086,
31,2,car,van,484,935,412,738,451,326,0.9526533,3,0,2,0.7228381374722838,
32,2,car,van,482,944,410,736,462,326,0.97273606,3,0,2,0.7056277056277056,
33,2,car,van,480,940,415,734,460,319,0.96075284,3,0,2,0.6934782608695652,
34,2,car,van,486,953,415,763,467,348,0.95723224,3,0,2,0.7451820128479657,
35,2,car,van,492,948,412,767,456,355,0.9304319,3,0,2,0.7785087719298246,
36,2,car,van,489,956,411,768,467,357,0.906528,3,0,2,0.7644539614561028,
37,2,car,van,484,940,413,733,456,320,0.97553414,3,0,2,0.7017543859649122,
38,2,car,van,488,936,413,735,448,322,0.9737919,3,0,2,0.71875,
39,2,car,van,490,956,413,763,466,350,0.9481417,3,0,2,0.7510729613733905,
40,2,car,van,482,952,419,760,470,341,0.9468499,3,0,2,0.725531914893617,
41,2,car,van,590,944,439,693,354,254,0.9859484,3,0,2,0.7175141242937854,
42,2,car,van,589,949,437,697,360,260,0.98192203,3,0,2,0.7222222222222222,
43,2,car,van,590,946,439,698,356,259,0.96922255,3,0,2,0.7275280898876404,
0,2,car,van,488,936,413,735,448,322,0.9562123,3,0,2,0.71875,
1,2,car,van,486,939,414,735,453,321,0.9730841,3,0,2,0.7086092715231788,
2,2,car,van,489,940,411,737,451,326,0.94711137,3,0,2,0.7228381374722838,
3,2,car,van,488,954,411,769,466,358,0.9352239,3,0,2,0.7682403433476395,
4,2,car,van,487,955,409,768,468,359,0.96377707,3,0,2,0.7670940170940171,
5,2,car,van,483,953,413,767,470,354,0.95913815,3,0,2,0.7531914893617021,
6,2,car,van,483,955,410,769,472,359,0.95927954,3,0,2,0.760593220338983,
7,2,car,van,490,943,411,735,453,324,0.9208222,3,0,2,0.7152317880794702,
8,2,car,van,486,941,412,731,455,319,0.9610242,3,0,2,0.701098901098901,
9,2,car,van,487,953,415,761,466,346,0.97434527,3,0,2,0.7424892703862661,
10,2,car,van,486,938,416,730,452,314,0.9374376,3,0,2,0.6946902654867256,
11,2,car,van,491,949,411,769,458,358,0.9677114,3,0,2,0.7816593886462883,
12,2,car,van,485,955,412,768,470,356,0.8783675,3,0,2,0.7574468085106383,
13,2,car,van,485,941,414,730,456,316,0.9736741,3,0,2,0.6929824561403509,
14,2,car,van,485,948,416,761,463,345,0.95564747,3,0,2,0.7451403887688985,
15,2,car,van,485,942,410,739,457,329,0.94875216,3,0,2,0.7199124726477024,
16,2,car,van,487,951,414,764,464,350,0.95158833,3,0,2,0.7543103448275862,
17,2,car,van,489,955,409,769,466,360,0.95695746,3,0,2,0.7725321888412017,
18,2,car,van,496,948,415,764,452,349,0.9718963,3,0,2,0.7721238938053098,
19,2,car,van,488,953,416,761,465,345,0.97468466,3,0,2,0.7419354838709677,
20,2,car,van,483,955,415,763,472,348,0.9583383,3,0,2,0.7372881355932204,
21,2,car,van,488,940,412,737,452,325,0.9648091,3,0,2,0.7190265486725663,
22,2,car,van,484,957,412,766,473,354,0.95933455,3,0,2,0.7484143763213531,
23,2,car,van,488,949,417,759,461,342,0.9826786,3,0,2,0.7418655097613883,
24,2,car,van,482,959,414,763,477,349,0.888824,3,0,2,0.7316561844863732,
25,2,car,van,487,955,420,758,468,338,0.9463203,3,0,2,0.7222222222222222,
26,2,car,van,492,952,410,768,460,358,0.9421822,3,0,2,0.7782608695652173,
27,2,car,van,488,939,416,730,451,314,0.9661252,3,0,2,0.6962305986696231,
28,2,car,van,482,955,419,756,473,337,0.94365954,3,0,2,0.7124735729386892,
29,2,car,van,494,951,409,769,457,360,0.95296556,3,0,2,0.787746170678337,
30,2,car,van,487,960,415,764,473,349,0.9687263,3,0,2,0.7378435517970402,
31,2,car,van,479,962,412,769,483,357,0.95937186,3,0,2,0.7391304347826086,
32,2,car,van,484,935,412,738,451,326,0.9526533,3,0,2,0.7228381374722838,
33,2,car,van,482,944,410,736,462,326,0.97273606,3,0,2,0.7056277056277056,
34,2,car,van,480,940,415,734,460,319,0.96075284,3,0,2,0.6934782608695652,
35,2,car,van,486,953,415,763,467,348,0.95723224,3,0,2,0.7451820128479657,
36,2,car,van,492,948,412,767,456,355,0.9304319,3,0,2,0.7785087719298246,
37,2,car,van,489,956,411,768,467,357,0.906528,3,0,2,0.7644539614561028,
38,2,car,van,484,940,413,733,456,320,0.97553414,3,0,2,0.7017543859649122,
39,2,car,van,488,936,413,735,448,322,0.9737919,3,0,2,0.71875,
40,2,car,van,490,956,413,763,466,350,0.9481417,3,0,2,0.7510729613733905,
41,2,car,van,482,952,419,760,470,341,0.9468499,3,0,2,0.725531914893617,
42,2,car,van,590,944,439,693,354,254,0.9859484,3,0,2,0.7175141242937854,
43,2,car,van,589,949,437,697,360,260,0.98192203,3,0,2,0.7222222222222222,
44,2,car,van,590,946,439,698,356,259,0.96922255,3,0,2,0.7275280898876404,
0,2,car,van,486,954,414,764,468,350,0.9754412,3,0,2,0.7478632478632479,
1,2,car,van,488,936,413,735,448,322,0.9562123,3,0,2,0.71875,
2,2,car,van,486,939,414,735,453,321,0.9730841,3,0,2,0.7086092715231788,
3,2,car,van,489,940,411,737,451,326,0.94711137,3,0,2,0.7228381374722838,
4,2,car,van,488,954,411,769,466,358,0.9352239,3,0,2,0.7682403433476395,
5,2,car,van,487,955,409,768,468,359,0.96377707,3,0,2,0.7670940170940171,
6,2,car,van,483,953,413,767,470,354,0.95913815,3,0,2,0.7531914893617021,
7,2,car,van,483,955,410,769,472,359,0.95927954,3,0,2,0.760593220338983,
8,2,car,van,490,943,411,735,453,324,0.9208222,3,0,2,0.7152317880794702,
9,2,car,van,486,941,412,731,455,319,0.9610242,3,0,2,0.701098901098901,
10,2,car,van,487,953,415,761,466,346,0.97434527,3,0,2,0.7424892703862661,
11,2,car,van,486,938,416,730,452,314,0.9374376,3,0,2,0.6946902654867256,
12,2,car,van,491,949,411,769,458,358,0.9677114,3,0,2,0.7816593886462883,
13,2,car,van,485,955,412,768,470,356,0.8783675,3,0,2,0.7574468085106383,
14,2,car,van,485,941,414,730,456,316,0.9736741,3,0,2,0.6929824561403509,
15,2,car,van,485,948,416,761,463,345,0.95564747,3,0,2,0.7451403887688985,
16,2,car,van,485,942,410,739,457,329,0.94875216,3,0,2,0.7199124726477024,
17,2,car,van,487,951,414,764,464,350,0.95158833,3,0,2,0.7543103448275862,
18,2,car,van,489,955,409,769,466,360,0.95695746,3,0,2,0.7725321888412017,
19,2,car,van,496,948,415,764,452,349,0.9718963,3,0,2,0.7721238938053098,
20,2,car,van,488,953,416,761,465,345,0.97468466,3,0,2,0.7419354838709677,
21,2,car,van,483,955,415,763,472,348,0.9583383,3,0,2,0.7372881355932204,
22,2,car,van,488,940,412,737,452,325,0.9648091,3,0,2,0.7190265486725663,
23,2,car,van,484,957,412,766,473,354,0.95933455,3,0,2,0.7484143763213531,
24,2,car,van,488,949,417,759,461,342,0.9826786,3,0,2,0.7418655097613883,
25,2,car,van,482,959,414,763,477,349,0.888824,3,0,2,0.7316561844863732,
26,2,car,van,487,955,420,758,468,338,0.9463203,3,0,2,0.7222222222222222,
27,2,car,van,492,952,410,768,460,358,0.9421822,3,0,2,0.7782608695652173,
28,2,car,van,488,939,416,730,451,314,0.9661252,3,0,2,0.6962305986696231,
29,2,car,van,482,955,419,756,473,337,0.94365954,3,0,2,0.7124735729386892,
30,2,car,van,494,951,409,769,457,360,0.95296556,3,0,2,0.787746170678337,
31,2,car,van,487,960,415,764,473,349,0.9687263,3,0,2,0.7378435517970402,
32,2,car,van,479,962,412,769,483,357,0.95937186,3,0,2,0.7391304347826086,
33,2,car,van,484,935,412,738,451,326,0.9526533,3,0,2,0.7228381374722838,
34,2,car,van,482,944,410,736,462,326,0.97273606,3,0,2,0.7056277056277056,
35,2,car,van,480,940,415,734,460,319,0.96075284,3,0,2,0.6934782608695652,
36,2,car,van,486,953,415,763,467,348,0.95723224,3,0,2,0.7451820128479657,
37,2,car,van,492,948,412,767,456,355,0.9304319,3,0,2,0.7785087719298246,
38,2,car,van,489,956,411,768,467,357,0.906528,3,0,2,0.7644539614561028,
39,2,car,van,484,940,413,733,456,320,0.97553414,3,0,2,0.7017543859649122,
40,2,car,van,488,936,413,735,448,322,0.9737919,3,0,2,0.71875,
41,2,car,van,490,956,413,763,466,350,0.9481417,3,0,2,0.7510729613733905,
42,2,car,van,482,952,419,760,470,341,0.9468499,3,0,2,0.725531914893617,
43,2,car,van,590,944,439,693,354,254,0.9859484,3,0,2,0.7175141242937854,
44,2,car,van,589,949,437,697,360,260,0.98192203,3,0,2,0.7222222222222222,
45,2,car,van,590,946,439,698,356,259,0.96922255,3,0,2,0.7275280898876404,
0,2,car,van,488,957,416,762,469,346,0.97819936,3,0,2,0.7377398720682303,
1,2,car,van,486,954,414,764,468,350,0.9754412,3,0,2,0.7478632478632479,
2,2,car,van,488,936,413,735,448,322,0.9562123,3,0,2,0.71875,
3,2,car,van,486,939,414,735,453,321,0.9730841,3,0,2,0.7086092715231788,
4,2,car,van,489,940,411,737,451,326,0.94711137,3,0,2,0.7228381374722838,
5,2,car,van,488,954,411,769,466,358,0.9352239,3,0,2,0.7682403433476395,
6,2,car,van,487,955,409,768,468,359,0.96377707,3,0,2,0.7670940170940171,
7,2,car,van,483,953,413,767,470,354,0.95913815,3,0,2,0.7531914893617021,
8,2,car,van,483,955,410,769,472,359,0.95927954,3,0,2,0.760593220338983,
9,2,car,van,490,943,411,735,453,324,0.9208222,3,0,2,0.7152317880794702,
10,2,car,van,486,941,412,731,455,319,0.9610242,3,0,2,0.701098901098901,
11,2,car,van,487,953,415,761,466,346,0.97434527,3,0,2,0.7424892703862661,
12,2,car,van,486,938,416,730,452,314,0.9374376,3,0,2,0.6946902654867256,
13,2,car,van,491,949,411,769,458,358,0.9677114,3,0,2,0.7816593886462883,
14,2,car,van,485,955,412,768,470,356,0.8783675,3,0,2,0.7574468085106383,
15,2,car,van,485,941,414,730,456,316,0.9736741,3,0,2,0.6929824561403509,
16,2,car,van,485,948,416,761,463,345,0.95564747,3,0,2,0.7451403887688985,
17,2,car,van,485,942,410,739,457,329,0.94875216,3,0,2,0.7199124726477024,
18,2,car,van,487,951,414,764,464,350,0.95158833,3,0,2,0.7543103448275862,
19,2,car,van,489,955,409,769,466,360,0.95695746,3,0,2,0.7725321888412017,
20,2,car,van,496,948,415,764,452,349,0.9718963,3,0,2,0.7721238938053098,
21,2,car,van,488,953,416,761,465,345,0.97468466,3,0,2,0.7419354838709677,
22,2,car,van,483,955,415,763,472,348,0.9583383,3,0,2,0.7372881355932204,
23,2,car,van,488,940,412,737,452,325,0.9648091,3,0,2,0.7190265486725663,
24,2,car,van,484,957,412,766,473,354,0.95933455,3,0,2,0.7484143763213531,
25,2,car,van,488,949,417,759,461,342,0.9826786,3,0,2,0.7418655097613883,
26,2,car,van,482,959,414,763,477,349,0.888824,3,0,2,0.7316561844863732,
27,2,car,van,487,955,420,758,468,338,0.9463203,3,0,2,0.7222222222222222,
28,2,car,van,492,952,410,768,460,358,0.9421822,3,0,2,0.7782608695652173,
29,2,car,van,488,939,416,730,451,314,0.9661252,3,0,2,0.6962305986696231,
30,2,car,van,482,955,419,756,473,337,0.94365954,3,0,2,0.7124735729386892,
31,2,car,van,494,951,409,769,457,360,0.95296556,3,0,2,0.787746170678337,
32,2,car,van,487,960,415,764,473,349,0.9687263,3,0,2,0.7378435517970402,
33,2,car,van,479,962,412,769,483,357,0.95937186,3,0,2,0.7391304347826086,
34,2,car,van,484,935,412,738,451,326,0.9526533,3,0,2,0.7228381374722838,
35,2,car,van,482,944,410,736,462,326,0.97273606,3,0,2,0.7056277056277056,
36,2,car,van,480,940,415,734,460,319,0.96075284,3,0,2,0.6934782608695652,
37,2,car,van,486,953,415,763,467,348,0.95723224,3,0,2,0.7451820128479657,
38,2,car,van,492,948,412,767,456,355,0.9304319,3,0,2,0.7785087719298246,
39,2,car,van,489,956,411,768,467,357,0.906528,3,0,2,0.7644539614561028,
40,2,car,van,484,940,413,733,456,320,0.97553414,3,0,2,0.7017543859649122,
41,2,car,van,488,936,413,735,448,322,0.9737919,3,0,2,0.71875,
42,2,car,van,490,956,413,763,466,350,0.9481417,3,0,2,0.7510729613733905,
43,2,car,van,482,952,419,760,470,341,0.9468499,3,0,2,0.725531914893617,
44,2,car,van,590,944,439,693,354,254,0.9859484,3,0,2,0.7175141242937854,
45,2,car,van,589,949,437,697,360,260,0.98192203,3,0,2,0.7222222222222222,
46,2,car,van,590,946,439,698,356,259,0.96922255,3,0,2,0.7275280898876404,
0,2,car,van,488,938,413,738,450,325,0.94057816,3,0,2,0.7222222222222222,
1,2,car,van,488,957,416,762,469,346,0.97819936,3,0,2,0.7377398720682303,
2,2,car,van,486,954,414,764,468,350,0.9754412,3,0,2,0.7478632478632479,
3,2,car,van,488,936,413,735,448,322,0.9562123,3,0,2,0.71875,
4,2,car,van,486,939,414,735,453,321,0.9730841,3,0,2,0.7086092715231788,
5,2,car,van,489,940,411,737,451,326,0.94711137,3,0,2,0.7228381374722838,
6,2,car,van,488,954,411,769,466,358,0.9352239,3,0,2,0.7682403433476395,
7,2,car,van,487,955,409,768,468,359,0.96377707,3,0,2,0.7670940170940171,
8,2,car,van,483,953,413,767,470,354,0.95913815,3,0,2,0.7531914893617021,
9,2,car,van,483,955,410,769,472,359,0.95927954,3,0,2,0.760593220338983,
10,2,car,van,490,943,411,735,453,324,0.9208222,3,0,2,0.7152317880794702,
11,2,car,van,486,941,412,731,455,319,0.9610242,3,0,2,0.701098901098901,
12,2,car,van,487,953,415,761,466,346,0.97434527,3,0,2,0.7424892703862661,
13,2,car,van,486,938,416,730,452,314,0.9374376,3,0,2,0.6946902654867256,
14,2,car,van,491,949,411,769,458,358,0.9677114,3,0,2,0.7816593886462883,
15,2,car,van,485,955,412,768,470,356,0.8783675,3,0,2,0.7574468085106383,
16,2,car,van,485,941,414,730,456,316,0.9736741,3,0,2,0.6929824561403509,
17,2,car,van,485,948,416,761,463,345,0.95564747,3,0,2,0.7451403887688985,
18,2,car,van,485,942,410,739,457,329,0.94875216,3,0,2,0.7199124726477024,
19,2,car,van,487,951,414,764,464,350,0.95158833,3,0,2,0.7543103448275862,
20,2,car,van,489,955,409,769,466,360,0.95695746,3,0,2,0.7725321888412017,
21,2,car,van,496,948,415,764,452,349,0.9718963,3,0,2,0.7721238938053098,
22,2,car,van,488,953,416,761,465,345,0.97468466,3,0,2,0.7419354838709677,
23,2,car,van,483,955,415,763,472,348,0.9583383,3,0,2,0.7372881355932204,
24,2,car,van,488,940,412,737,452,325,0.9648091,3,0,2,0.7190265486725663,
25,2,car,van,484,957,412,766,473,354,0.95933455,3,0,2,0.7484143763213531,
26,2,car,van,488,949,417,759,461,342,0.9826786,3,0,2,0.7418655097613883,
27,2,car,van,482,959,414,763,477,349,0.888824,3,0,2,0.7316561844863732,
28,2,car,van,487,955,420,758,468,338,0.9463203,3,0,2,0.7222222222222222,
29,2,car,van,492,952,410,768,460,358,0.9421822,3,0,2,0.7782608695652173,
30,2,car,van,488,939,416,730,451,314,0.9661252,3,0,2,0.6962305986696231,
31,2,car,van,482,955,419,756,473,337,0.94365954,3,0,2,0.7124735729386892,
32,2,car,van,494,951,409,769,457,360,0.95296556,3,0,2,0.787746170678337,
33,2,car,van,487,960,415,764,473,349,0.9687263,3,0,2,0.7378435517970402,
34,2,car,van,479,962,412,769,483,357,0.95937186,3,0,2,0.7391304347826086,
35,2,car,van,484,935,412,738,451,326,0.9526533,3,0,2,0.7228381374722838,
36,2,car,van,482,944,410,736,462,326,0.97273606,3,0,2,0.7056277056277056,
37,2,car,van,480,940,415,734,460,319,0.96075284,3,0,2,0.6934782608695652,
38,2,car,van,486,953,415,763,467,348,0.95723224,3,0,2,0.7451820128479657,
39,2,car,van,492,948,412,767,456,355,0.9304319,3,0,2,0.7785087719298246,
40,2,car,van,489,956,411,768,467,357,0.906528,3,0,2,0.7644539614561028,
41,2,car,van,484,940,413,733,456,320,0.97553414,3,0,2,0.7017543859649122,
42,2,car,van,488,936,413,735,448,322,0.9737919,3,0,2,0.71875,
43,2,car,van,490,956,413,763,466,350,0.9481417,3,0,2,0.7510729613733905,
44,2,car,van,482,952,419,760,470,341,0.9468499,3,0,2,0.725531914893617,
45,2,car,van,590,944,439,693,354,254,0.9859484,3,0,2,0.7175141242937854,
46,2,car,van,589,949,437,697,360,260,0.98192203,3,0,2,0.7222222222222222,
47,2,car,van,590,946,439,698,356,259,0.96922255,3,0,2,0.7275280898876404,
0,2,car,van,490,956,409,768,466,359,0.9676818,3,0,2,0.7703862660944206,
1,2,car,van,488,938,413,738,450,325,0.94057816,3,0,2,0.7222222222222222,
2,2,car,van,488,957,416,762,469,346,0.97819936,3,0,2,0.7377398720682303,
3,2,car,van,486,954,414,764,468,350,0.9754412,3,0,2,0.7478632478632479,
4,2,car,van,488,936,413,735,448,322,0.9562123,3,0,2,0.71875,
5,2,car,van,486,939,414,735,453,321,0.9730841,3,0,2,0.7086092715231788,
6,2,car,van,489,940,411,737,451,326,0.94711137,3,0,2,0.7228381374722838,
7,2,car,van,488,954,411,769,466,358,0.9352239,3,0,2,0.7682403433476395,
8,2,car,van,487,955,409,768,468,359,0.96377707,3,0,2,0.7670940170940171,
9,2,car,van,483,953,413,767,470,354,0.95913815,3,0,2,0.7531914893617021,
10,2,car,van,483,955,410,769,472,359,0.95927954,3,0,2,0.760593220338983,
11,2,car,van,490,943,411,735,453,324,0.9208222,3,0,2,0.7152317880794702,
12,2,car,van,486,941,412,731,455,319,0.9610242,3,0,2,0.701098901098901,
13,2,car,van,487,953,415,761,466,346,0.97434527,3,0,2,0.7424892703862661,
14,2,car,van,486,938,416,730,452,314,0.9374376,3,0,2,0.6946902654867256,
15,2,car,van,491,949,411,769,458,358,0.9677114,3,0,2,0.7816593886462883,
16,2,car,van,485,955,412,768,470,356,0.8783675,3,0,2,0.7574468085106383,
17,2,car,van,485,941,414,730,456,316,0.9736741,3,0,2,0.6929824561403509,
18,2,car,van,485,948,416,761,463,345,0.95564747,3,0,2,0.7451403887688985,
19,2,car,van,485,942,410,739,457,329,0.94875216,3,0,2,0.7199124726477024,
20,2,car,van,487,951,414,764,464,350,0.95158833,3,0,2,0.7543103448275862,
21,2,car,van,489,955,409,769,466,360,0.95695746,3,0,2,0.7725321888412017,
22,2,car,van,496,948,415,764,452,349,0.9718963,3,0,2,0.7721238938053098,
23,2,car,van,488,953,416,761,465,345,0.97468466,3,0,2,0.7419354838709677,
24,2,car,van,483,955,415,763,472,348,0.9583383,3,0,2,0.7372881355932204,
25,2,car,van,488,940,412,737,452,325,0.9648091,3,0,2,0.7190265486725663,
26,2,car,van,484,957,412,766,473,354,0.95933455,3,0,2,0.7484143763213531,
27,2,car,van,488,949,417,759,461,342,0.9826786,3,0,2,0.7418655097613883,
28,2,car,van,482,959,414,763,477,349,0.888824,3,0,2,0.7316561844863732,
29,2,car,van,487,955,420,758,468,338,0.9463203,3,0,2,0.7222222222222222,
30,2,car,van,492,952,410,768,460,358,0.9421822,3,0,2,0.7782608695652173,
31,2,car,van,488,939,416,730,451,314,0.9661252,3,0,2,0.6962305986696231,
32,2,car,van,482,955,419,756,473,337,0.94365954,3,0,2,0.7124735729386892,
33,2,car,van,494,951,409,769,457,360,0.95296556,3,0,2,0.787746170678337,
34,2,car,van,487,960,415,764,473,349,0.9687263,3,0,2,0.7378435517970402,
35,2,car,van,479,962,412,769,483,357,0.95937186,3,0,2,0.7391304347826086,
36,2,car,van,484,935,412,738,451,326,0.9526533,3,0,2,0.7228381374722838,
37,2,car,van,482,944,410,736,462,326,0.97273606,3,0,2,0.7056277056277056,
38,2,car,van,480,940,415,734,460,319,0.96075284,3,0,2,0.6934782608695652,
39,2,car,van,486,953,415,763,467,348,0.95723224,3,0,2,0.7451820128479657,
40,2,car,van,492,948,412,767,456,355,0.9304319,3,0,2,0.7785087719298246,
41,2,car,van,489,956,411,768,467,357,0.906528,3,0,2,0.7644539614561028,
42,2,car,van,484,940,413,733,456,320,0.97553414,3,0,2,0.7017543859649122,
43,2,car,van,488,936,413,735,448,322,0.9737919,3,0,2,0.71875,
44,2,car,van,490,956,413,763,466,350,0.9481417,3,0,2,0.7510729613733905,
45,2,car,van,482,952,419,760,470,341,0.9468499,3,0,2,0.725531914893617,
46,2,car,van,590,944,439,693,354,254,0.9859484,3,0,2,0.7175141242937854,
47,2,car,van,589,949,437,697,360,260,0.98192203,3,0,2,0.7222222222222222,
48,2,car,van,590,946,439,698,356,259,0.96922255,3,0,2,0.7275280898876404,
0,2,car,van,492,952,415,762,460,347,0.97278863,3,0,2,0.7543478260869565,
1,2,car,van,490,956,409,768,466,359,0.9676818,3,0,2,0.7703862660944206,
2,2,car,van,488,938,413,738,450,325,0.94057816,3,0,2,0.7222222222222222,
3,2,car,van,488,957,416,762,469,346,0.97819936,3,0,2,0.7377398720682303,
4,2,car,van,486,954,414,764,468,350,0.9754412,3,0,2,0.7478632478632479,
5,2,car,van,488,936,413,735,448,322,0.9562123,3,0,2,0.71875,
6,2,car,van,486,939,414,735,453,321,0.9730841,3,0,2,0.7086092715231788,
7,2,car,van,489,940,411,737,451,326,0.94711137,3,0,2,0.7228381374722838,
8,2,car,van,488,954,411,769,466,358,0.9352239,3,0,2,0.7682403433476395,
9,2,car,van,487,955,409,768,468,359,0.96377707,3,0,2,0.7670940170940171,
10,2,car,van,483,953,413,767,470,354,0.95913815,3,0,2,0.7531914893617021,
11,2,car,van,483,955,410,769,472,359,0.95927954,3,0,2,0.760593220338983,
12,2,car,van,490,943,411,735,453,324,0.9208222,3,0,2,0.7152317880794702,
13,2,car,van,486,941,412,731,455,319,0.9610242,3,0,2,0.701098901098901,
14,2,car,van,487,953,415,761,466,346,0.97434527,3,0,2,0.7424892703862661,
15,2,car,van,486,938,416,730,452,314,0.9374376,3,0,2,0.6946902654867256,
16,2,car,van,491,949,411,769,458,358,0.9677114,3,0,2,0.7816593886462883,
17,2,car,van,485,955,412,768,470,356,0.8783675,3,0,2,0.7574468085106383,
18,2,car,van,485,941,414,730,456,316,0.9736741,3,0,2,0.6929824561403509,
19,2,car,van,485,948,416,761,463,345,0.95564747,3,0,2,0.7451403887688985,
20,2,car,van,485,942,410,739,457,329,0.94875216,3,0,2,0.7199124726477024,
21,2,car,van,487,951,414,764,464,350,0.95158833,3,0,2,0.7543103448275862,
22,2,car,van,489,955,409,769,466,360,0.95695746,3,0,2,0.7725321888412017,
23,2,car,van,496,948,415,764,452,349,0.9718963,3,0,2,0.7721238938053098,
24,2,car,van,488,953,416,761,465,345,0.97468466,3,0,2,0.7419354838709677,
25,2,car,van,483,955,415,763,472,348,0.9583383,3,0,2,0.7372881355932204,
26,2,car,van,488,940,412,737,452,325,0.9648091,3,0,2,0.7190265486725663,
27,2,car,van,484,957,412,766,473,354,0.95933455,3,0,2,0.7484143763213531,
28,2,car,van,488,949,417,759,461,342,0.9826786,3,0,2,0.7418655097613883,
29,2,car,van,482,959,414,763,477,349,0.888824,3,0,2,0.7316561844863732,
30,2,car,van,487,955,420,758,468,338,0.9463203,3,0,2,0.7222222222222222,
31,2,car,van,492,952,410,768,460,358,0.9421822,3,0,2,0.7782608695652173,
32,2,car,van,488,939,416,730,451,314,0.9661252,3,0,2,0.6962305986696231,
33,2,car,van,482,955,419,756,473,337,0.94365954,3,0,2,0.7124735729386892,
34,2,car,van,494,951,409,769,457,360,0.95296556,3,0,2,0.787746170678337,
35,2,car,van,487,960,415,764,473,349,0.9687263,3,0,2,0.7378435517970402,
36,2,car,van,479,962,412,769,483,357,0.95937186,3,0,2,0.7391304347826086,
37,2,car,van,484,935,412,738,451,326,0.9526533,3,0,2,0.7228381374722838,
38,2,car,van,482,944,410,736,462,326,0.97273606,3,0,2,0.7056277056277056,
39,2,car,van,480,940,415,734,460,319,0.96075284,3,0,2,0.6934782608695652,
40,2,car,van,486,953,415,763,467,348,0.95723224,3,0,2,0.7451820128479657,
41,2,car,van,492,948,412,767,456,355,0.9304319,3,0,2,0.7785087719298246,
42,2,car,van,489,956,411,768,467,357,0.906528,3,0,2,0.7644539614561028,
43,2,car,van,484,940,413,733,456,320,0.97553414,3,0,2,0.7017543859649122,
44,2,car,van,488,936,413,735,448,322,0.9737919,3,0,2,0.71875,
45,2,car,van,490,956,413,763,466,350,0.9481417,3,0,2,0.7510729613733905,
46,2,car,van,482,952,419,760,470,341,0.9468499,3,0,2,0.725531914893617,
47,2,car,van,590,944,439,693,354,254,0.9859484,3,0,2,0.7175141242937854,
48,2,car,van,589,949,437,697,360,260,0.98192203,3,0,2,0.7222222222222222,
49,2,car,van,590,946,439,698,356,259,0.96922255,3,0,2,0.7275280898876404,
0,2,car,van,489,957,420,756,468,336,0.97189754,3,0,2,0.717948717948718,
1,2,car,van,492,952,415,762,460,347,0.97278863,3,0,2,0.7543478260869565,
2,2,car,van,490,956,409,768,466,359,0.9676818,3,0,2,0.7703862660944206,
3,2,car,van,488,938,413,738,450,325,0.94057816,3,0,2,0.7222222222222222,
4,2,car,van,488,957,416,762,469,346,0.97819936,3,0,2,0.7377398720682303,
5,2,car,van,486,954,414,764,468,350,0.9754412,3,0,2,0.7478632478632479,
6,2,car,van,488,936,413,735,448,322,0.9562123,3,0,2,0.71875,
7,2,car,van,486,939,414,735,453,321,0.9730841,3,0,2,0.7086092715231788,
8,2,car,van,489,940,411,737,451,326,0.94711137,3,0,2,0.7228381374722838,
9,2,car,van,488,954,411,769,466,358,0.9352239,3,0,2,0.7682403433476395,
10,2,car,van,487,955,409,768,468,359,0.96377707,3,0,2,0.7670940170940171,
11,2,car,van,483,953,413,767,470,354,0.95913815,3,0,2,0.7531914893617021,
12,2,car,van,483,955,410,769,472,359,0.95927954,3,0,2,0.760593220338983,
13,2,car,van,490,943,411,735,453,324,0.9208222,3,0,2,0.7152317880794702,
14,2,car,van,486,941,412,731,455,319,0.9610242,3,0,2,0.701098901098901,
15,2,car,van,487,953,415,761,466,346,0.97434527,3,0,2,0.7424892703862661,
16,2,car,van,486,938,416,730,452,314,0.9374376,3,0,2,0.6946902654867256,
17,2,car,van,491,949,411,769,458,358,0.9677114,3,0,2,0.7816593886462883,
18,2,car,van,485,955,412,768,470,356,0.8783675,3,0,2,0.7574468085106383,
19,2,car,van,485,941,414,730,456,316,0.9736741,3,0,2,0.6929824561403509,
20,2,car,van,485,948,416,761,463,345,0.95564747,3,0,2,0.7451403887688985,
21,2,car,van,485,942,410,739,457,329,0.94875216,3,0,2,0.7199124726477024,
22,2,car,van,487,951,414,764,464,350,0.95158833,3,0,2,0.7543103448275862,
23,2,car,van,489,955,409,769,466,360,0.95695746,3,0,2,0.7725321888412017,
24,2,car,van,496,948,415,764,452,349,0.9718963,3,0,2,0.7721238938053098,
25,2,car,van,488,953,416,761,465,345,0.97468466,3,0,2,0.7419354838709677,
26,2,car,van,483,955,415,763,472,348,0.9583383,3,0,2,0.7372881355932204,
27,2,car,van,488,940,412,737,452,325,0.9648091,3,0,2,0.7190265486725663,
28,2,car,van,484,957,412,766,473,354,0.95933455,3,0,2,0.7484143763213531,
29,2,car,van,488,949,417,759,461,342,0.9826786,3,0,2,0.7418655097613883,
30,2,car,van,482,959,414,763,477,349,0.888824,3,0,2,0.7316561844863732,
31,2,car,van,487,955,420,758,468,338,0.9463203,3,0,2,0.7222222222222222,
32,2,car,van,492,952,410,768,460,358,0.9421822,3,0,2,0.7782608695652173,
33,2,car,van,488,939,416,730,451,314,0.9661252,3,0,2,0.6962305986696231,
34,2,car,van,482,955,419,756,473,337,0.94365954,3,0,2,0.7124735729386892,
35,2,car,van,494,951,409,769,457,360,0.95296556,3,0,2,0.787746170678337,
36,2,car,van,487,960,415,764,473,349,0.9687263,3,0,2,0.7378435517970402,
37,2,car,van,479,962,412,769,483,357,0.95937186,3,0,2,0.7391304347826086,
38,2,car,van,484,935,412,738,451,326,0.9526533,3,0,2,0.7228381374722838,
39,2,car,van,482,944,410,736,462,326,0.97273606,3,0,2,0.7056277056277056,
40,2,car,van,480,940,415,734,460,319,0.96075284,3,0,2,0.6934782608695652,
41,2,car,van,486,953,415,763,467,348,0.95723224,3,0,2,0.7451820128479657,
42,2,car,van,492,948,412,767,456,355,0.9304319,3,0,2,0.7785087719298246,
43,2,car,van,489,956,411,768,467,357,0.906528,3,0,2,0.7644539614561028,
44,2,car,van,484,940,413,733,456,320,0.97553414,3,0,2,0.7017543859649122,
45,2,car,van,488,936,413,735,448,322,0.9737919,3,0,2,0.71875,
46,2,car,van,490,956,413,763,466,350,0.9481417,3,0,2,0.7510729613733905,
47,2,car,van,482,952,419,760,470,341,0.9468499,3,0,2,0.725531914893617,
48,2,car,van,590,944,439,693,354,254,0.9859484,3,0,2,0.7175141242937854,
49,2,car,van,589,949,437,697,360,260,0.98192203,3,0,2,0.7222222222222222,
50,2,car,van,590,946,439,698,356,259,0.96922255,3,0,2,0.7275280898876404,
0,2,car,van,484,955,411,765,471,354,0.967853,3,0,2,0.7515923566878981,
1,2,car,van,489,957,420,756,468,336,0.97189754,3,0,2,0.717948717948718,
2,2,car,van,492,952,415,762,460,347,0.97278863,3,0,2,0.7543478260869565,
3,2,car,van,490,956,409,768,466,359,0.9676818,3,0,2,0.7703862660944206,
4,2,car,van,488,938,413,738,450,325,0.94057816,3,0,2,0.7222222222222222,
5,2,car,van,488,957,416,762,469,346,0.97819936,3,0,2,0.7377398720682303,
6,2,car,van,486,954,414,764,468,350,0.9754412,3,0,2,0.7478632478632479,
7,2,car,van,488,936,413,735,448,322,0.9562123,3,0,2,0.71875,
8,2,car,van,486,939,414,735,453,321,0.9730841,3,0,2,0.7086092715231788,
9,2,car,van,489,940,411,737,451,326,0.94711137,3,0,2,0.7228381374722838,
10,2,car,van,488,954,411,769,466,358,0.9352239,3,0,2,0.7682403433476395,
11,2,car,van,487,955,409,768,468,359,0.96377707,3,0,2,0.7670940170940171,
12,2,car,van,483,953,413,767,470,354,0.95913815,3,0,2,0.7531914893617021,
13,2,car,van,483,955,410,769,472,359,0.95927954,3,0,2,0.760593220338983,
14,2,car,van,490,943,411,735,453,324,0.9208222,3,0,2,0.7152317880794702,
15,2,car,van,486,941,412,731,455,319,0.9610242,3,0,2,0.701098901098901,
16,2,car,van,487,953,415,761,466,346,0.97434527,3,0,2,0.7424892703862661,
17,2,car,van,486,938,416,730,452,314,0.9374376,3,0,2,0.6946902654867256,
18,2,car,van,491,949,411,769,458,358,0.9677114,3,0,2,0.7816593886462883,
19,2,car,van,485,955,412,768,470,356,0.8783675,3,0,2,0.7574468085106383,
20,2,car,van,485,941,414,730,456,316,0.9736741,3,0,2,0.6929824561403509,
21,2,car,van,485,948,416,761,463,345,0.95564747,3,0,2,0.7451403887688985,
22,2,car,van,485,942,410,739,457,329,0.94875216,3,0,2,0.7199124726477024,
23,2,car,van,487,951,414,764,464,350,0.95158833,3,0,2,0.7543103448275862,
24,2,car,van,489,955,409,769,466,360,0.95695746,3,0,2,0.7725321888412017,
25,2,car,van,496,948,415,764,452,349,0.9718963,3,0,2,0.7721238938053098,
26,2,car,van,488,953,416,761,465,345,0.97468466,3,0,2,0.7419354838709677,
27,2,car,van,483,955,415,763,472,348,0.9583383,3,0,2,0.7372881355932204,
28,2,car,van,488,940,412,737,452,325,0.9648091,3,0,2,0.7190265486725663,
29,2,car,van,484,957,412,766,473,354,0.95933455,3,0,2,0.7484143763213531,
30,2,car,van,488,949,417,759,461,342,0.9826786,3,0,2,0.7418655097613883,
31,2,car,van,482,959,414,763,477,349,0.888824,3,0,2,0.7316561844863732,
32,2,car,van,487,955,420,758,468,338,0.9463203,3,0,2,0.7222222222222222,
33,2,car,van,492,952,410,768,460,358,0.9421822,3,0,2,0.7782608695652173,
34,2,car,van,488,939,416,730,451,314,0.9661252,3,0,2,0.6962305986696231,
35,2,car,van,482,955,419,756,473,337,0.94365954,3,0,2,0.7124735729386892,
36,2,car,van,494,951,409,769,457,360,0.95296556,3,0,2,0.787746170678337,
37,2,car,van,487,960,415,764,473,349,0.9687263,3,0,2,0.7378435517970402,
38,2,car,van,479,962,412,769,483,357,0.95937186,3,0,2,0.7391304347826086,
39,2,car,van,484,935,412,738,451,326,0.9526533,3,0,2,0.7228381374722838,
40,2,car,van,482,944,410,736,462,326,0.97273606,3,0,2,0.7056277056277056,
41,2,car,van,480,940,415,734,460,319,0.96075284,3,0,2,0.6934782608695652,
42,2,car,van,486,953,415,763,467,348,0.95723224,3,0,2,0.7451820128479657,
43,2,car,van,492,948,412,767,456,355,0.9304319,3,0,2,0.7785087719298246,
44,2,car,van,489,956,411,768,467,357,0.906528,3,0,2,0.7644539614561028,
45,2,car,van,484,940,413,733,456,320,0.97553414,3,0,2,0.7017543859649122,
46,2,car,van,488,936,413,735,448,322,0.9737919,3,0,2,0.71875,
47,2,car,van,490,956,413,763,466,350,0.9481417,3,0,2,0.7510729613733905,
48,2,car,van,482,952,419,760,470,341,0.9468499,3,0,2,0.725531914893617,
49,2,car,van,590,944,439,693,354,254,0.9859484,3,0,2,0.7175141242937854,
50,2,car,van,589,949,437,697,360,260,0.98192203,3,0,2,0.7222222222222222,
51,2,car,van,590,946,439,698,356,259,0.96922255,3,0,2,0.7275280898876404,
0,2,car,van,485,938,414,732,453,318,0.9526754,3,0,2,0.7019867549668874,
1,2,car,van,484,955,411,765,471,354,0.967853,3,0,2,0.7515923566878981,
2,2,car,van,489,957,420,756,468,336,0.97189754,3,0,2,0.717948717948718,
3,2,car,van,492,952,415,762,460,347,0.97278863,3,0,2,0.7543478260869565,
4,2,car,van,490,956,409,768,466,359,0.9676818,3,0,2,0.7703862660944206,
5,2,car,van,488,938,413,738,450,325,0.94057816,3,0,2,0.7222222222222222,
6,2,car,van,488,957,416,762,469,346,0.97819936,3,0,2,0.7377398720682303,
7,2,car,van,486,954,414,764,468,350,0.9754412,3,0,2,0.7478632478632479,
8,2,car,van,488,936,413,735,448,322,0.9562123,3,0,2,0.71875,
9,2,car,van,486,939,414,735,453,321,0.9730841,3,0,2,0.7086092715231788,
10,2,car,van,489,940,411,737,451,326,0.94711137,3,0,2,0.7228381374722838,
11,2,car,van,488,954,411,769,466,358,0.9352239,3,0,2,0.7682403433476395,
12,2,car,van,487,955,409,768,468,359,0.96377707,3,0,2,0.7670940170940171,
13,2,car,van,483,953,413,767,470,354,0.95913815,3,0,2,0.7531914893617021,
14,2,car,van,483,955,410,769,472,359,0.95927954,3,0,2,0.760593220338983,
15,2,car,van,490,943,411,735,453,324,0.9208222,3,0,2,0.7152317880794702,
16,2,car,van,486,941,412,731,455,319,0.9610242,3,0,2,0.701098901098901,
17,2,car,van,487,953,415,761,466,346,0.97434527,3,0,2,0.7424892703862661,
18,2,car,van,486,938,416,730,452,314,0.9374376,3,0,2,0.6946902654867256,
19,2,car,van,491,949,411,769,458,358,0.9677114,3,0,2,0.7816593886462883,
20,2,car,van,485,955,412,768,470,356,0.8783675,3,0,2,0.7574468085106383,
21,2,car,van,485,941,414,730,456,316,0.9736741,3,0,2,0.6929824561403509,
22,2,car,van,485,948,416,761,463,345,0.95564747,3,0,2,0.7451403887688985,
23,2,car,van,485,942,410,739,457,329,0.94875216,3,0,2,0.7199124726477024,
24,2,car,van,487,951,414,764,464,350,0.95158833,3,0,2,0.7543103448275862,
25,2,car,van,489,955,409,769,466,360,0.95695746,3,0,2,0.7725321888412017,
26,2,car,van,496,948,415,764,452,349,0.9718963,3,0,2,0.7721238938053098,
27,2,car,van,488,953,416,761,465,345,0.97468466,3,0,2,0.7419354838709677,
28,2,car,van,483,955,415,763,472,348,0.9583383,3,0,2,0.7372881355932204,
29,2,car,van,488,940,412,737,452,325,0.9648091,3,0,2,0.7190265486725663,
30,2,car,van,484,957,412,766,473,354,0.95933455,3,0,2,0.7484143763213531,
31,2,car,van,488,949,417,759,461,342,0.9826786,3,0,2,0.7418655097613883,
32,2,car,van,482,959,414,763,477,349,0.888824,3,0,2,0.7316561844863732,
33,2,car,van,487,955,420,758,468,338,0.9463203,3,0,2,0.7222222222222222,
34,2,car,van,492,952,410,768,460,358,0.9421822,3,0,2,0.7782608695652173,
35,2,car,van,488,939,416,730,451,314,0.9661252,3,0,2,0.6962305986696231,
36,2,car,van,482,955,419,756,473,337,0.94365954,3,0,2,0.7124735729386892,
37,2,car,van,494,951,409,769,457,360,0.95296556,3,0,2,0.787746170678337,
38,2,car,van,487,960,415,764,473,349,0.9687263,3,0,2,0.7378435517970402,
39,2,car,van,479,962,412,769,483,357,0.95937186,3,0,2,0.7391304347826086,
40,2,car,van,484,935,412,738,451,326,0.9526533,3,0,2,0.7228381374722838,
41,2,car,van,482,944,410,736,462,326,0.97273606,3,0,2,0.7056277056277056,
42,2,car,van,480,940,415,734,460,319,0.96075284,3,0,2,0.6934782608695652,
43,2,car,van,486,953,415,763,467,348,0.95723224,3,0,2,0.7451820128479657,
44,2,car,van,492,948,412,767,456,355,0.9304319,3,0,2,0.7785087719298246,
45,2,car,van,489,956,411,768,467,357,0.906528,3,0,2,0.7644539614561028,
46,2,car,van,484,940,413,733,456,320,0.97553414,3,0,2,0.7017543859649122,
47,2,car,van,488,936,413,735,448,322,0.9737919,3,0,2,0.71875,
48,2,car,van,490,956,413,763,466,350,0.9481417,3,0,2,0.7510729613733905,
49,2,car,van,482,952,419,760,470,341,0.9468499,3,0,2,0.725531914893617,
50,2,car,van,590,944,439,693,354,254,0.9859484,3,0,2,0.7175141242937854,
51,2,car,van,589,949,437,697,360,260,0.98192203,3,0,2,0.7222222222222222,
52,2,car,van,590,946,439,698,356,259,0.96922255,3,0,2,0.7275280898876404,
0,2,car,van,484,954,412,769,470,357,0.9619448,3,0,2,0.7595744680851064,
1,2,car,van,485,938,414,732,453,318,0.9526754,3,0,2,0.7019867549668874,
2,2,car,van,484,955,411,765,471,354,0.967853,3,0,2,0.7515923566878981,
3,2,car,van,489,957,420,756,468,336,0.97189754,3,0,2,0.717948717948718,
4,2,car,van,492,952,415,762,460,347,0.97278863,3,0,2,0.7543478260869565,
5,2,car,van,490,956,409,768,466,359,0.9676818,3,0,2,0.7703862660944206,
6,2,car,van,488,938,413,738,450,325,0.94057816,3,0,2,0.7222222222222222,
7,2,car,van,488,957,416,762,469,346,0.97819936,3,0,2,0.7377398720682303,
8,2,car,van,486,954,414,764,468,350,0.9754412,3,0,2,0.7478632478632479,
9,2,car,van,488,936,413,735,448,322,0.9562123,3,0,2,0.71875,
10,2,car,van,486,939,414,735,453,321,0.9730841,3,0,2,0.7086092715231788,
11,2,car,van,489,940,411,737,451,326,0.94711137,3,0,2,0.7228381374722838,
12,2,car,van,488,954,411,769,466,358,0.9352239,3,0,2,0.7682403433476395,
13,2,car,van,487,955,409,768,468,359,0.96377707,3,0,2,0.7670940170940171,
14,2,car,van,483,953,413,767,470,354,0.95913815,3,0,2,0.7531914893617021,
15,2,car,van,483,955,410,769,472,359,0.95927954,3,0,2,0.760593220338983,
16,2,car,van,490,943,411,735,453,324,0.9208222,3,0,2,0.7152317880794702,
17,2,car,van,486,941,412,731,455,319,0.9610242,3,0,2,0.701098901098901,
18,2,car,van,487,953,415,761,466,346,0.97434527,3,0,2,0.7424892703862661,
19,2,car,van,486,938,416,730,452,314,0.9374376,3,0,2,0.6946902654867256,
20,2,car,van,491,949,411,769,458,358,0.9677114,3,0,2,0.7816593886462883,
21,2,car,van,485,955,412,768,470,356,0.8783675,3,0,2,0.7574468085106383,
22,2,car,van,485,941,414,730,456,316,0.9736741,3,0,2,0.6929824561403509,
23,2,car,van,485,948,416,761,463,345,0.95564747,3,0,2,0.7451403887688985,
24,2,car,van,485,942,410,739,457,329,0.94875216,3,0,2,0.7199124726477024,
25,2,car,van,487,951,414,764,464,350,0.95158833,3,0,2,0.7543103448275862,
26,2,car,van,489,955,409,769,466,360,0.95695746,3,0,2,0.7725321888412017,
27,2,car,van,496,948,415,764,452,349,0.9718963,3,0,2,0.7721238938053098,
28,2,car,van,488,953,416,761,465,345,0.97468466,3,0,2,0.7419354838709677,
29,2,car,van,483,955,415,763,472,348,0.9583383,3,0,2,0.7372881355932204,
30,2,car,van,488,940,412,737,452,325,0.9648091,3,0,2,0.7190265486725663,
31,2,car,van,484,957,412,766,473,354,0.95933455,3,0,2,0.7484143763213531,
32,2,car,van,488,949,417,759,461,342,0.9826786,3,0,2,0.7418655097613883,
33,2,car,van,482,959,414,763,477,349,0.888824,3,0,2,0.7316561844863732,
34,2,car,van,487,955,420,758,468,338,0.9463203,3,0,2,0.7222222222222222,
35,2,car,van,492,952,410,768,460,358,0.9421822,3,0,2,0.7782608695652173,
36,2,car,van,488,939,416,730,451,314,0.9661252,3,0,2,0.6962305986696231,
37,2,car,van,482,955,419,756,473,337,0.94365954,3,0,2,0.7124735729386892,
38,2,car,van,494,951,409,769,457,360,0.95296556,3,0,2,0.787746170678337,
39,2,car,van,487,960,415,764,473,349,0.9687263,3,0,2,0.7378435517970402,
40,2,car,van,479,962,412,769,483,357,0.95937186,3,0,2,0.7391304347826086,
41,2,car,van,484,935,412,738,451,326,0.9526533,3,0,2,0.7228381374722838,
42,2,car,van,482,944,410,736,462,326,0.97273606,3,0,2,0.7056277056277056,
43,2,car,van,480,940,415,734,460,319,0.96075284,3,0,2,0.6934782608695652,
44,2,car,van,486,953,415,763,467,348,0.95723224,3,0,2,0.7451820128479657,
45,2,car,van,492,948,412,767,456,355,0.9304319,3,0,2,0.7785087719298246,
46,2,car,van,489,956,411,768,467,357,0.906528,3,0,2,0.7644539614561028,
47,2,car,van,484,940,413,733,456,320,0.97553414,3,0,2,0.7017543859649122,
48,2,car,van,488,936,413,735,448,322,0.9737919,3,0,2,0.71875,
49,2,car,van,490,956,413,763,466,350,0.9481417,3,0,2,0.7510729613733905,
50,2,car,van,482,952,419,760,470,341,0.9468499,3,0,2,0.725531914893617,
51,2,car,van,590,944,439,693,354,254,0.9859484,3,0,2,0.7175141242937854,
52,2,car,van,589,949,437,697,360,260,0.98192203,3,0,2,0.7222222222222222,
53,2,car,van,590,946,439,698,356,259,0.96922255,3,0,2,0.7275280898876404,
0,2,car,van,490,952,416,763,462,347,0.98539907,3,0,2,0.7510822510822511,
1,2,car,van,484,954,412,769,470,357,0.9619448,3,0,2,0.7595744680851064,
2,2,car,van,485,938,414,732,453,318,0.9526754,3,0,2,0.7019867549668874,
3,2,car,van,484,955,411,765,471,354,0.967853,3,0,2,0.7515923566878981,
4,2,car,van,489,957,420,756,468,336,0.97189754,3,0,2,0.717948717948718,
5,2,car,van,492,952,415,762,460,347,0.97278863,3,0,2,0.7543478260869565,
6,2,car,van,490,956,409,768,466,359,0.9676818,3,0,2,0.7703862660944206,
7,2,car,van,488,938,413,738,450,325,0.94057816,3,0,2,0.7222222222222222,
8,2,car,van,488,957,416,762,469,346,0.97819936,3,0,2,0.7377398720682303,
9,2,car,van,486,954,414,764,468,350,0.9754412,3,0,2,0.7478632478632479,
10,2,car,van,488,936,413,735,448,322,0.9562123,3,0,2,0.71875,
11,2,car,van,486,939,414,735,453,321,0.9730841,3,0,2,0.7086092715231788,
12,2,car,van,489,940,411,737,451,326,0.94711137,3,0,2,0.7228381374722838,
13,2,car,van,488,954,411,769,466,358,0.9352239,3,0,2,0.7682403433476395,
14,2,car,van,487,955,409,768,468,359,0.96377707,3,0,2,0.7670940170940171,
15,2,car,van,483,953,413,767,470,354,0.95913815,3,0,2,0.7531914893617021,
16,2,car,van,483,955,410,769,472,359,0.95927954,3,0,2,0.760593220338983,
17,2,car,van,490,943,411,735,453,324,0.9208222,3,0,2,0.7152317880794702,
18,2,car,van,486,941,412,731,455,319,0.9610242,3,0,2,0.701098901098901,
19,2,car,van,487,953,415,761,466,346,0.97434527,3,0,2,0.7424892703862661,
20,2,car,van,486,938,416,730,452,314,0.9374376,3,0,2,0.6946902654867256,
21,2,car,van,491,949,411,769,458,358,0.9677114,3,0,2,0.7816593886462883,
22,2,car,van,485,955,412,768,470,356,0.8783675,3,0,2,0.7574468085106383,
23,2,car,van,485,941,414,730,456,316,0.9736741,3,0,2,0.6929824561403509,
24,2,car,van,485,948,416,761,463,345,0.95564747,3,0,2,0.7451403887688985,
25,2,car,van,485,942,410,739,457,329,0.94875216,3,0,2,0.7199124726477024,
26,2,car,van,487,951,414,764,464,350,0.95158833,3,0,2,0.7543103448275862,
27,2,car,van,489,955,409,769,466,360,0.95695746,3,0,2,0.7725321888412017,
28,2,car,van,496,948,415,764,452,349,0.9718963,3,0,2,0.7721238938053098,
29,2,car,van,488,953,416,761,465,345,0.97468466,3,0,2,0.7419354838709677,
30,2,car,van,483,955,415,763,472,348,0.9583383,3,0,2,0.7372881355932204,
31,2,car,van,488,940,412,737,452,325,0.9648091,3,0,2,0.7190265486725663,
32,2,car,van,484,957,412,766,473,354,0.95933455,3,0,2,0.7484143763213531,
33,2,car,van,488,949,417,759,461,342,0.9826786,3,0,2,0.7418655097613883,
34,2,car,van,482,959,414,763,477,349,0.888824,3,0,2,0.7316561844863732,
35,2,car,van,487,955,420,758,468,338,0.9463203,3,0,2,0.7222222222222222,
36,2,car,van,492,952,410,768,460,358,0.9421822,3,0,2,0.7782608695652173,
37,2,car,van,488,939,416,730,451,314,0.9661252,3,0,2,0.6962305986696231,
38,2,car,van,482,955,419,756,473,337,0.94365954,3,0,2,0.7124735729386892,
39,2,car,van,494,951,409,769,457,360,0.95296556,3,0,2,0.787746170678337,
40,2,car,van,487,960,415,764,473,349,0.9687263,3,0,2,0.7378435517970402,
41,2,car,van,479,962,412,769,483,357,0.95937186,3,0,2,0.7391304347826086,
42,2,car,van,484,935,412,738,451,326,0.9526533,3,0,2,0.7228381374722838,
43,2,car,van,482,944,410,736,462,326,0.97273606,3,0,2,0.7056277056277056,
44,2,car,van,480,940,415,734,460,319,0.96075284,3,0,2,0.6934782608695652,
45,2,car,van,486,953,415,763,467,348,0.95723224,3,0,2,0.7451820128479657,
46,2,car,van,492,948,412,767,456,355,0.9304319,3,0,2,0.7785087719298246,
47,2,car,van,489,956,411,768,467,357,0.906528,3,0,2,0.7644539614561028,
48,2,car,van,484,940,413,733,456,320,0.97553414,3,0,2,0.7017543859649122,
49,2,car,van,488,936,413,735,448,322,0.9737919,3,0,2,0.71875,
50,2,car,van,490,956,413,763,466,350,0.9481417,3,0,2,0.7510729613733905,
51,2,car,van,482,952,419,760,470,341,0.9468499,3,0,2,0.725531914893617,
52,2,car,van,590,944,439,693,354,254,0.9859484,3,0,2,0.7175141242937854,
53,2,car,van,589,949,437,697,360,260,0.98192203,3,0,2,0.7222222222222222,
54,2,car,van,590,946,439,698,356,259,0.96922255,3,0,2,0.7275280898876404,
0,2,car,van,488,952,408,769,464,361,0.95232624,3,0,2,0.7780172413793104,
1,2,car,van,490,952,416,763,462,347,0.98539907,3,0,2,0.7510822510822511,
2,2,car,van,484,954,412,769,470,357,0.9619448,3,0,2,0.7595744680851064,
3,2,car,van,485,938,414,732,453,318,0.9526754,3,0,2,0.7019867549668874,
4,2,car,van,484,955,411,765,471,354,0.967853,3,0,2,0.7515923566878981,
5,2,car,van,489,957,420,756,468,336,0.97189754,3,0,2,0.717948717948718,
6,2,car,van,492,952,415,762,460,347,0.97278863,3,0,2,0.7543478260869565,
7,2,car,van,490,956,409,768,466,359,0.9676818,3,0,2,0.7703862660944206,
8,2,car,van,488,938,413,738,450,325,0.94057816,3,0,2,0.7222222222222222,
9,2,car,van,488,957,416,762,469,346,0.97819936,3,0,2,0.7377398720682303,
10,2,car,van,486,954,414,764,468,350,0.9754412,3,0,2,0.7478632478632479,
11,2,car,van,488,936,413,735,448,322,0.9562123,3,0,2,0.71875,
12,2,car,van,486,939,414,735,453,321,0.9730841,3,0,2,0.7086092715231788,
13,2,car,van,489,940,411,737,451,326,0.94711137,3,0,2,0.7228381374722838,
14,2,car,van,488,954,411,769,466,358,0.9352239,3,0,2,0.7682403433476395,
15,2,car,van,487,955,409,768,468,359,0.96377707,3,0,2,0.7670940170940171,
16,2,car,van,483,953,413,767,470,354,0.95913815,3,0,2,0.7531914893617021,
17,2,car,van,483,955,410,769,472,359,0.95927954,3,0,2,0.760593220338983,
18,2,car,van,490,943,411,735,453,324,0.9208222,3,0,2,0.7152317880794702,
19,2,car,van,486,941,412,731,455,319,0.9610242,3,0,2,0.701098901098901,
20,2,car,van,487,953,415,761,466,346,0.97434527,3,0,2,0.7424892703862661,
21,2,car,van,486,938,416,730,452,314,0.9374376,3,0,2,0.6946902654867256,
22,2,car,van,491,949,411,769,458,358,0.9677114,3,0,2,0.7816593886462883,
23,2,car,van,485,955,412,768,470,356,0.8783675,3,0,2,0.7574468085106383,
24,2,car,van,485,941,414,730,456,316,0.9736741,3,0,2,0.6929824561403509,
25,2,car,van,485,948,416,761,463,345,0.95564747,3,0,2,0.7451403887688985,
26,2,car,van,485,942,410,739,457,329,0.94875216,3,0,2,0.7199124726477024,
27,2,car,van,487,951,414,764,464,350,0.95158833,3,0,2,0.7543103448275862,
28,2,car,van,489,955,409,769,466,360,0.95695746,3,0,2,0.7725321888412017,
29,2,car,van,496,948,415,764,452,349,0.9718963,3,0,2,0.7721238938053098,
30,2,car,van,488,953,416,761,465,345,0.97468466,3,0,2,0.7419354838709677,
31,2,car,van,483,955,415,763,472,348,0.9583383,3,0,2,0.7372881355932204,
32,2,car,van,488,940,412,737,452,325,0.9648091,3,0,2,0.7190265486725663,
33,2,car,van,484,957,412,766,473,354,0.95933455,3,0,2,0.7484143763213531,
34,2,car,van,488,949,417,759,461,342,0.9826786,3,0,2,0.7418655097613883,
35,2,car,van,482,959,414,763,477,349,0.888824,3,0,2,0.7316561844863732,
36,2,car,van,487,955,420,758,468,338,0.9463203,3,0,2,0.7222222222222222,
37,2,car,van,492,952,410,768,460,358,0.9421822,3,0,2,0.7782608695652173,
38,2,car,van,488,939,416,730,451,314,0.9661252,3,0,2,0.6962305986696231,
39,2,car,van,482,955,419,756,473,337,0.94365954,3,0,2,0.7124735729386892,
40,2,car,van,494,951,409,769,457,360,0.95296556,3,0,2,0.787746170678337,
41,2,car,van,487,960,415,764,473,349,0.9687263,3,0,2,0.7378435517970402,
42,2,car,van,479,962,412,769,483,357,0.95937186,3,0,2,0.7391304347826086,
43,2,car,van,484,935,412,738,451,326,0.9526533,3,0,2,0.7228381374722838,
44,2,car,van,482,944,410,736,462,326,0.97273606,3,0,2,0.7056277056277056,
45,2,car,van,480,940,415,734,460,319,0.96075284,3,0,2,0.6934782608695652,
46,2,car,van,486,953,415,763,467,348,0.95723224,3,0,2,0.7451820128479657,
47,2,car,van,492,948,412,767,456,355,0.9304319,3,0,2,0.7785087719298246,
48,2,car,van,489,956,411,768,467,357,0.906528,3,0,2,0.7644539614561028,
49,2,car,van,484,940,413,733,456,320,0.97553414,3,0,2,0.7017543859649122,
50,2,car,van,488,936,413,735,448,322,0.9737919,3,0,2,0.71875,
51,2,car,van,490,956,413,763,466,350,0.9481417,3,0,2,0.7510729613733905,
52,2,car,van,482,952,419,760,470,341,0.9468499,3,0,2,0.725531914893617,
53,2,car,van,590,944,439,693,354,254,0.9859484,3,0,2,0.7175141242937854,
54,2,car,van,589,949,437,697,360,260,0.98192203,3,0,2,0.7222222222222222,
55,2,car,van,590,946,439,698,356,259,0.96922255,3,0,2,0.7275280898876404,
0,2,car,van,486,957,408,773,471,365,0.9602443,3,0,2,0.7749469214437368,
1,2,car,van,488,952,408,769,464,361,0.95232624,3,0,2,0.7780172413793104,
2,2,car,van,490,952,416,763,462,347,0.98539907,3,0,2,0.7510822510822511,
3,2,car,van,484,954,412,769,470,357,0.9619448,3,0,2,0.7595744680851064,
4,2,car,van,485,938,414,732,453,318,0.9526754,3,0,2,0.7019867549668874,
5,2,car,van,484,955,411,765,471,354,0.967853,3,0,2,0.7515923566878981,
6,2,car,van,489,957,420,756,468,336,0.97189754,3,0,2,0.717948717948718,
7,2,car,van,492,952,415,762,460,347,0.97278863,3,0,2,0.7543478260869565,
8,2,car,van,490,956,409,768,466,359,0.9676818,3,0,2,0.7703862660944206,
9,2,car,van,488,938,413,738,450,325,0.94057816,3,0,2,0.7222222222222222,
10,2,car,van,488,957,416,762,469,346,0.97819936,3,0,2,0.7377398720682303,
11,2,car,van,486,954,414,764,468,350,0.9754412,3,0,2,0.7478632478632479,
12,2,car,van,488,936,413,735,448,322,0.9562123,3,0,2,0.71875,
13,2,car,van,486,939,414,735,453,321,0.9730841,3,0,2,0.7086092715231788,
14,2,car,van,489,940,411,737,451,326,0.94711137,3,0,2,0.7228381374722838,
15,2,car,van,488,954,411,769,466,358,0.9352239,3,0,2,0.7682403433476395,
16,2,car,van,487,955,409,768,468,359,0.96377707,3,0,2,0.7670940170940171,
17,2,car,van,483,953,413,767,470,354,0.95913815,3,0,2,0.7531914893617021,
18,2,car,van,483,955,410,769,472,359,0.95927954,3,0,2,0.760593220338983,
19,2,car,van,490,943,411,735,453,324,0.9208222,3,0,2,0.7152317880794702,
20,2,car,van,486,941,412,731,455,319,0.9610242,3,0,2,0.701098901098901,
21,2,car,van,487,953,415,761,466,346,0.97434527,3,0,2,0.7424892703862661,
22,2,car,van,486,938,416,730,452,314,0.9374376,3,0,2,0.6946902654867256,
23,2,car,van,491,949,411,769,458,358,0.9677114,3,0,2,0.7816593886462883,
24,2,car,van,485,955,412,768,470,356,0.8783675,3,0,2,0.7574468085106383,
25,2,car,van,485,941,414,730,456,316,0.9736741,3,0,2,0.6929824561403509,
26,2,car,van,485,948,416,761,463,345,0.95564747,3,0,2,0.7451403887688985,
27,2,car,van,485,942,410,739,457,329,0.94875216,3,0,2,0.7199124726477024,
28,2,car,van,487,951,414,764,464,350,0.95158833,3,0,2,0.7543103448275862,
29,2,car,van,489,955,409,769,466,360,0.95695746,3,0,2,0.7725321888412017,
30,2,car,van,496,948,415,764,452,349,0.9718963,3,0,2,0.7721238938053098,
31,2,car,van,488,953,416,761,465,345,0.97468466,3,0,2,0.7419354838709677,
32,2,car,van,483,955,415,763,472,348,0.9583383,3,0,2,0.7372881355932204,
33,2,car,van,488,940,412,737,452,325,0.9648091,3,0,2,0.7190265486725663,
34,2,car,van,484,957,412,766,473,354,0.95933455,3,0,2,0.7484143763213531,
35,2,car,van,488,949,417,759,461,342,0.9826786,3,0,2,0.7418655097613883,
36,2,car,van,482,959,414,763,477,349,0.888824,3,0,2,0.7316561844863732,
37,2,car,van,487,955,420,758,468,338,0.9463203,3,0,2,0.7222222222222222,
38,2,car,van,492,952,410,768,460,358,0.9421822,3,0,2,0.7782608695652173,
39,2,car,van,488,939,416,730,451,314,0.9661252,3,0,2,0.6962305986696231,
40,2,car,van,482,955,419,756,473,337,0.94365954,3,0,2,0.7124735729386892,
41,2,car,van,494,951,409,769,457,360,0.95296556,3,0,2,0.787746170678337,
42,2,car,van,487,960,415,764,473,349,0.9687263,3,0,2,0.7378435517970402,
43,2,car,van,479,962,412,769,483,357,0.95937186,3,0,2,0.7391304347826086,
44,2,car,van,484,935,412,738,451,326,0.9526533,3,0,2,0.7228381374722838,
45,2,car,van,482,944,410,736,462,326,0.97273606,3,0,2,0.7056277056277056,
46,2,car,van,480,940,415,734,460,319,0.96075284,3,0,2,0.6934782608695652,
47,2,car,van,486,953,415,763,467,348,0.95723224,3,0,2,0.7451820128479657,
48,2,car,van,492,948,412,767,456,355,0.9304319,3,0,2,0.7785087719298246,
49,2,car,van,489,956,411,768,467,357,0.906528,3,0,2,0.7644539614561028,
50,2,car,van,484,940,413,733,456,320,0.97553414,3,0,2,0.7017543859649122,
51,2,car,van,488,936,413,735,448,322,0.9737919,3,0,2,0.71875,
52,2,car,van,490,956,413,763,466,350,0.9481417,3,0,2,0.7510729613733905,
53,2,car,van,482,952,419,760,470,341,0.9468499,3,0,2,0.725531914893617,
54,2,car,van,590,944,439,693,354,254,0.9859484,3,0,2,0.7175141242937854,
55,2,car,van,589,949,437,697,360,260,0.98192203,3,0,2,0.7222222222222222,
56,2,car,van,590,946,439,698,356,259,0.96922255,3,0,2,0.7275280898876404,
0,2,car,van,487,938,412,739,451,327,0.944092,3,0,2,0.7250554323725056,
1,2,car,van,486,957,408,773,471,365,0.9602443,3,0,2,0.7749469214437368,
2,2,car,van,488,952,408,769,464,361,0.95232624,3,0,2,0.7780172413793104,
3,2,car,van,490,952,416,763,462,347,0.98539907,3,0,2,0.7510822510822511,
4,2,car,van,484,954,412,769,470,357,0.9619448,3,0,2,0.7595744680851064,
5,2,car,van,485,938,414,732,453,318,0.9526754,3,0,2,0.7019867549668874,
6,2,car,van,484,955,411,765,471,354,0.967853,3,0,2,0.7515923566878981,
7,2,car,van,489,957,420,756,468,336,0.97189754,3,0,2,0.717948717948718,
8,2,car,van,492,952,415,762,460,347,0.97278863,3,0,2,0.7543478260869565,
9,2,car,van,490,956,409,768,466,359,0.9676818,3,0,2,0.7703862660944206,
10,2,car,van,488,938,413,738,450,325,0.94057816,3,0,2,0.7222222222222222,
11,2,car,van,488,957,416,762,469,346,0.97819936,3,0,2,0.7377398720682303,
12,2,car,van,486,954,414,764,468,350,0.9754412,3,0,2,0.7478632478632479,
13,2,car,van,488,936,413,735,448,322,0.9562123,3,0,2,0.71875,
14,2,car,van,486,939,414,735,453,321,0.9730841,3,0,2,0.7086092715231788,
15,2,car,van,489,940,411,737,451,326,0.94711137,3,0,2,0.7228381374722838,
16,2,car,van,488,954,411,769,466,358,0.9352239,3,0,2,0.7682403433476395,
17,2,car,van,487,955,409,768,468,359,0.96377707,3,0,2,0.7670940170940171,
18,2,car,van,483,953,413,767,470,354,0.95913815,3,0,2,0.7531914893617021,
19,2,car,van,483,955,410,769,472,359,0.95927954,3,0,2,0.760593220338983,
20,2,car,van,490,943,411,735,453,324,0.9208222,3,0,2,0.7152317880794702,
21,2,car,van,486,941,412,731,455,319,0.9610242,3,0,2,0.701098901098901,
22,2,car,van,487,953,415,761,466,346,0.97434527,3,0,2,0.7424892703862661,
23,2,car,van,486,938,416,730,452,314,0.9374376,3,0,2,0.6946902654867256,
24,2,car,van,491,949,411,769,458,358,0.9677114,3,0,2,0.7816593886462883,
25,2,car,van,485,955,412,768,470,356,0.8783675,3,0,2,0.7574468085106383,
26,2,car,van,485,941,414,730,456,316,0.9736741,3,0,2,0.6929824561403509,
27,2,car,van,485,948,416,761,463,345,0.95564747,3,0,2,0.7451403887688985,
28,2,car,van,485,942,410,739,457,329,0.94875216,3,0,2,0.7199124726477024,
29,2,car,van,487,951,414,764,464,350,0.95158833,3,0,2,0.7543103448275862,
30,2,car,van,489,955,409,769,466,360,0.95695746,3,0,2,0.7725321888412017,
31,2,car,van,496,948,415,764,452,349,0.9718963,3,0,2,0.7721238938053098,
32,2,car,van,488,953,416,761,465,345,0.97468466,3,0,2,0.7419354838709677,
33,2,car,van,483,955,415,763,472,348,0.9583383,3,0,2,0.7372881355932204,
34,2,car,van,488,940,412,737,452,325,0.9648091,3,0,2,0.7190265486725663,
35,2,car,van,484,957,412,766,473,354,0.95933455,3,0,2,0.7484143763213531,
36,2,car,van,488,949,417,759,461,342,0.9826786,3,0,2,0.7418655097613883,
37,2,car,van,482,959,414,763,477,349,0.888824,3,0,2,0.7316561844863732,
38,2,car,van,487,955,420,758,468,338,0.9463203,3,0,2,0.7222222222222222,
39,2,car,van,492,952,410,768,460,358,0.9421822,3,0,2,0.7782608695652173,
40,2,car,van,488,939,416,730,451,314,0.9661252,3,0,2,0.6962305986696231,
41,2,car,van,482,955,419,756,473,337,0.94365954,3,0,2,0.7124735729386892,
42,2,car,van,494,951,409,769,457,360,0.95296556,3,0,2,0.787746170678337,
43,2,car,van,487,960,415,764,473,349,0.9687263,3,0,2,0.7378435517970402,
44,2,car,van,479,962,412,769,483,357,0.95937186,3,0,2,0.7391304347826086,
45,2,car,van,484,935,412,738,451,326,0.9526533,3,0,2,0.7228381374722838,
46,2,car,van,482,944,410,736,462,326,0.97273606,3,0,2,0.7056277056277056,
47,2,car,van,480,940,415,734,460,319,0.96075284,3,0,2,0.6934782608695652,
48,2,car,van,486,953,415,763,467,348,0.95723224,3,0,2,0.7451820128479657,
49,2,car,van,492,948,412,767,456,355,0.9304319,3,0,2,0.7785087719298246,
50,2,car,van,489,956,411,768,467,357,0.906528,3,0,2,0.7644539614561028,
51,2,car,van,484,940,413,733,456,320,0.97553414,3,0,2,0.7017543859649122,
52,2,car,van,488,936,413,735,448,322,0.9737919,3,0,2,0.71875,
53,2,car,van,490,956,413,763,466,350,0.9481417,3,0,2,0.7510729613733905,
54,2,car,van,482,952,419,760,470,341,0.9468499,3,0,2,0.725531914893617,
55,2,car,van,590,944,439,693,354,254,0.9859484,3,0,2,0.7175141242937854,
56,2,car,van,589,949,437,697,360,260,0.98192203,3,0,2,0.7222222222222222,
57,2,car,van,590,946,439,698,356,259,0.96922255,3,0,2,0.7275280898876404,
0,2,car,van,493,952,417,765,459,348,0.98740655,3,0,2,0.7581699346405228,
1,2,car,van,487,938,412,739,451,327,0.944092,3,0,2,0.7250554323725056,
2,2,car,van,486,957,408,773,471,365,0.9602443,3,0,2,0.7749469214437368,
3,2,car,van,488,952,408,769,464,361,0.95232624,3,0,2,0.7780172413793104,
4,2,car,van,490,952,416,763,462,347,0.98539907,3,0,2,0.7510822510822511,
5,2,car,van,484,954,412,769,470,357,0.9619448,3,0,2,0.7595744680851064,
6,2,car,van,485,938,414,732,453,318,0.9526754,3,0,2,0.7019867549668874,
7,2,car,van,484,955,411,765,471,354,0.967853,3,0,2,0.7515923566878981,
8,2,car,van,489,957,420,756,468,336,0.97189754,3,0,2,0.717948717948718,
9,2,car,van,492,952,415,762,460,347,0.97278863,3,0,2,0.7543478260869565,
10,2,car,van,490,956,409,768,466,359,0.9676818,3,0,2,0.7703862660944206,
11,2,car,van,488,938,413,738,450,325,0.94057816,3,0,2,0.7222222222222222,
12,2,car,van,488,957,416,762,469,346,0.97819936,3,0,2,0.7377398720682303,
13,2,car,van,486,954,414,764,468,350,0.9754412,3,0,2,0.7478632478632479,
14,2,car,van,488,936,413,735,448,322,0.9562123,3,0,2,0.71875,
15,2,car,van,486,939,414,735,453,321,0.9730841,3,0,2,0.7086092715231788,
16,2,car,van,489,940,411,737,451,326,0.94711137,3,0,2,0.7228381374722838,
17,2,car,van,488,954,411,769,466,358,0.9352239,3,0,2,0.7682403433476395,
18,2,car,van,487,955,409,768,468,359,0.96377707,3,0,2,0.7670940170940171,
19,2,car,van,483,953,413,767,470,354,0.95913815,3,0,2,0.7531914893617021,
20,2,car,van,483,955,410,769,472,359,0.95927954,3,0,2,0.760593220338983,
21,2,car,van,490,943,411,735,453,324,0.9208222,3,0,2,0.7152317880794702,
22,2,car,van,486,941,412,731,455,319,0.9610242,3,0,2,0.701098901098901,
23,2,car,van,487,953,415,761,466,346,0.97434527,3,0,2,0.7424892703862661,
24,2,car,van,486,938,416,730,452,314,0.9374376,3,0,2,0.6946902654867256,
25,2,car,van,491,949,411,769,458,358,0.9677114,3,0,2,0.7816593886462883,
26,2,car,van,485,955,412,768,470,356,0.8783675,3,0,2,0.7574468085106383,
27,2,car,van,485,941,414,730,456,316,0.9736741,3,0,2,0.6929824561403509,
28,2,car,van,485,948,416,761,463,345,0.95564747,3,0,2,0.7451403887688985,
29,2,car,van,485,942,410,739,457,329,0.94875216,3,0,2,0.7199124726477024,
30,2,car,van,487,951,414,764,464,350,0.95158833,3,0,2,0.7543103448275862,
31,2,car,van,489,955,409,769,466,360,0.95695746,3,0,2,0.7725321888412017,
32,2,car,van,496,948,415,764,452,349,0.9718963,3,0,2,0.7721238938053098,
33,2,car,van,488,953,416,761,465,345,0.97468466,3,0,2,0.7419354838709677,
34,2,car,van,483,955,415,763,472,348,0.9583383,3,0,2,0.7372881355932204,
35,2,car,van,488,940,412,737,452,325,0.9648091,3,0,2,0.7190265486725663,
36,2,car,van,484,957,412,766,473,354,0.95933455,3,0,2,0.7484143763213531,
37,2,car,van,488,949,417,759,461,342,0.9826786,3,0,2,0.7418655097613883,
38,2,car,van,482,959,414,763,477,349,0.888824,3,0,2,0.7316561844863732,
39,2,car,van,487,955,420,758,468,338,0.9463203,3,0,2,0.7222222222222222,
40,2,car,van,492,952,410,768,460,358,0.9421822,3,0,2,0.7782608695652173,
41,2,car,van,488,939,416,730,451,314,0.9661252,3,0,2,0.6962305986696231,
42,2,car,van,482,955,419,756,473,337,0.94365954,3,0,2,0.7124735729386892,
43,2,car,van,494,951,409,769,457,360,0.95296556,3,0,2,0.787746170678337,
44,2,car,van,487,960,415,764,473,349,0.9687263,3,0,2,0.7378435517970402,
45,2,car,van,479,962,412,769,483,357,0.95937186,3,0,2,0.7391304347826086,
46,2,car,van,484,935,412,738,451,326,0.9526533,3,0,2,0.7228381374722838,
47,2,car,van,482,944,410,736,462,326,0.97273606,3,0,2,0.7056277056277056,
48,2,car,van,480,940,415,734,460,319,0.96075284,3,0,2,0.6934782608695652,
49,2,car,van,486,953,415,763,467,348,0.95723224,3,0,2,0.7451820128479657,
50,2,car,van,492,948,412,767,456,355,0.9304319,3,0,2,0.7785087719298246,
51,2,car,van,489,956,411,768,467,357,0.906528,3,0,2,0.7644539614561028,
52,2,car,van,484,940,413,733,456,320,0.97553414,3,0,2,0.7017543859649122,
53,2,car,van,488,936,413,735,448,322,0.9737919,3,0,2,0.71875,
54,2,car,van,490,956,413,763,466,350,0.9481417,3,0,2,0.7510729613733905,
55,2,car,van,482,952,419,760,470,341,0.9468499,3,0,2,0.725531914893617,
56,2,car,van,590,944,439,693,354,254,0.9859484,3,0,2,0.7175141242937854,
57,2,car,van,589,949,437,697,360,260,0.98192203,3,0,2,0.7222222222222222,
58,2,car,van,590,946,439,698,356,259,0.96922255,3,0,2,0.7275280898876404,
0,2,car,van,482,958,407,772,476,365,0.9601497,3,0,2,0.7668067226890757,
1,2,car,van,493,952,417,765,459,348,0.98740655,3,0,2,0.7581699346405228,
2,2,car,van,487,938,412,739,451,327,0.944092,3,0,2,0.7250554323725056,
3,2,car,van,486,957,408,773,471,365,0.9602443,3,0,2,0.7749469214437368,
4,2,car,van,488,952,408,769,464,361,0.95232624,3,0,2,0.7780172413793104,
5,2,car,van,490,952,416,763,462,347,0.98539907,3,0,2,0.7510822510822511,
6,2,car,van,484,954,412,769,470,357,0.9619448,3,0,2,0.7595744680851064,
7,2,car,van,485,938,414,732,453,318,0.9526754,3,0,2,0.7019867549668874,
8,2,car,van,484,955,411,765,471,354,0.967853,3,0,2,0.7515923566878981,
9,2,car,van,489,957,420,756,468,336,0.97189754,3,0,2,0.717948717948718,
10,2,car,van,492,952,415,762,460,347,0.97278863,3,0,2,0.7543478260869565,
11,2,car,van,490,956,409,768,466,359,0.9676818,3,0,2,0.7703862660944206,
12,2,car,van,488,938,413,738,450,325,0.94057816,3,0,2,0.7222222222222222,
13,2,car,van,488,957,416,762,469,346,0.97819936,3,0,2,0.7377398720682303,
14,2,car,van,486,954,414,764,468,350,0.9754412,3,0,2,0.7478632478632479,
15,2,car,van,488,936,413,735,448,322,0.9562123,3,0,2,0.71875,
16,2,car,van,486,939,414,735,453,321,0.9730841,3,0,2,0.7086092715231788,
17,2,car,van,489,940,411,737,451,326,0.94711137,3,0,2,0.7228381374722838,
18,2,car,van,488,954,411,769,466,358,0.9352239,3,0,2,0.7682403433476395,
19,2,car,van,487,955,409,768,468,359,0.96377707,3,0,2,0.7670940170940171,
20,2,car,van,483,953,413,767,470,354,0.95913815,3,0,2,0.7531914893617021,
21,2,car,van,483,955,410,769,472,359,0.95927954,3,0,2,0.760593220338983,
22,2,car,van,490,943,411,735,453,324,0.9208222,3,0,2,0.7152317880794702,
23,2,car,van,486,941,412,731,455,319,0.9610242,3,0,2,0.701098901098901,
24,2,car,van,487,953,415,761,466,346,0.97434527,3,0,2,0.7424892703862661,
25,2,car,van,486,938,416,730,452,314,0.9374376,3,0,2,0.6946902654867256,
26,2,car,van,491,949,411,769,458,358,0.9677114,3,0,2,0.7816593886462883,
27,2,car,van,485,955,412,768,470,356,0.8783675,3,0,2,0.7574468085106383,
28,2,car,van,485,941,414,730,456,316,0.9736741,3,0,2,0.6929824561403509,
29,2,car,van,485,948,416,761,463,345,0.95564747,3,0,2,0.7451403887688985,
30,2,car,van,485,942,410,739,457,329,0.94875216,3,0,2,0.7199124726477024,
31,2,car,van,487,951,414,764,464,350,0.95158833,3,0,2,0.7543103448275862,
32,2,car,van,489,955,409,769,466,360,0.95695746,3,0,2,0.7725321888412017,
33,2,car,van,496,948,415,764,452,349,0.9718963,3,0,2,0.7721238938053098,
34,2,car,van,488,953,416,761,465,345,0.97468466,3,0,2,0.7419354838709677,
35,2,car,van,483,955,415,763,472,348,0.9583383,3,0,2,0.7372881355932204,
36,2,car,van,488,940,412,737,452,325,0.9648091,3,0,2,0.7190265486725663,
37,2,car,van,484,957,412,766,473,354,0.95933455,3,0,2,0.7484143763213531,
38,2,car,van,488,949,417,759,461,342,0.9826786,3,0,2,0.7418655097613883,
39,2,car,van,482,959,414,763,477,349,0.888824,3,0,2,0.7316561844863732,
40,2,car,van,487,955,420,758,468,338,0.9463203,3,0,2,0.7222222222222222,
41,2,car,van,492,952,410,768,460,358,0.9421822,3,0,2,0.7782608695652173,
42,2,car,van,488,939,416,730,451,314,0.9661252,3,0,2,0.6962305986696231,
43,2,car,van,482,955,419,756,473,337,0.94365954,3,0,2,0.7124735729386892,
44,2,car,van,494,951,409,769,457,360,0.95296556,3,0,2,0.787746170678337,
45,2,car,van,487,960,415,764,473,349,0.9687263,3,0,2,0.7378435517970402,
46,2,car,van,479,962,412,769,483,357,0.95937186,3,0,2,0.7391304347826086,
47,2,car,van,484,935,412,738,451,326,0.9526533,3,0,2,0.7228381374722838,
48,2,car,van,482,944,410,736,462,326,0.97273606,3,0,2,0.7056277056277056,
49,2,car,van,480,940,415,734,460,319,0.96075284,3,0,2,0.6934782608695652,
50,2,car,van,486,953,415,763,467,348,0.95723224,3,0,2,0.7451820128479657,
51,2,car,van,492,948,412,767,456,355,0.9304319,3,0,2,0.7785087719298246,
52,2,car,van,489,956,411,768,467,357,0.906528,3,0,2,0.7644539614561028,
53,2,car,van,484,940,413,733,456,320,0.97553414,3,0,2,0.7017543859649122,
54,2,car,van,488,936,413,735,448,322,0.9737919,3,0,2,0.71875,
55,2,car,van,490,956,413,763,466,350,0.9481417,3,0,2,0.7510729613733905,
56,2,car,van,482,952,419,760,470,341,0.9468499,3,0,2,0.725531914893617,
57,2,car,van,590,944,439,693,354,254,0.9859484,3,0,2,0.7175141242937854,
58,2,car,van,589,949,437,697,360,260,0.98192203,3,0,2,0.7222222222222222,
59,2,car,van,590,946,439,698,356,259,0.96922255,3,0,2,0.7275280898876404,
0,2,car,van,485,952,416,762,467,346,0.96896255,3,0,2,0.7408993576017131,
1,2,car,van,482,958,407,772,476,365,0.9601497,3,0,2,0.7668067226890757,
2,2,car,van,493,952,417,765,459,348,0.98740655,3,0,2,0.7581699346405228,
3,2,car,van,487,938,412,739,451,327,0.944092,3,0,2,0.7250554323725056,
4,2,car,van,486,957,408,773,471,365,0.9602443,3,0,2,0.7749469214437368,
5,2,car,van,488,952,408,769,464,361,0.95232624,3,0,2,0.7780172413793104,
6,2,car,van,490,952,416,763,462,347,0.98539907,3,0,2,0.7510822510822511,
7,2,car,van,484,954,412,769,470,357,0.9619448,3,0,2,0.7595744680851064,
8,2,car,van,485,938,414,732,453,318,0.9526754,3,0,2,0.7019867549668874,
9,2,car,van,484,955,411,765,471,354,0.967853,3,0,2,0.7515923566878981,
10,2,car,van,489,957,420,756,468,336,0.97189754,3,0,2,0.717948717948718,
11,2,car,van,492,952,415,762,460,347,0.97278863,3,0,2,0.7543478260869565,
12,2,car,van,490,956,409,768,466,359,0.9676818,3,0,2,0.7703862660944206,
13,2,car,van,488,938,413,738,450,325,0.94057816,3,0,2,0.7222222222222222,
14,2,car,van,488,957,416,762,469,346,0.97819936,3,0,2,0.7377398720682303,
15,2,car,van,486,954,414,764,468,350,0.9754412,3,0,2,0.7478632478632479,
16,2,car,van,488,936,413,735,448,322,0.9562123,3,0,2,0.71875,
17,2,car,van,486,939,414,735,453,321,0.9730841,3,0,2,0.7086092715231788,
18,2,car,van,489,940,411,737,451,326,0.94711137,3,0,2,0.7228381374722838,
19,2,car,van,488,954,411,769,466,358,0.9352239,3,0,2,0.7682403433476395,
20,2,car,van,487,955,409,768,468,359,0.96377707,3,0,2,0.7670940170940171,
21,2,car,van,483,953,413,767,470,354,0.95913815,3,0,2,0.7531914893617021,
22,2,car,van,483,955,410,769,472,359,0.95927954,3,0,2,0.760593220338983,
23,2,car,van,490,943,411,735,453,324,0.9208222,3,0,2,0.7152317880794702,
24,2,car,van,486,941,412,731,455,319,0.9610242,3,0,2,0.701098901098901,
25,2,car,van,487,953,415,761,466,346,0.97434527,3,0,2,0.7424892703862661,
26,2,car,van,486,938,416,730,452,314,0.9374376,3,0,2,0.6946902654867256,
27,2,car,van,491,949,411,769,458,358,0.9677114,3,0,2,0.7816593886462883,
28,2,car,van,485,955,412,768,470,356,0.8783675,3,0,2,0.7574468085106383,
29,2,car,van,485,941,414,730,456,316,0.9736741,3,0,2,0.6929824561403509,
30,2,car,van,485,948,416,761,463,345,0.95564747,3,0,2,0.7451403887688985,
31,2,car,van,485,942,410,739,457,329,0.94875216,3,0,2,0.7199124726477024,
32,2,car,van,487,951,414,764,464,350,0.95158833,3,0,2,0.7543103448275862,
33,2,car,van,489,955,409,769,466,360,0.95695746,3,0,2,0.7725321888412017,
34,2,car,van,496,948,415,764,452,349,0.9718963,3,0,2,0.7721238938053098,
35,2,car,van,488,953,416,761,465,345,0.97468466,3,0,2,0.7419354838709677,
36,2,car,van,483,955,415,763,472,348,0.9583383,3,0,2,0.7372881355932204,
37,2,car,van,488,940,412,737,452,325,0.9648091,3,0,2,0.7190265486725663,
38,2,car,van,484,957,412,766,473,354,0.95933455,3,0,2,0.7484143763213531,
39,2,car,van,488,949,417,759,461,342,0.9826786,3,0,2,0.7418655097613883,
40,2,car,van,482,959,414,763,477,349,0.888824,3,0,2,0.7316561844863732,
41,2,car,van,487,955,420,758,468,338,0.9463203,3,0,2,0.7222222222222222,
42,2,car,van,492,952,410,768,460,358,0.9421822,3,0,2,0.7782608695652173,
43,2,car,van,488,939,416,730,451,314,0.9661252,3,0,2,0.6962305986696231,
44,2,car,van,482,955,419,756,473,337,0.94365954,3,0,2,0.7124735729386892,
45,2,car,van,494,951,409,769,457,360,0.95296556,3,0,2,0.787746170678337,
46,2,car,van,487,960,415,764,473,349,0.9687263,3,0,2,0.7378435517970402,
47,2,car,van,479,962,412,769,483,357,0.95937186,3,0,2,0.7391304347826086,
48,2,car,van,484,935,412,738,451,326,0.9526533,3,0,2,0.7228381374722838,
49,2,car,van,482,944,410,736,462,326,0.97273606,3,0,2,0.7056277056277056,
50,2,car,van,480,940,415,734,460,319,0.96075284,3,0,2,0.6934782608695652,
51,2,car,van,486,953,415,763,467,348,0.95723224,3,0,2,0.7451820128479657,
52,2,car,van,492,948,412,767,456,355,0.9304319,3,0,2,0.7785087719298246,
53,2,car,van,489,956,411,768,467,357,0.906528,3,0,2,0.7644539614561028,
54,2,car,van,484,940,413,733,456,320,0.97553414,3,0,2,0.7017543859649122,
55,2,car,van,488,936,413,735,448,322,0.9737919,3,0,2,0.71875,
56,2,car,van,490,956,413,763,466,350,0.9481417,3,0,2,0.7510729613733905,
57,2,car,van,482,952,419,760,470,341,0.9468499,3,0,2,0.725531914893617,
58,2,car,van,590,944,439,693,354,254,0.9859484,3,0,2,0.7175141242937854,
59,2,car,van,589,949,437,697,360,260,0.98192203,3,0,2,0.7222222222222222,
60,2,car,van,590,946,439,698,356,259,0.96922255,3,0,2,0.7275280898876404,
0,2,car,van,487,938,415,731,451,316,0.96498144,3,0,2,0.7006651884700665,
1,2,car,van,485,952,416,762,467,346,0.96896255,3,0,2,0.7408993576017131,
2,2,car,van,482,958,407,772,476,365,0.9601497,3,0,2,0.7668067226890757,
3,2,car,van,493,952,417,765,459,348,0.98740655,3,0,2,0.7581699346405228,
4,2,car,van,487,938,412,739,451,327,0.944092,3,0,2,0.7250554323725056,
5,2,car,van,486,957,408,773,471,365,0.9602443,3,0,2,0.7749469214437368,
6,2,car,van,488,952,408,769,464,361,0.95232624,3,0,2,0.7780172413793104,
7,2,car,van,490,952,416,763,462,347,0.98539907,3,0,2,0.7510822510822511,
8,2,car,van,484,954,412,769,470,357,0.9619448,3,0,2,0.7595744680851064,
9,2,car,van,485,938,414,732,453,318,0.9526754,3,0,2,0.7019867549668874,
10,2,car,van,484,955,411,765,471,354,0.967853,3,0,2,0.7515923566878981,
11,2,car,van,489,957,420,756,468,336,0.97189754,3,0,2,0.717948717948718,
12,2,car,van,492,952,415,762,460,347,0.97278863,3,0,2,0.7543478260869565,
13,2,car,van,490,956,409,768,466,359,0.9676818,3,0,2,0.7703862660944206,
14,2,car,van,488,938,413,738,450,325,0.94057816,3,0,2,0.7222222222222222,
15,2,car,van,488,957,416,762,469,346,0.97819936,3,0,2,0.7377398720682303,
16,2,car,van,486,954,414,764,468,350,0.9754412,3,0,2,0.7478632478632479,
17,2,car,van,488,936,413,735,448,322,0.9562123,3,0,2,0.71875,
18,2,car,van,486,939,414,735,453,321,0.9730841,3,0,2,0.7086092715231788,
19,2,car,van,489,940,411,737,451,326,0.94711137,3,0,2,0.7228381374722838,
20,2,car,van,488,954,411,769,466,358,0.9352239,3,0,2,0.7682403433476395,
21,2,car,van,487,955,409,768,468,359,0.96377707,3,0,2,0.7670940170940171,
22,2,car,van,483,953,413,767,470,354,0.95913815,3,0,2,0.7531914893617021,
23,2,car,van,483,955,410,769,472,359,0.95927954,3,0,2,0.760593220338983,
24,2,car,van,490,943,411,735,453,324,0.9208222,3,0,2,0.7152317880794702,
25,2,car,van,486,941,412,731,455,319,0.9610242,3,0,2,0.701098901098901,
26,2,car,van,487,953,415,761,466,346,0.97434527,3,0,2,0.7424892703862661,
27,2,car,van,486,938,416,730,452,314,0.9374376,3,0,2,0.6946902654867256,
28,2,car,van,491,949,411,769,458,358,0.9677114,3,0,2,0.7816593886462883,
29,2,car,van,485,955,412,768,470,356,0.8783675,3,0,2,0.7574468085106383,
30,2,car,van,485,941,414,730,456,316,0.9736741,3,0,2,0.6929824561403509,
31,2,car,van,485,948,416,761,463,345,0.95564747,3,0,2,0.7451403887688985,
32,2,car,van,485,942,410,739,457,329,0.94875216,3,0,2,0.7199124726477024,
33,2,car,van,487,951,414,764,464,350,0.95158833,3,0,2,0.7543103448275862,
34,2,car,van,489,955,409,769,466,360,0.95695746,3,0,2,0.7725321888412017,
35,2,car,van,496,948,415,764,452,349,0.9718963,3,0,2,0.7721238938053098,
36,2,car,van,488,953,416,761,465,345,0.97468466,3,0,2,0.7419354838709677,
37,2,car,van,483,955,415,763,472,348,0.9583383,3,0,2,0.7372881355932204,
38,2,car,van,488,940,412,737,452,325,0.9648091,3,0,2,0.7190265486725663,
39,2,car,van,484,957,412,766,473,354,0.95933455,3,0,2,0.7484143763213531,
40,2,car,van,488,949,417,759,461,342,0.9826786,3,0,2,0.7418655097613883,
41,2,car,van,482,959,414,763,477,349,0.888824,3,0,2,0.7316561844863732,
42,2,car,van,487,955,420,758,468,338,0.9463203,3,0,2,0.7222222222222222,
43,2,car,van,492,952,410,768,460,358,0.9421822,3,0,2,0.7782608695652173,
44,2,car,van,488,939,416,730,451,314,0.9661252,3,0,2,0.6962305986696231,
45,2,car,van,482,955,419,756,473,337,0.94365954,3,0,2,0.7124735729386892,
46,2,car,van,494,951,409,769,457,360,0.95296556,3,0,2,0.787746170678337,
47,2,car,van,487,960,415,764,473,349,0.9687263,3,0,2,0.7378435517970402,
48,2,car,van,479,962,412,769,483,357,0.95937186,3,0,2,0.7391304347826086,
49,2,car,van,484,935,412,738,451,326,0.9526533,3,0,2,0.7228381374722838,
50,2,car,van,482,944,410,736,462,326,0.97273606,3,0,2,0.7056277056277056,
51,2,car,van,480,940,415,734,460,319,0.96075284,3,0,2,0.6934782608695652,
52,2,car,van,486,953,415,763,467,348,0.95723224,3,0,2,0.7451820128479657,
53,2,car,van,492,948,412,767,456,355,0.9304319,3,0,2,0.7785087719298246,
54,2,car,van,489,956,411,768,467,357,0.906528,3,0,2,0.7644539614561028,
55,2,car,van,484,940,413,733,456,320,0.97553414,3,0,2,0.7017543859649122,
56,2,car,van,488,936,413,735,448,322,0.9737919,3,0,2,0.71875,
57,2,car,van,490,956,413,763,466,350,0.9481417,3,0,2,0.7510729613733905,
58,2,car,van,482,952,419,760,470,341,0.9468499,3,0,2,0.725531914893617,
59,2,car,van,590,944,439,693,354,254,0.9859484,3,0,2,0.7175141242937854,
60,2,car,van,589,949,437,697,360,260,0.98192203,3,0,2,0.7222222222222222,
61,2,car,van,590,946,439,698,356,259,0.96922255,3,0,2,0.7275280898876404,
0,2,car,van,487,942,414,734,455,320,0.9520047,3,0,2,0.7032967032967034,
1,2,car,van,487,938,415,731,451,316,0.96498144,3,0,2,0.7006651884700665,
2,2,car,van,485,952,416,762,467,346,0.96896255,3,0,2,0.7408993576017131,
3,2,car,van,482,958,407,772,476,365,0.9601497,3,0,2,0.7668067226890757,
4,2,car,van,493,952,417,765,459,348,0.98740655,3,0,2,0.7581699346405228,
5,2,car,van,487,938,412,739,451,327,0.944092,3,0,2,0.7250554323725056,
6,2,car,van,486,957,408,773,471,365,0.9602443,3,0,2,0.7749469214437368,
7,2,car,van,488,952,408,769,464,361,0.95232624,3,0,2,0.7780172413793104,
8,2,car,van,490,952,416,763,462,347,0.98539907,3,0,2,0.7510822510822511,
9,2,car,van,484,954,412,769,470,357,0.9619448,3,0,2,0.7595744680851064,
10,2,car,van,485,938,414,732,453,318,0.9526754,3,0,2,0.7019867549668874,
11,2,car,van,484,955,411,765,471,354,0.967853,3,0,2,0.7515923566878981,
12,2,car,van,489,957,420,756,468,336,0.97189754,3,0,2,0.717948717948718,
13,2,car,van,492,952,415,762,460,347,0.97278863,3,0,2,0.7543478260869565,
14,2,car,van,490,956,409,768,466,359,0.9676818,3,0,2,0.7703862660944206,
15,2,car,van,488,938,413,738,450,325,0.94057816,3,0,2,0.7222222222222222,
16,2,car,van,488,957,416,762,469,346,0.97819936,3,0,2,0.7377398720682303,
17,2,car,van,486,954,414,764,468,350,0.9754412,3,0,2,0.7478632478632479,
18,2,car,van,488,936,413,735,448,322,0.9562123,3,0,2,0.71875,
19,2,car,van,486,939,414,735,453,321,0.9730841,3,0,2,0.7086092715231788,
20,2,car,van,489,940,411,737,451,326,0.94711137,3,0,2,0.7228381374722838,
21,2,car,van,488,954,411,769,466,358,0.9352239,3,0,2,0.7682403433476395,
22,2,car,van,487,955,409,768,468,359,0.96377707,3,0,2,0.7670940170940171,
23,2,car,van,483,953,413,767,470,354,0.95913815,3,0,2,0.7531914893617021,
24,2,car,van,483,955,410,769,472,359,0.95927954,3,0,2,0.760593220338983,
25,2,car,van,490,943,411,735,453,324,0.9208222,3,0,2,0.7152317880794702,
26,2,car,van,486,941,412,731,455,319,0.9610242,3,0,2,0.701098901098901,
27,2,car,van,487,953,415,761,466,346,0.97434527,3,0,2,0.7424892703862661,
28,2,car,van,486,938,416,730,452,314,0.9374376,3,0,2,0.6946902654867256,
29,2,car,van,491,949,411,769,458,358,0.9677114,3,0,2,0.7816593886462883,
30,2,car,van,485,955,412,768,470,356,0.8783675,3,0,2,0.7574468085106383,
31,2,car,van,485,941,414,730,456,316,0.9736741,3,0,2,0.6929824561403509,
32,2,car,van,485,948,416,761,463,345,0.95564747,3,0,2,0.7451403887688985,
33,2,car,van,485,942,410,739,457,329,0.94875216,3,0,2,0.7199124726477024,
34,2,car,van,487,951,414,764,464,350,0.95158833,3,0,2,0.7543103448275862,
35,2,car,van,489,955,409,769,466,360,0.95695746,3,0,2,0.7725321888412017,
36,2,car,van,496,948,415,764,452,349,0.9718963,3,0,2,0.7721238938053098,
37,2,car,van,488,953,416,761,465,345,0.97468466,3,0,2,0.7419354838709677,
38,2,car,van,483,955,415,763,472,348,0.9583383,3,0,2,0.7372881355932204,
39,2,car,van,488,940,412,737,452,325,0.9648091,3,0,2,0.7190265486725663,
40,2,car,van,484,957,412,766,473,354,0.95933455,3,0,2,0.7484143763213531,
41,2,car,van,488,949,417,759,461,342,0.9826786,3,0,2,0.7418655097613883,
42,2,car,van,482,959,414,763,477,349,0.888824,3,0,2,0.7316561844863732,
43,2,car,van,487,955,420,758,468,338,0.9463203,3,0,2,0.7222222222222222,
44,2,car,van,492,952,410,768,460,358,0.9421822,3,0,2,0.7782608695652173,
45,2,car,van,488,939,416,730,451,314,0.9661252,3,0,2,0.6962305986696231,
46,2,car,van,482,955,419,756,473,337,0.94365954,3,0,2,0.7124735729386892,
47,2,car,van,494,951,409,769,457,360,0.95296556,3,0,2,0.787746170678337,
48,2,car,van,487,960,415,764,473,349,0.9687263,3,0,2,0.7378435517970402,
49,2,car,van,479,962,412,769,483,357,0.95937186,3,0,2,0.7391304347826086,
50,2,car,van,484,935,412,738,451,326,0.9526533,3,0,2,0.7228381374722838,
51,2,car,van,482,944,410,736,462,326,0.97273606,3,0,2,0.7056277056277056,
52,2,car,van,480,940,415,734,460,319,0.96075284,3,0,2,0.6934782608695652,
53,2,car,van,486,953,415,763,467,348,0.95723224,3,0,2,0.7451820128479657,
54,2,car,van,492,948,412,767,456,355,0.9304319,3,0,2,0.7785087719298246,
55,2,car,van,489,956,411,768,467,357,0.906528,3,0,2,0.7644539614561028,
56,2,car,van,484,940,413,733,456,320,0.97553414,3,0,2,0.7017543859649122,
57,2,car,van,488,936,413,735,448,322,0.9737919,3,0,2,0.71875,
58,2,car,van,490,956,413,763,466,350,0.9481417,3,0,2,0.7510729613733905,
59,2,car,van,482,952,419,760,470,341,0.9468499,3,0,2,0.725531914893617,
60,2,car,van,590,944,439,693,354,254,0.9859484,3,0,2,0.7175141242937854,
61,2,car,van,589,949,437,697,360,260,0.98192203,3,0,2,0.7222222222222222,
62,2,car,van,590,946,439,698,356,259,0.96922255,3,0,2,0.7275280898876404,
0,2,car,van,492,954,415,764,462,349,0.97444296,3,0,2,0.7554112554112554,
1,2,car,van,487,942,414,734,455,320,0.9520047,3,0,2,0.7032967032967034,
2,2,car,van,487,938,415,731,451,316,0.96498144,3,0,2,0.7006651884700665,
3,2,car,van,485,952,416,762,467,346,0.96896255,3,0,2,0.7408993576017131,
4,2,car,van,482,958,407,772,476,365,0.9601497,3,0,2,0.7668067226890757,
5,2,car,van,493,952,417,765,459,348,0.98740655,3,0,2,0.7581699346405228,
6,2,car,van,487,938,412,739,451,327,0.944092,3,0,2,0.7250554323725056,
7,2,car,van,486,957,408,773,471,365,0.9602443,3,0,2,0.7749469214437368,
8,2,car,van,488,952,408,769,464,361,0.95232624,3,0,2,0.7780172413793104,
9,2,car,van,490,952,416,763,462,347,0.98539907,3,0,2,0.7510822510822511,
10,2,car,van,484,954,412,769,470,357,0.9619448,3,0,2,0.7595744680851064,
11,2,car,van,485,938,414,732,453,318,0.9526754,3,0,2,0.7019867549668874,
12,2,car,van,484,955,411,765,471,354,0.967853,3,0,2,0.7515923566878981,
13,2,car,van,489,957,420,756,468,336,0.97189754,3,0,2,0.717948717948718,
14,2,car,van,492,952,415,762,460,347,0.97278863,3,0,2,0.7543478260869565,
15,2,car,van,490,956,409,768,466,359,0.9676818,3,0,2,0.7703862660944206,
16,2,car,van,488,938,413,738,450,325,0.94057816,3,0,2,0.7222222222222222,
17,2,car,van,488,957,416,762,469,346,0.97819936,3,0,2,0.7377398720682303,
18,2,car,van,486,954,414,764,468,350,0.9754412,3,0,2,0.7478632478632479,
19,2,car,van,488,936,413,735,448,322,0.9562123,3,0,2,0.71875,
20,2,car,van,486,939,414,735,453,321,0.9730841,3,0,2,0.7086092715231788,
21,2,car,van,489,940,411,737,451,326,0.94711137,3,0,2,0.7228381374722838,
22,2,car,van,488,954,411,769,466,358,0.9352239,3,0,2,0.7682403433476395,
23,2,car,van,487,955,409,768,468,359,0.96377707,3,0,2,0.7670940170940171,
24,2,car,van,483,953,413,767,470,354,0.95913815,3,0,2,0.7531914893617021,
25,2,car,van,483,955,410,769,472,359,0.95927954,3,0,2,0.760593220338983,
26,2,car,van,490,943,411,735,453,324,0.9208222,3,0,2,0.7152317880794702,
27,2,car,van,486,941,412,731,455,319,0.9610242,3,0,2,0.701098901098901,
28,2,car,van,487,953,415,761,466,346,0.97434527,3,0,2,0.7424892703862661,
29,2,car,van,486,938,416,730,452,314,0.9374376,3,0,2,0.6946902654867256,
30,2,car,van,491,949,411,769,458,358,0.9677114,3,0,2,0.7816593886462883,
31,2,car,van,485,955,412,768,470,356,0.8783675,3,0,2,0.7574468085106383,
32,2,car,van,485,941,414,730,456,316,0.9736741,3,0,2,0.6929824561403509,
33,2,car,van,485,948,416,761,463,345,0.95564747,3,0,2,0.7451403887688985,
34,2,car,van,485,942,410,739,457,329,0.94875216,3,0,2,0.7199124726477024,
35,2,car,van,487,951,414,764,464,350,0.95158833,3,0,2,0.7543103448275862,
36,2,car,van,489,955,409,769,466,360,0.95695746,3,0,2,0.7725321888412017,
37,2,car,van,496,948,415,764,452,349,0.9718963,3,0,2,0.7721238938053098,
38,2,car,van,488,953,416,761,465,345,0.97468466,3,0,2,0.7419354838709677,
39,2,car,van,483,955,415,763,472,348,0.9583383,3,0,2,0.7372881355932204,
40,2,car,van,488,940,412,737,452,325,0.9648091,3,0,2,0.7190265486725663,
41,2,car,van,484,957,412,766,473,354,0.95933455,3,0,2,0.7484143763213531,
42,2,car,van,488,949,417,759,461,342,0.9826786,3,0,2,0.7418655097613883,
43,2,car,van,482,959,414,763,477,349,0.888824,3,0,2,0.7316561844863732,
44,2,car,van,487,955,420,758,468,338,0.9463203,3,0,2,0.7222222222222222,
45,2,car,van,492,952,410,768,460,358,0.9421822,3,0,2,0.7782608695652173,
46,2,car,van,488,939,416,730,451,314,0.9661252,3,0,2,0.6962305986696231,
47,2,car,van,482,955,419,756,473,337,0.94365954,3,0,2,0.7124735729386892,
48,2,car,van,494,951,409,769,457,360,0.95296556,3,0,2,0.787746170678337,
49,2,car,van,487,960,415,764,473,349,0.9687263,3,0,2,0.7378435517970402,
50,2,car,van,479,962,412,769,483,357,0.95937186,3,0,2,0.7391304347826086,
51,2,car,van,484,935,412,738,451,326,0.9526533,3,0,2,0.7228381374722838,
52,2,car,van,482,944,410,736,462,326,0.97273606,3,0,2,0.7056277056277056,
53,2,car,van,480,940,415,734,460,319,0.96075284,3,0,2,0.6934782608695652,
54,2,car,van,486,953,415,763,467,348,0.95723224,3,0,2,0.7451820128479657,
55,2,car,van,492,948,412,767,456,355,0.9304319,3,0,2,0.7785087719298246,
56,2,car,van,489,956,411,768,467,357,0.906528,3,0,2,0.7644539614561028,
57,2,car,van,484,940,413,733,456,320,0.97553414,3,0,2,0.7017543859649122,
58,2,car,van,488,936,413,735,448,322,0.9737919,3,0,2,0.71875,
59,2,car,van,490,956,413,763,466,350,0.9481417,3,0,2,0.7510729613733905,
60,2,car,van,482,952,419,760,470,341,0.9468499,3,0,2,0.725531914893617,
61,2,car,van,590,944,439,693,354,254,0.9859484,3,0,2,0.7175141242937854,
62,2,car,van,589,949,437,697,360,260,0.98192203,3,0,2,0.7222222222222222,
63,2,car,van,590,946,439,698,356,259,0.96922255,3,0,2,0.7275280898876404,
0,2,car,van,493,951,415,764,458,349,0.96600556,3,0,2,0.7620087336244541,
1,2,car,van,492,954,415,764,462,349,0.97444296,3,0,2,0.7554112554112554,
2,2,car,van,487,942,414,734,455,320,0.9520047,3,0,2,0.7032967032967034,
3,2,car,van,487,938,415,731,451,316,0.96498144,3,0,2,0.7006651884700665,
4,2,car,van,485,952,416,762,467,346,0.96896255,3,0,2,0.7408993576017131,
5,2,car,van,482,958,407,772,476,365,0.9601497,3,0,2,0.7668067226890757,
6,2,car,van,493,952,417,765,459,348,0.98740655,3,0,2,0.7581699346405228,
7,2,car,van,487,938,412,739,451,327,0.944092,3,0,2,0.7250554323725056,
8,2,car,van,486,957,408,773,471,365,0.9602443,3,0,2,0.7749469214437368,
9,2,car,van,488,952,408,769,464,361,0.95232624,3,0,2,0.7780172413793104,
10,2,car,van,490,952,416,763,462,347,0.98539907,3,0,2,0.7510822510822511,
11,2,car,van,484,954,412,769,470,357,0.9619448,3,0,2,0.7595744680851064,
12,2,car,van,485,938,414,732,453,318,0.9526754,3,0,2,0.7019867549668874,
13,2,car,van,484,955,411,765,471,354,0.967853,3,0,2,0.7515923566878981,
14,2,car,van,489,957,420,756,468,336,0.97189754,3,0,2,0.717948717948718,
15,2,car,van,492,952,415,762,460,347,0.97278863,3,0,2,0.7543478260869565,
16,2,car,van,490,956,409,768,466,359,0.9676818,3,0,2,0.7703862660944206,
17,2,car,van,488,938,413,738,450,325,0.94057816,3,0,2,0.7222222222222222,
18,2,car,van,488,957,416,762,469,346,0.97819936,3,0,2,0.7377398720682303,
19,2,car,van,486,954,414,764,468,350,0.9754412,3,0,2,0.7478632478632479,
20,2,car,van,488,936,413,735,448,322,0.9562123,3,0,2,0.71875,
21,2,car,van,486,939,414,735,453,321,0.9730841,3,0,2,0.7086092715231788,
22,2,car,van,489,940,411,737,451,326,0.94711137,3,0,2,0.7228381374722838,
23,2,car,van,488,954,411,769,466,358,0.9352239,3,0,2,0.7682403433476395,
24,2,car,van,487,955,409,768,468,359,0.96377707,3,0,2,0.7670940170940171,
25,2,car,van,483,953,413,767,470,354,0.95913815,3,0,2,0.7531914893617021,
26,2,car,van,483,955,410,769,472,359,0.95927954,3,0,2,0.760593220338983,
27,2,car,van,490,943,411,735,453,324,0.9208222,3,0,2,0.7152317880794702,
28,2,car,van,486,941,412,731,455,319,0.9610242,3,0,2,0.701098901098901,
29,2,car,van,487,953,415,761,466,346,0.97434527,3,0,2,0.7424892703862661,
30,2,car,van,486,938,416,730,452,314,0.9374376,3,0,2,0.6946902654867256,
31,2,car,van,491,949,411,769,458,358,0.9677114,3,0,2,0.7816593886462883,
32,2,car,van,485,955,412,768,470,356,0.8783675,3,0,2,0.7574468085106383,
33,2,car,van,485,941,414,730,456,316,0.9736741,3,0,2,0.6929824561403509,
34,2,car,van,485,948,416,761,463,345,0.95564747,3,0,2,0.7451403887688985,
35,2,car,van,485,942,410,739,457,329,0.94875216,3,0,2,0.7199124726477024,
36,2,car,van,487,951,414,764,464,350,0.95158833,3,0,2,0.7543103448275862,
37,2,car,van,489,955,409,769,466,360,0.95695746,3,0,2,0.7725321888412017,
38,2,car,van,496,948,415,764,452,349,0.9718963,3,0,2,0.7721238938053098,
39,2,car,van,488,953,416,761,465,345,0.97468466,3,0,2,0.7419354838709677,
40,2,car,van,483,955,415,763,472,348,0.9583383,3,0,2,0.7372881355932204,
41,2,car,van,488,940,412,737,452,325,0.9648091,3,0,2,0.7190265486725663,
42,2,car,van,484,957,412,766,473,354,0.95933455,3,0,2,0.7484143763213531,
43,2,car,van,488,949,417,759,461,342,0.9826786,3,0,2,0.7418655097613883,
44,2,car,van,482,959,414,763,477,349,0.888824,3,0,2,0.7316561844863732,
45,2,car,van,487,955,420,758,468,338,0.9463203,3,0,2,0.7222222222222222,
46,2,car,van,492,952,410,768,460,358,0.9421822,3,0,2,0.7782608695652173,
47,2,car,van,488,939,416,730,451,314,0.9661252,3,0,2,0.6962305986696231,
48,2,car,van,482,955,419,756,473,337,0.94365954,3,0,2,0.7124735729386892,
49,2,car,van,494,951,409,769,457,360,0.95296556,3,0,2,0.787746170678337,
50,2,car,van,487,960,415,764,473,349,0.9687263,3,0,2,0.7378435517970402,
51,2,car,van,479,962,412,769,483,357,0.95937186,3,0,2,0.7391304347826086,
52,2,car,van,484,935,412,738,451,326,0.9526533,3,0,2,0.7228381374722838,
53,2,car,van,482,944,410,736,462,326,0.97273606,3,0,2,0.7056277056277056,
54,2,car,van,480,940,415,734,460,319,0.96075284,3,0,2,0.6934782608695652,
55,2,car,van,486,953,415,763,467,348,0.95723224,3,0,2,0.7451820128479657,
56,2,car,van,492,948,412,767,456,355,0.9304319,3,0,2,0.7785087719298246,
57,2,car,van,489,956,411,768,467,357,0.906528,3,0,2,0.7644539614561028,
58,2,car,van,484,940,413,733,456,320,0.97553414,3,0,2,0.7017543859649122,
59,2,car,van,488,936,413,735,448,322,0.9737919,3,0,2,0.71875,
60,2,car,van,490,956,413,763,466,350,0.9481417,3,0,2,0.7510729613733905,
61,2,car,van,482,952,419,760,470,341,0.9468499,3,0,2,0.725531914893617,
62,2,car,van,590,944,439,693,354,254,0.9859484,3,0,2,0.7175141242937854,
63,2,car,van,589,949,437,697,360,260,0.98192203,3,0,2,0.7222222222222222,
64,2,car,van,590,946,439,698,356,259,0.96922255,3,0,2,0.7275280898876404,
0,2,car,van,484,958,414,763,474,349,0.97204894,3,0,2,0.7362869198312236,
1,2,car,van,493,951,415,764,458,349,0.96600556,3,0,2,0.7620087336244541,
2,2,car,van,492,954,415,764,462,349,0.97444296,3,0,2,0.7554112554112554,
3,2,car,van,487,942,414,734,455,320,0.9520047,3,0,2,0.7032967032967034,
4,2,car,van,487,938,415,731,451,316,0.96498144,3,0,2,0.7006651884700665,
5,2,car,van,485,952,416,762,467,346,0.96896255,3,0,2,0.7408993576017131,
6,2,car,van,482,958,407,772,476,365,0.9601497,3,0,2,0.7668067226890757,
7,2,car,van,493,952,417,765,459,348,0.98740655,3,0,2,0.7581699346405228,
8,2,car,van,487,938,412,739,451,327,0.944092,3,0,2,0.7250554323725056,
9,2,car,van,486,957,408,773,471,365,0.9602443,3,0,2,0.7749469214437368,
10,2,car,van,488,952,408,769,464,361,0.95232624,3,0,2,0.7780172413793104,
11,2,car,van,490,952,416,763,462,347,0.98539907,3,0,2,0.7510822510822511,
12,2,car,van,484,954,412,769,470,357,0.9619448,3,0,2,0.7595744680851064,
13,2,car,van,485,938,414,732,453,318,0.9526754,3,0,2,0.7019867549668874,
14,2,car,van,484,955,411,765,471,354,0.967853,3,0,2,0.7515923566878981,
15,2,car,van,489,957,420,756,468,336,0.97189754,3,0,2,0.717948717948718,
16,2,car,van,492,952,415,762,460,347,0.97278863,3,0,2,0.7543478260869565,
17,2,car,van,490,956,409,768,466,359,0.9676818,3,0,2,0.7703862660944206,
18,2,car,van,488,938,413,738,450,325,0.94057816,3,0,2,0.7222222222222222,
19,2,car,van,488,957,416,762,469,346,0.97819936,3,0,2,0.7377398720682303,
20,2,car,van,486,954,414,764,468,350,0.9754412,3,0,2,0.7478632478632479,
21,2,car,van,488,936,413,735,448,322,0.9562123,3,0,2,0.71875,
22,2,car,van,486,939,414,735,453,321,0.9730841,3,0,2,0.7086092715231788,
23,2,car,van,489,940,411,737,451,326,0.94711137,3,0,2,0.7228381374722838,
24,2,car,van,488,954,411,769,466,358,0.9352239,3,0,2,0.7682403433476395,
25,2,car,van,487,955,409,768,468,359,0.96377707,3,0,2,0.7670940170940171,
26,2,car,van,483,953,413,767,470,354,0.95913815,3,0,2,0.7531914893617021,
27,2,car,van,483,955,410,769,472,359,0.95927954,3,0,2,0.760593220338983,
28,2,car,van,490,943,411,735,453,324,0.9208222,3,0,2,0.7152317880794702,
29,2,car,van,486,941,412,731,455,319,0.9610242,3,0,2,0.701098901098901,
30,2,car,van,487,953,415,761,466,346,0.97434527,3,0,2,0.7424892703862661,
31,2,car,van,486,938,416,730,452,314,0.9374376,3,0,2,0.6946902654867256,
32,2,car,van,491,949,411,769,458,358,0.9677114,3,0,2,0.7816593886462883,
33,2,car,van,485,955,412,768,470,356,0.8783675,3,0,2,0.7574468085106383,
34,2,car,van,485,941,414,730,456,316,0.9736741,3,0,2,0.6929824561403509,
35,2,car,van,485,948,416,761,463,345,0.95564747,3,0,2,0.7451403887688985,
36,2,car,van,485,942,410,739,457,329,0.94875216,3,0,2,0.7199124726477024,
37,2,car,van,487,951,414,764,464,350,0.95158833,3,0,2,0.7543103448275862,
38,2,car,van,489,955,409,769,466,360,0.95695746,3,0,2,0.7725321888412017,
39,2,car,van,496,948,415,764,452,349,0.9718963,3,0,2,0.7721238938053098,
40,2,car,van,488,953,416,761,465,345,0.97468466,3,0,2,0.7419354838709677,
41,2,car,van,483,955,415,763,472,348,0.9583383,3,0,2,0.7372881355932204,
42,2,car,van,488,940,412,737,452,325,0.9648091,3,0,2,0.7190265486725663,
43,2,car,van,484,957,412,766,473,354,0.95933455,3,0,2,0.7484143763213531,
44,2,car,van,488,949,417,759,461,342,0.9826786,3,0,2,0.7418655097613883,
45,2,car,van,482,959,414,763,477,349,0.888824,3,0,2,0.7316561844863732,
46,2,car,van,487,955,420,758,468,338,0.9463203,3,0,2,0.7222222222222222,
47,2,car,van,492,952,410,768,460,358,0.9421822,3,0,2,0.7782608695652173,
48,2,car,van,488,939,416,730,451,314,0.9661252,3,0,2,0.6962305986696231,
49,2,car,van,482,955,419,756,473,337,0.94365954,3,0,2,0.7124735729386892,
50,2,car,van,494,951,409,769,457,360,0.95296556,3,0,2,0.787746170678337,
51,2,car,van,487,960,415,764,473,349,0.9687263,3,0,2,0.7378435517970402,
52,2,car,van,479,962,412,769,483,357,0.95937186,3,0,2,0.7391304347826086,
53,2,car,van,484,935,412,738,451,326,0.9526533,3,0,2,0.7228381374722838,
54,2,car,van,482,944,410,736,462,326,0.97273606,3,0,2,0.7056277056277056,
55,2,car,van,480,940,415,734,460,319,0.96075284,3,0,2,0.6934782608695652,
56,2,car,van,486,953,415,763,467,348,0.95723224,3,0,2,0.7451820128479657,
57,2,car,van,492,948,412,767,456,355,0.9304319,3,0,2,0.7785087719298246,
58,2,car,van,489,956,411,768,467,357,0.906528,3,0,2,0.7644539614561028,
59,2,car,van,484,940,413,733,456,320,0.97553414,3,0,2,0.7017543859649122,
60,2,car,van,488,936,413,735,448,322,0.9737919,3,0,2,0.71875,
61,2,car,van,490,956,413,763,466,350,0.9481417,3,0,2,0.7510729613733905,
62,2,car,van,482,952,419,760,470,341,0.9468499,3,0,2,0.725531914893617,
63,2,car,van,590,944,439,693,354,254,0.9859484,3,0,2,0.7175141242937854,
64,2,car,van,589,949,437,697,360,260,0.98192203,3,0,2,0.7222222222222222,
65,2,car,van,590,946,439,698,356,259,0.96922255,3,0,2,0.7275280898876404,
0,2,car,van,488,937,411,738,449,327,0.9417135,3,0,2,0.7282850779510023,
1,2,car,van,484,958,414,763,474,349,0.97204894,3,0,2,0.7362869198312236,
2,2,car,van,493,951,415,764,458,349,0.96600556,3,0,2,0.7620087336244541,
3,2,car,van,492,954,415,764,462,349,0.97444296,3,0,2,0.7554112554112554,
4,2,car,van,487,942,414,734,455,320,0.9520047,3,0,2,0.7032967032967034,
5,2,car,van,487,938,415,731,451,316,0.96498144,3,0,2,0.7006651884700665,
6,2,car,van,485,952,416,762,467,346,0.96896255,3,0,2,0.7408993576017131,
7,2,car,van,482,958,407,772,476,365,0.9601497,3,0,2,0.7668067226890757,
8,2,car,van,493,952,417,765,459,348,0.98740655,3,0,2,0.7581699346405228,
9,2,car,van,487,938,412,739,451,327,0.944092,3,0,2,0.7250554323725056,
10,2,car,van,486,957,408,773,471,365,0.9602443,3,0,2,0.7749469214437368,
11,2,car,van,488,952,408,769,464,361,0.95232624,3,0,2,0.7780172413793104,
12,2,car,van,490,952,416,763,462,347,0.98539907,3,0,2,0.7510822510822511,
13,2,car,van,484,954,412,769,470,357,0.9619448,3,0,2,0.7595744680851064,
14,2,car,van,485,938,414,732,453,318,0.9526754,3,0,2,0.7019867549668874,
15,2,car,van,484,955,411,765,471,354,0.967853,3,0,2,0.7515923566878981,
16,2,car,van,489,957,420,756,468,336,0.97189754,3,0,2,0.717948717948718,
17,2,car,van,492,952,415,762,460,347,0.97278863,3,0,2,0.7543478260869565,
18,2,car,van,490,956,409,768,466,359,0.9676818,3,0,2,0.7703862660944206,
19,2,car,van,488,938,413,738,450,325,0.94057816,3,0,2,0.7222222222222222,
20,2,car,van,488,957,416,762,469,346,0.97819936,3,0,2,0.7377398720682303,
21,2,car,van,486,954,414,764,468,350,0.9754412,3,0,2,0.7478632478632479,
22,2,car,van,488,936,413,735,448,322,0.9562123,3,0,2,0.71875,
23,2,car,van,486,939,414,735,453,321,0.9730841,3,0,2,0.7086092715231788,
24,2,car,van,489,940,411,737,451,326,0.94711137,3,0,2,0.7228381374722838,
25,2,car,van,488,954,411,769,466,358,0.9352239,3,0,2,0.7682403433476395,
26,2,car,van,487,955,409,768,468,359,0.96377707,3,0,2,0.7670940170940171,
27,2,car,van,483,953,413,767,470,354,0.95913815,3,0,2,0.7531914893617021,
28,2,car,van,483,955,410,769,472,359,0.95927954,3,0,2,0.760593220338983,
29,2,car,van,490,943,411,735,453,324,0.9208222,3,0,2,0.7152317880794702,
30,2,car,van,486,941,412,731,455,319,0.9610242,3,0,2,0.701098901098901,
31,2,car,van,487,953,415,761,466,346,0.97434527,3,0,2,0.7424892703862661,
32,2,car,van,486,938,416,730,452,314,0.9374376,3,0,2,0.6946902654867256,
33,2,car,van,491,949,411,769,458,358,0.9677114,3,0,2,0.7816593886462883,
34,2,car,van,485,955,412,768,470,356,0.8783675,3,0,2,0.7574468085106383,
35,2,car,van,485,941,414,730,456,316,0.9736741,3,0,2,0.6929824561403509,
36,2,car,van,485,948,416,761,463,345,0.95564747,3,0,2,0.7451403887688985,
37,2,car,van,485,942,410,739,457,329,0.94875216,3,0,2,0.7199124726477024,
38,2,car,van,487,951,414,764,464,350,0.95158833,3,0,2,0.7543103448275862,
39,2,car,van,489,955,409,769,466,360,0.95695746,3,0,2,0.7725321888412017,
40,2,car,van,496,948,415,764,452,349,0.9718963,3,0,2,0.7721238938053098,
41,2,car,van,488,953,416,761,465,345,0.97468466,3,0,2,0.7419354838709677,
42,2,car,van,483,955,415,763,472,348,0.9583383,3,0,2,0.7372881355932204,
43,2,car,van,488,940,412,737,452,325,0.9648091,3,0,2,0.7190265486725663,
44,2,car,van,484,957,412,766,473,354,0.95933455,3,0,2,0.7484143763213531,
45,2,car,van,488,949,417,759,461,342,0.9826786,3,0,2,0.7418655097613883,
46,2,car,van,482,959,414,763,477,349,0.888824,3,0,2,0.7316561844863732,
47,2,car,van,487,955,420,758,468,338,0.9463203,3,0,2,0.7222222222222222,
48,2,car,van,492,952,410,768,460,358,0.9421822,3,0,2,0.7782608695652173,
49,2,car,van,488,939,416,730,451,314,0.9661252,3,0,2,0.6962305986696231,
50,2,car,van,482,955,419,756,473,337,0.94365954,3,0,2,0.7124735729386892,
51,2,car,van,494,951,409,769,457,360,0.95296556,3,0,2,0.787746170678337,
52,2,car,van,487,960,415,764,473,349,0.9687263,3,0,2,0.7378435517970402,
53,2,car,van,479,962,412,769,483,357,0.95937186,3,0,2,0.7391304347826086,
54,2,car,van,484,935,412,738,451,326,0.9526533,3,0,2,0.7228381374722838,
55,2,car,van,482,944,410,736,462,326,0.97273606,3,0,2,0.7056277056277056,
56,2,car,van,480,940,415,734,460,319,0.96075284,3,0,2,0.6934782608695652,
57,2,car,van,486,953,415,763,467,348,0.95723224,3,0,2,0.7451820128479657,
58,2,car,van,492,948,412,767,456,355,0.9304319,3,0,2,0.7785087719298246,
59,2,car,van,489,956,411,768,467,357,0.906528,3,0,2,0.7644539614561028,
60,2,car,van,484,940,413,733,456,320,0.97553414,3,0,2,0.7017543859649122,
61,2,car,van,488,936,413,735,448,322,0.9737919,3,0,2,0.71875,
62,2,car,van,490,956,413,763,466,350,0.9481417,3,0,2,0.7510729613733905,
63,2,car,van,482,952,419,760,470,341,0.9468499,3,0,2,0.725531914893617,
64,2,car,van,590,944,439,693,354,254,0.9859484,3,0,2,0.7175141242937854,
65,2,car,van,589,949,437,697,360,260,0.98192203,3,0,2,0.7222222222222222,
66,2,car,van,590,946,439,698,356,259,0.96922255,3,0,2,0.7275280898876404,
0,2,car,van,490,953,410,767,463,357,0.9787868,3,0,2,0.7710583153347732,
1,2,car,van,488,937,411,738,449,327,0.9417135,3,0,2,0.7282850779510023,
2,2,car,van,484,958,414,763,474,349,0.97204894,3,0,2,0.7362869198312236,
3,2,car,van,493,951,415,764,458,349,0.96600556,3,0,2,0.7620087336244541,
4,2,car,van,492,954,415,764,462,349,0.97444296,3,0,2,0.7554112554112554,
5,2,car,van,487,942,414,734,455,320,0.9520047,3,0,2,0.7032967032967034,
6,2,car,van,487,938,415,731,451,316,0.96498144,3,0,2,0.7006651884700665,
7,2,car,van,485,952,416,762,467,346,0.96896255,3,0,2,0.7408993576017131,
8,2,car,van,482,958,407,772,476,365,0.9601497,3,0,2,0.7668067226890757,
9,2,car,van,493,952,417,765,459,348,0.98740655,3,0,2,0.7581699346405228,
10,2,car,van,487,938,412,739,451,327,0.944092,3,0,2,0.7250554323725056,
11,2,car,van,486,957,408,773,471,365,0.9602443,3,0,2,0.7749469214437368,
12,2,car,van,488,952,408,769,464,361,0.95232624,3,0,2,0.7780172413793104,
13,2,car,van,490,952,416,763,462,347,0.98539907,3,0,2,0.7510822510822511,
14,2,car,van,484,954,412,769,470,357,0.9619448,3,0,2,0.7595744680851064,
15,2,car,van,485,938,414,732,453,318,0.9526754,3,0,2,0.7019867549668874,
16,2,car,van,484,955,411,765,471,354,0.967853,3,0,2,0.7515923566878981,
17,2,car,van,489,957,420,756,468,336,0.97189754,3,0,2,0.717948717948718,
18,2,car,van,492,952,415,762,460,347,0.97278863,3,0,2,0.7543478260869565,
19,2,car,van,490,956,409,768,466,359,0.9676818,3,0,2,0.7703862660944206,
20,2,car,van,488,938,413,738,450,325,0.94057816,3,0,2,0.7222222222222222,
21,2,car,van,488,957,416,762,469,346,0.97819936,3,0,2,0.7377398720682303,
22,2,car,van,486,954,414,764,468,350,0.9754412,3,0,2,0.7478632478632479,
23,2,car,van,488,936,413,735,448,322,0.9562123,3,0,2,0.71875,
24,2,car,van,486,939,414,735,453,321,0.9730841,3,0,2,0.7086092715231788,
25,2,car,van,489,940,411,737,451,326,0.94711137,3,0,2,0.7228381374722838,
26,2,car,van,488,954,411,769,466,358,0.9352239,3,0,2,0.7682403433476395,
27,2,car,van,487,955,409,768,468,359,0.96377707,3,0,2,0.7670940170940171,
28,2,car,van,483,953,413,767,470,354,0.95913815,3,0,2,0.7531914893617021,
29,2,car,van,483,955,410,769,472,359,0.95927954,3,0,2,0.760593220338983,
30,2,car,van,490,943,411,735,453,324,0.9208222,3,0,2,0.7152317880794702,
31,2,car,van,486,941,412,731,455,319,0.9610242,3,0,2,0.701098901098901,
32,2,car,van,487,953,415,761,466,346,0.97434527,3,0,2,0.7424892703862661,
33,2,car,van,486,938,416,730,452,314,0.9374376,3,0,2,0.6946902654867256,
34,2,car,van,491,949,411,769,458,358,0.9677114,3,0,2,0.7816593886462883,
35,2,car,van,485,955,412,768,470,356,0.8783675,3,0,2,0.7574468085106383,
36,2,car,van,485,941,414,730,456,316,0.9736741,3,0,2,0.6929824561403509,
37,2,car,van,485,948,416,761,463,345,0.95564747,3,0,2,0.7451403887688985,
38,2,car,van,485,942,410,739,457,329,0.94875216,3,0,2,0.7199124726477024,
39,2,car,van,487,951,414,764,464,350,0.95158833,3,0,2,0.7543103448275862,
40,2,car,van,489,955,409,769,466,360,0.95695746,3,0,2,0.7725321888412017,
41,2,car,van,496,948,415,764,452,349,0.9718963,3,0,2,0.7721238938053098,
42,2,car,van,488,953,416,761,465,345,0.97468466,3,0,2,0.7419354838709677,
43,2,car,van,483,955,415,763,472,348,0.9583383,3,0,2,0.7372881355932204,
44,2,car,van,488,940,412,737,452,325,0.9648091,3,0,2,0.7190265486725663,
45,2,car,van,484,957,412,766,473,354,0.95933455,3,0,2,0.7484143763213531,
46,2,car,van,488,949,417,759,461,342,0.9826786,3,0,2,0.7418655097613883,
47,2,car,van,482,959,414,763,477,349,0.888824,3,0,2,0.7316561844863732,
48,2,car,van,487,955,420,758,468,338,0.9463203,3,0,2,0.7222222222222222,
49,2,car,van,492,952,410,768,460,358,0.9421822,3,0,2,0.7782608695652173,
50,2,car,van,488,939,416,730,451,314,0.9661252,3,0,2,0.6962305986696231,
51,2,car,van,482,955,419,756,473,337,0.94365954,3,0,2,0.7124735729386892,
52,2,car,van,494,951,409,769,457,360,0.95296556,3,0,2,0.787746170678337,
53,2,car,van,487,960,415,764,473,349,0.9687263,3,0,2,0.7378435517970402,
54,2,car,van,479,962,412,769,483,357,0.95937186,3,0,2,0.7391304347826086,
55,2,car,van,484,935,412,738,451,326,0.9526533,3,0,2,0.7228381374722838,
56,2,car,van,482,944,410,736,462,326,0.97273606,3,0,2,0.7056277056277056,
57,2,car,van,480,940,415,734,460,319,0.96075284,3,0,2,0.6934782608695652,
58,2,car,van,486,953,415,763,467,348,0.95723224,3,0,2,0.7451820128479657,
59,2,car,van,492,948,412,767,456,355,0.9304319,3,0,2,0.7785087719298246,
60,2,car,van,489,956,411,768,467,357,0.906528,3,0,2,0.7644539614561028,
61,2,car,van,484,940,413,733,456,320,0.97553414,3,0,2,0.7017543859649122,
62,2,car,van,488,936,413,735,448,322,0.9737919,3,0,2,0.71875,
63,2,car,van,490,956,413,763,466,350,0.9481417,3,0,2,0.7510729613733905,
64,2,car,van,482,952,419,760,470,341,0.9468499,3,0,2,0.725531914893617,
65,2,car,van,590,944,439,693,354,254,0.9859484,3,0,2,0.7175141242937854,
66,2,car,van,589,949,437,697,360,260,0.98192203,3,0,2,0.7222222222222222,
67,2,car,van,590,946,439,698,356,259,0.96922255,3,0,2,0.7275280898876404,
0,2,car,van,481,957,412,766,476,354,0.92372614,3,0,2,0.7436974789915967,
1,2,car,van,490,953,410,767,463,357,0.9787868,3,0,2,0.7710583153347732,
2,2,car,van,488,937,411,738,449,327,0.9417135,3,0,2,0.7282850779510023,
3,2,car,van,484,958,414,763,474,349,0.97204894,3,0,2,0.7362869198312236,
4,2,car,van,493,951,415,764,458,349,0.96600556,3,0,2,0.7620087336244541,
5,2,car,van,492,954,415,764,462,349,0.97444296,3,0,2,0.7554112554112554,
6,2,car,van,487,942,414,734,455,320,0.9520047,3,0,2,0.7032967032967034,
7,2,car,van,487,938,415,731,451,316,0.96498144,3,0,2,0.7006651884700665,
8,2,car,van,485,952,416,762,467,346,0.96896255,3,0,2,0.7408993576017131,
9,2,car,van,482,958,407,772,476,365,0.9601497,3,0,2,0.7668067226890757,
10,2,car,van,493,952,417,765,459,348,0.98740655,3,0,2,0.7581699346405228,
11,2,car,van,487,938,412,739,451,327,0.944092,3,0,2,0.7250554323725056,
12,2,car,van,486,957,408,773,471,365,0.9602443,3,0,2,0.7749469214437368,
13,2,car,van,488,952,408,769,464,361,0.95232624,3,0,2,0.7780172413793104,
14,2,car,van,490,952,416,763,462,347,0.98539907,3,0,2,0.7510822510822511,
15,2,car,van,484,954,412,769,470,357,0.9619448,3,0,2,0.7595744680851064,
16,2,car,van,485,938,414,732,453,318,0.9526754,3,0,2,0.7019867549668874,
17,2,car,van,484,955,411,765,471,354,0.967853,3,0,2,0.7515923566878981,
18,2,car,van,489,957,420,756,468,336,0.97189754,3,0,2,0.717948717948718,
19,2,car,van,492,952,415,762,460,347,0.97278863,3,0,2,0.7543478260869565,
20,2,car,van,490,956,409,768,466,359,0.9676818,3,0,2,0.7703862660944206,
21,2,car,van,488,938,413,738,450,325,0.94057816,3,0,2,0.7222222222222222,
22,2,car,van,488,957,416,762,469,346,0.97819936,3,0,2,0.7377398720682303,
23,2,car,van,486,954,414,764,468,350,0.9754412,3,0,2,0.7478632478632479,
24,2,car,van,488,936,413,735,448,322,0.9562123,3,0,2,0.71875,
25,2,car,van,486,939,414,735,453,321,0.9730841,3,0,2,0.7086092715231788,
26,2,car,van,489,940,411,737,451,326,0.94711137,3,0,2,0.7228381374722838,
27,2,car,van,488,954,411,769,466,358,0.9352239,3,0,2,0.7682403433476395,
28,2,car,van,487,955,409,768,468,359,0.96377707,3,0,2,0.7670940170940171,
29,2,car,van,483,953,413,767,470,354,0.95913815,3,0,2,0.7531914893617021,
30,2,car,van,483,955,410,769,472,359,0.95927954,3,0,2,0.760593220338983,
31,2,car,van,490,943,411,735,453,324,0.9208222,3,0,2,0.7152317880794702,
32,2,car,van,486,941,412,731,455,319,0.9610242,3,0,2,0.701098901098901,
33,2,car,van,487,953,415,761,466,346,0.97434527,3,0,2,0.7424892703862661,
34,2,car,van,486,938,416,730,452,314,0.9374376,3,0,2,0.6946902654867256,
35,2,car,van,491,949,411,769,458,358,0.9677114,3,0,2,0.7816593886462883,
36,2,car,van,485,955,412,768,470,356,0.8783675,3,0,2,0.7574468085106383,
37,2,car,van,485,941,414,730,456,316,0.9736741,3,0,2,0.6929824561403509,
38,2,car,van,485,948,416,761,463,345,0.95564747,3,0,2,0.7451403887688985,
39,2,car,van,485,942,410,739,457,329,0.94875216,3,0,2,0.7199124726477024,
40,2,car,van,487,951,414,764,464,350,0.95158833,3,0,2,0.7543103448275862,
41,2,car,van,489,955,409,769,466,360,0.95695746,3,0,2,0.7725321888412017,
42,2,car,van,496,948,415,764,452,349,0.9718963,3,0,2,0.7721238938053098,
43,2,car,van,488,953,416,761,465,345,0.97468466,3,0,2,0.7419354838709677,
44,2,car,van,483,955,415,763,472,348,0.9583383,3,0,2,0.7372881355932204,
45,2,car,van,488,940,412,737,452,325,0.9648091,3,0,2,0.7190265486725663,
46,2,car,van,484,957,412,766,473,354,0.95933455,3,0,2,0.7484143763213531,
47,2,car,van,488,949,417,759,461,342,0.9826786,3,0,2,0.7418655097613883,
48,2,car,van,482,959,414,763,477,349,0.888824,3,0,2,0.7316561844863732,
49,2,car,van,487,955,420,758,468,338,0.9463203,3,0,2,0.7222222222222222,
50,2,car,van,492,952,410,768,460,358,0.9421822,3,0,2,0.7782608695652173,
51,2,car,van,488,939,416,730,451,314,0.9661252,3,0,2,0.6962305986696231,
52,2,car,van,482,955,419,756,473,337,0.94365954,3,0,2,0.7124735729386892,
53,2,car,van,494,951,409,769,457,360,0.95296556,3,0,2,0.787746170678337,
54,2,car,van,487,960,415,764,473,349,0.9687263,3,0,2,0.7378435517970402,
55,2,car,van,479,962,412,769,483,357,0.95937186,3,0,2,0.7391304347826086,
56,2,car,van,484,935,412,738,451,326,0.9526533,3,0,2,0.7228381374722838,
57,2,car,van,482,944,410,736,462,326,0.97273606,3,0,2,0.7056277056277056,
58,2,car,van,480,940,415,734,460,319,0.96075284,3,0,2,0.6934782608695652,
59,2,car,van,486,953,415,763,467,348,0.95723224,3,0,2,0.7451820128479657,
60,2,car,van,492,948,412,767,456,355,0.9304319,3,0,2,0.7785087719298246,
61,2,car,van,489,956,411,768,467,357,0.906528,3,0,2,0.7644539614561028,
62,2,car,van,484,940,413,733,456,320,0.97553414,3,0,2,0.7017543859649122,
63,2,car,van,488,936,413,735,448,322,0.9737919,3,0,2,0.71875,
64,2,car,van,490,956,413,763,466,350,0.9481417,3,0,2,0.7510729613733905,
65,2,car,van,482,952,419,760,470,341,0.9468499,3,0,2,0.725531914893617,
66,2,car,van,590,944,439,693,354,254,0.9859484,3,0,2,0.7175141242937854,
67,2,car,van,589,949,437,697,360,260,0.98192203,3,0,2,0.7222222222222222,
68,2,car,van,590,946,439,698,356,259,0.96922255,3,0,2,0.7275280898876404,
0,2,car,van,486,936,413,738,450,325,0.96561056,3,0,2,0.7222222222222222,
1,2,car,van,481,957,412,766,476,354,0.92372614,3,0,2,0.7436974789915967,
2,2,car,van,490,953,410,767,463,357,0.9787868,3,0,2,0.7710583153347732,
3,2,car,van,488,937,411,738,449,327,0.9417135,3,0,2,0.7282850779510023,
4,2,car,van,484,958,414,763,474,349,0.97204894,3,0,2,0.7362869198312236,
5,2,car,van,493,951,415,764,458,349,0.96600556,3,0,2,0.7620087336244541,
6,2,car,van,492,954,415,764,462,349,0.97444296,3,0,2,0.7554112554112554,
7,2,car,van,487,942,414,734,455,320,0.9520047,3,0,2,0.7032967032967034,
8,2,car,van,487,938,415,731,451,316,0.96498144,3,0,2,0.7006651884700665,
9,2,car,van,485,952,416,762,467,346,0.96896255,3,0,2,0.7408993576017131,
10,2,car,van,482,958,407,772,476,365,0.9601497,3,0,2,0.7668067226890757,
11,2,car,van,493,952,417,765,459,348,0.98740655,3,0,2,0.7581699346405228,
12,2,car,van,487,938,412,739,451,327,0.944092,3,0,2,0.7250554323725056,
13,2,car,van,486,957,408,773,471,365,0.9602443,3,0,2,0.7749469214437368,
14,2,car,van,488,952,408,769,464,361,0.95232624,3,0,2,0.7780172413793104,
15,2,car,van,490,952,416,763,462,347,0.98539907,3,0,2,0.7510822510822511,
16,2,car,van,484,954,412,769,470,357,0.9619448,3,0,2,0.7595744680851064,
17,2,car,van,485,938,414,732,453,318,0.9526754,3,0,2,0.7019867549668874,
18,2,car,van,484,955,411,765,471,354,0.967853,3,0,2,0.7515923566878981,
19,2,car,van,489,957,420,756,468,336,0.97189754,3,0,2,0.717948717948718,
20,2,car,van,492,952,415,762,460,347,0.97278863,3,0,2,0.7543478260869565,
21,2,car,van,490,956,409,768,466,359,0.9676818,3,0,2,0.7703862660944206,
22,2,car,van,488,938,413,738,450,325,0.94057816,3,0,2,0.7222222222222222,
23,2,car,van,488,957,416,762,469,346,0.97819936,3,0,2,0.7377398720682303,
24,2,car,van,486,954,414,764,468,350,0.9754412,3,0,2,0.7478632478632479,
25,2,car,van,488,936,413,735,448,322,0.9562123,3,0,2,0.71875,
26,2,car,van,486,939,414,735,453,321,0.9730841,3,0,2,0.7086092715231788,
27,2,car,van,489,940,411,737,451,326,0.94711137,3,0,2,0.7228381374722838,
28,2,car,van,488,954,411,769,466,358,0.9352239,3,0,2,0.7682403433476395,
29,2,car,van,487,955,409,768,468,359,0.96377707,3,0,2,0.7670940170940171,
30,2,car,van,483,953,413,767,470,354,0.95913815,3,0,2,0.7531914893617021,
31,2,car,van,483,955,410,769,472,359,0.95927954,3,0,2,0.760593220338983,
32,2,car,van,490,943,411,735,453,324,0.9208222,3,0,2,0.7152317880794702,
33,2,car,van,486,941,412,731,455,319,0.9610242,3,0,2,0.701098901098901,
34,2,car,van,487,953,415,761,466,346,0.97434527,3,0,2,0.7424892703862661,
35,2,car,van,486,938,416,730,452,314,0.9374376,3,0,2,0.6946902654867256,
36,2,car,van,491,949,411,769,458,358,0.9677114,3,0,2,0.7816593886462883,
37,2,car,van,485,955,412,768,470,356,0.8783675,3,0,2,0.7574468085106383,
38,2,car,van,485,941,414,730,456,316,0.9736741,3,0,2,0.6929824561403509,
39,2,car,van,485,948,416,761,463,345,0.95564747,3,0,2,0.7451403887688985,
40,2,car,van,485,942,410,739,457,329,0.94875216,3,0,2,0.7199124726477024,
41,2,car,van,487,951,414,764,464,350,0.95158833,3,0,2,0.7543103448275862,
42,2,car,van,489,955,409,769,466,360,0.95695746,3,0,2,0.7725321888412017,
43,2,car,van,496,948,415,764,452,349,0.9718963,3,0,2,0.7721238938053098,
44,2,car,van,488,953,416,761,465,345,0.97468466,3,0,2,0.7419354838709677,
45,2,car,van,483,955,415,763,472,348,0.9583383,3,0,2,0.7372881355932204,
46,2,car,van,488,940,412,737,452,325,0.9648091,3,0,2,0.7190265486725663,
47,2,car,van,484,957,412,766,473,354,0.95933455,3,0,2,0.7484143763213531,
48,2,car,van,488,949,417,759,461,342,0.9826786,3,0,2,0.7418655097613883,
49,2,car,van,482,959,414,763,477,349,0.888824,3,0,2,0.7316561844863732,
50,2,car,van,487,955,420,758,468,338,0.9463203,3,0,2,0.7222222222222222,
51,2,car,van,492,952,410,768,460,358,0.9421822,3,0,2,0.7782608695652173,
52,2,car,van,488,939,416,730,451,314,0.9661252,3,0,2,0.6962305986696231,
53,2,car,van,482,955,419,756,473,337,0.94365954,3,0,2,0.7124735729386892,
54,2,car,van,494,951,409,769,457,360,0.95296556,3,0,2,0.787746170678337,
55,2,car,van,487,960,415,764,473,349,0.9687263,3,0,2,0.7378435517970402,
56,2,car,van,479,962,412,769,483,357,0.95937186,3,0,2,0.7391304347826086,
57,2,car,van,484,935,412,738,451,326,0.9526533,3,0,2,0.7228381374722838,
58,2,car,van,482,944,410,736,462,326,0.97273606,3,0,2,0.7056277056277056,
59,2,car,van,480,940,415,734,460,319,0.96075284,3,0,2,0.6934782608695652,
60,2,car,van,486,953,415,763,467,348,0.95723224,3,0,2,0.7451820128479657,
61,2,car,van,492,948,412,767,456,355,0.9304319,3,0,2,0.7785087719298246,
62,2,car,van,489,956,411,768,467,357,0.906528,3,0,2,0.7644539614561028,
63,2,car,van,484,940,413,733,456,320,0.97553414,3,0,2,0.7017543859649122,
64,2,car,van,488,936,413,735,448,322,0.9737919,3,0,2,0.71875,
65,2,car,van,490,956,413,763,466,350,0.9481417,3,0,2,0.7510729613733905,
66,2,car,van,482,952,419,760,470,341,0.9468499,3,0,2,0.725531914893617,
67,2,car,van,590,944,439,693,354,254,0.9859484,3,0,2,0.7175141242937854,
68,2,car,van,589,949,437,697,360,260,0.98192203,3,0,2,0.7222222222222222,
69,2,car,van,590,946,439,698,356,259,0.96922255,3,0,2,0.7275280898876404,
0,2,car,van,487,955,409,769,468,360,0.96269614,3,0,2,0.7692307692307693,
1,2,car,van,486,936,413,738,450,325,0.96561056,3,0,2,0.7222222222222222,
2,2,car,van,481,957,412,766,476,354,0.92372614,3,0,2,0.7436974789915967,
3,2,car,van,490,953,410,767,463,357,0.9787868,3,0,2,0.7710583153347732,
4,2,car,van,488,937,411,738,449,327,0.9417135,3,0,2,0.7282850779510023,
5,2,car,van,484,958,414,763,474,349,0.97204894,3,0,2,0.7362869198312236,
6,2,car,van,493,951,415,764,458,349,0.96600556,3,0,2,0.7620087336244541,
7,2,car,van,492,954,415,764,462,349,0.97444296,3,0,2,0.7554112554112554,
8,2,car,van,487,942,414,734,455,320,0.9520047,3,0,2,0.7032967032967034,
9,2,car,van,487,938,415,731,451,316,0.96498144,3,0,2,0.7006651884700665,
10,2,car,van,485,952,416,762,467,346,0.96896255,3,0,2,0.7408993576017131,
11,2,car,van,482,958,407,772,476,365,0.9601497,3,0,2,0.7668067226890757,
12,2,car,van,493,952,417,765,459,348,0.98740655,3,0,2,0.7581699346405228,
13,2,car,van,487,938,412,739,451,327,0.944092,3,0,2,0.7250554323725056,
14,2,car,van,486,957,408,773,471,365,0.9602443,3,0,2,0.7749469214437368,
15,2,car,van,488,952,408,769,464,361,0.95232624,3,0,2,0.7780172413793104,
16,2,car,van,490,952,416,763,462,347,0.98539907,3,0,2,0.7510822510822511,
17,2,car,van,484,954,412,769,470,357,0.9619448,3,0,2,0.7595744680851064,
18,2,car,van,485,938,414,732,453,318,0.9526754,3,0,2,0.7019867549668874,
19,2,car,van,484,955,411,765,471,354,0.967853,3,0,2,0.7515923566878981,
20,2,car,van,489,957,420,756,468,336,0.97189754,3,0,2,0.717948717948718,
21,2,car,van,492,952,415,762,460,347,0.97278863,3,0,2,0.7543478260869565,
22,2,car,van,490,956,409,768,466,359,0.9676818,3,0,2,0.7703862660944206,
23,2,car,van,488,938,413,738,450,325,0.94057816,3,0,2,0.7222222222222222,
24,2,car,van,488,957,416,762,469,346,0.97819936,3,0,2,0.7377398720682303,
25,2,car,van,486,954,414,764,468,350,0.9754412,3,0,2,0.7478632478632479,
26,2,car,van,488,936,413,735,448,322,0.9562123,3,0,2,0.71875,
27,2,car,van,486,939,414,735,453,321,0.9730841,3,0,2,0.7086092715231788,
28,2,car,van,489,940,411,737,451,326,0.94711137,3,0,2,0.7228381374722838,
29,2,car,van,488,954,411,769,466,358,0.9352239,3,0,2,0.7682403433476395,
30,2,car,van,487,955,409,768,468,359,0.96377707,3,0,2,0.7670940170940171,
31,2,car,van,483,953,413,767,470,354,0.95913815,3,0,2,0.7531914893617021,
32,2,car,van,483,955,410,769,472,359,0.95927954,3,0,2,0.760593220338983,
33,2,car,van,490,943,411,735,453,324,0.9208222,3,0,2,0.7152317880794702,
34,2,car,van,486,941,412,731,455,319,0.9610242,3,0,2,0.701098901098901,
35,2,car,van,487,953,415,761,466,346,0.97434527,3,0,2,0.7424892703862661,
36,2,car,van,486,938,416,730,452,314,0.9374376,3,0,2,0.6946902654867256,
37,2,car,van,491,949,411,769,458,358,0.9677114,3,0,2,0.7816593886462883,
38,2,car,van,485,955,412,768,470,356,0.8783675,3,0,2,0.7574468085106383,
39,2,car,van,485,941,414,730,456,316,0.9736741,3,0,2,0.6929824561403509,
40,2,car,van,485,948,416,761,463,345,0.95564747,3,0,2,0.7451403887688985,
41,2,car,van,485,942,410,739,457,329,0.94875216,3,0,2,0.7199124726477024,
42,2,car,van,487,951,414,764,464,350,0.95158833,3,0,2,0.7543103448275862,
43,2,car,van,489,955,409,769,466,360,0.95695746,3,0,2,0.7725321888412017,
44,2,car,van,496,948,415,764,452,349,0.9718963,3,0,2,0.7721238938053098,
45,2,car,van,488,953,416,761,465,345,0.97468466,3,0,2,0.7419354838709677,
46,2,car,van,483,955,415,763,472,348,0.9583383,3,0,2,0.7372881355932204,
47,2,car,van,488,940,412,737,452,325,0.9648091,3,0,2,0.7190265486725663,
48,2,car,van,484,957,412,766,473,354,0.95933455,3,0,2,0.7484143763213531,
49,2,car,van,488,949,417,759,461,342,0.9826786,3,0,2,0.7418655097613883,
50,2,car,van,482,959,414,763,477,349,0.888824,3,0,2,0.7316561844863732,
51,2,car,van,487,955,420,758,468,338,0.9463203,3,0,2,0.7222222222222222,
52,2,car,van,492,952,410,768,460,358,0.9421822,3,0,2,0.7782608695652173,
53,2,car,van,488,939,416,730,451,314,0.9661252,3,0,2,0.6962305986696231,
54,2,car,van,482,955,419,756,473,337,0.94365954,3,0,2,0.7124735729386892,
55,2,car,van,494,951,409,769,457,360,0.95296556,3,0,2,0.787746170678337,
56,2,car,van,487,960,415,764,473,349,0.9687263,3,0,2,0.7378435517970402,
57,2,car,van,479,962,412,769,483,357,0.95937186,3,0,2,0.7391304347826086,
58,2,car,van,484,935,412,738,451,326,0.9526533,3,0,2,0.7228381374722838,
59,2,car,van,482,944,410,736,462,326,0.97273606,3,0,2,0.7056277056277056,
60,2,car,van,480,940,415,734,460,319,0.96075284,3,0,2,0.6934782608695652,
61,2,car,van,486,953,415,763,467,348,0.95723224,3,0,2,0.7451820128479657,
62,2,car,van,492,948,412,767,456,355,0.9304319,3,0,2,0.7785087719298246,
63,2,car,van,489,956,411,768,467,357,0.906528,3,0,2,0.7644539614561028,
64,2,car,van,484,940,413,733,456,320,0.97553414,3,0,2,0.7017543859649122,
65,2,car,van,488,936,413,735,448,322,0.9737919,3,0,2,0.71875,
66,2,car,van,490,956,413,763,466,350,0.9481417,3,0,2,0.7510729613733905,
67,2,car,van,482,952,419,760,470,341,0.9468499,3,0,2,0.725531914893617,
68,2,car,van,590,944,439,693,354,254,0.9859484,3,0,2,0.7175141242937854,
69,2,car,van,589,949,437,697,360,260,0.98192203,3,0,2,0.7222222222222222,
70,2,car,van,590,946,439,698,356,259,0.96922255,3,0,2,0.7275280898876404,
0,2,car,van,482,955,413,766,473,353,0.9732442,3,0,2,0.7463002114164905,
1,2,car,van,487,955,409,769,468,360,0.96269614,3,0,2,0.7692307692307693,
2,2,car,van,486,936,413,738,450,325,0.96561056,3,0,2,0.7222222222222222,
3,2,car,van,481,957,412,766,476,354,0.92372614,3,0,2,0.7436974789915967,
4,2,car,van,490,953,410,767,463,357,0.9787868,3,0,2,0.7710583153347732,
5,2,car,van,488,937,411,738,449,327,0.9417135,3,0,2,0.7282850779510023,
6,2,car,van,484,958,414,763,474,349,0.97204894,3,0,2,0.7362869198312236,
7,2,car,van,493,951,415,764,458,349,0.96600556,3,0,2,0.7620087336244541,
8,2,car,van,492,954,415,764,462,349,0.97444296,3,0,2,0.7554112554112554,
9,2,car,van,487,942,414,734,455,320,0.9520047,3,0,2,0.7032967032967034,
10,2,car,van,487,938,415,731,451,316,0.96498144,3,0,2,0.7006651884700665,
11,2,car,van,485,952,416,762,467,346,0.96896255,3,0,2,0.7408993576017131,
12,2,car,van,482,958,407,772,476,365,0.9601497,3,0,2,0.7668067226890757,
13,2,car,van,493,952,417,765,459,348,0.98740655,3,0,2,0.7581699346405228,
14,2,car,van,487,938,412,739,451,327,0.944092,3,0,2,0.7250554323725056,
15,2,car,van,486,957,408,773,471,365,0.9602443,3,0,2,0.7749469214437368,
16,2,car,van,488,952,408,769,464,361,0.95232624,3,0,2,0.7780172413793104,
17,2,car,van,490,952,416,763,462,347,0.98539907,3,0,2,0.7510822510822511,
18,2,car,van,484,954,412,769,470,357,0.9619448,3,0,2,0.7595744680851064,
19,2,car,van,485,938,414,732,453,318,0.9526754,3,0,2,0.7019867549668874,
20,2,car,van,484,955,411,765,471,354,0.967853,3,0,2,0.7515923566878981,
21,2,car,van,489,957,420,756,468,336,0.97189754,3,0,2,0.717948717948718,
22,2,car,van,492,952,415,762,460,347,0.97278863,3,0,2,0.7543478260869565,
23,2,car,van,490,956,409,768,466,359,0.9676818,3,0,2,0.7703862660944206,
24,2,car,van,488,938,413,738,450,325,0.94057816,3,0,2,0.7222222222222222,
25,2,car,van,488,957,416,762,469,346,0.97819936,3,0,2,0.7377398720682303,
26,2,car,van,486,954,414,764,468,350,0.9754412,3,0,2,0.7478632478632479,
27,2,car,van,488,936,413,735,448,322,0.9562123,3,0,2,0.71875,
28,2,car,van,486,939,414,735,453,321,0.9730841,3,0,2,0.7086092715231788,
29,2,car,van,489,940,411,737,451,326,0.94711137,3,0,2,0.7228381374722838,
30,2,car,van,488,954,411,769,466,358,0.9352239,3,0,2,0.7682403433476395,
31,2,car,van,487,955,409,768,468,359,0.96377707,3,0,2,0.7670940170940171,
32,2,car,van,483,953,413,767,470,354,0.95913815,3,0,2,0.7531914893617021,
33,2,car,van,483,955,410,769,472,359,0.95927954,3,0,2,0.760593220338983,
34,2,car,van,490,943,411,735,453,324,0.9208222,3,0,2,0.7152317880794702,
35,2,car,van,486,941,412,731,455,319,0.9610242,3,0,2,0.701098901098901,
36,2,car,van,487,953,415,761,466,346,0.97434527,3,0,2,0.7424892703862661,
37,2,car,van,486,938,416,730,452,314,0.9374376,3,0,2,0.6946902654867256,
38,2,car,van,491,949,411,769,458,358,0.9677114,3,0,2,0.7816593886462883,
39,2,car,van,485,955,412,768,470,356,0.8783675,3,0,2,0.7574468085106383,
40,2,car,van,485,941,414,730,456,316,0.9736741,3,0,2,0.6929824561403509,
41,2,car,van,485,948,416,761,463,345,0.95564747,3,0,2,0.7451403887688985,
42,2,car,van,485,942,410,739,457,329,0.94875216,3,0,2,0.7199124726477024,
43,2,car,van,487,951,414,764,464,350,0.95158833,3,0,2,0.7543103448275862,
44,2,car,van,489,955,409,769,466,360,0.95695746,3,0,2,0.7725321888412017,
45,2,car,van,496,948,415,764,452,349,0.9718963,3,0,2,0.7721238938053098,
46,2,car,van,488,953,416,761,465,345,0.97468466,3,0,2,0.7419354838709677,
47,2,car,van,483,955,415,763,472,348,0.9583383,3,0,2,0.7372881355932204,
48,2,car,van,488,940,412,737,452,325,0.9648091,3,0,2,0.7190265486725663,
49,2,car,van,484,957,412,766,473,354,0.95933455,3,0,2,0.7484143763213531,
50,2,car,van,488,949,417,759,461,342,0.9826786,3,0,2,0.7418655097613883,
51,2,car,van,482,959,414,763,477,349,0.888824,3,0,2,0.7316561844863732,
52,2,car,van,487,955,420,758,468,338,0.9463203,3,0,2,0.7222222222222222,
53,2,car,van,492,952,410,768,460,358,0.9421822,3,0,2,0.7782608695652173,
54,2,car,van,488,939,416,730,451,314,0.9661252,3,0,2,0.6962305986696231,
55,2,car,van,482,955,419,756,473,337,0.94365954,3,0,2,0.7124735729386892,
56,2,car,van,494,951,409,769,457,360,0.95296556,3,0,2,0.787746170678337,
57,2,car,van,487,960,415,764,473,349,0.9687263,3,0,2,0.7378435517970402,
58,2,car,van,479,962,412,769,483,357,0.95937186,3,0,2,0.7391304347826086,
59,2,car,van,484,935,412,738,451,326,0.9526533,3,0,2,0.7228381374722838,
60,2,car,van,482,944,410,736,462,326,0.97273606,3,0,2,0.7056277056277056,
61,2,car,van,480,940,415,734,460,319,0.96075284,3,0,2,0.6934782608695652,
62,2,car,van,486,953,415,763,467,348,0.95723224,3,0,2,0.7451820128479657,
63,2,car,van,492,948,412,767,456,355,0.9304319,3,0,2,0.7785087719298246,
64,2,car,van,489,956,411,768,467,357,0.906528,3,0,2,0.7644539614561028,
65,2,car,van,484,940,413,733,456,320,0.97553414,3,0,2,0.7017543859649122,
66,2,car,van,488,936,413,735,448,322,0.9737919,3,0,2,0.71875,
67,2,car,van,490,956,413,763,466,350,0.9481417,3,0,2,0.7510729613733905,
68,2,car,van,482,952,419,760,470,341,0.9468499,3,0,2,0.725531914893617,
69,2,car,van,590,944,439,693,354,254,0.9859484,3,0,2,0.7175141242937854,
70,2,car,van,589,949,437,697,360,260,0.98192203,3,0,2,0.7222222222222222,
71,2,car,van,590,946,439,698,356,259,0.96922255,3,0,2,0.7275280898876404,
0,2,car,van,487,935,412,739,448,327,0.94020814,3,0,2,0.7299107142857143,
1,2,car,van,482,955,413,766,473,353,0.9732442,3,0,2,0.7463002114164905,
2,2,car,van,487,955,409,769,468,360,0.96269614,3,0,2,0.7692307692307693,
3,2,car,van,486,936,413,738,450,325,0.96561056,3,0,2,0.7222222222222222,
4,2,car,van,481,957,412,766,476,354,0.92372614,3,0,2,0.7436974789915967,
5,2,car,van,490,953,410,767,463,357,0.9787868,3,0,2,0.7710583153347732,
6,2,car,van,488,937,411,738,449,327,0.9417135,3,0,2,0.7282850779510023,
7,2,car,van,484,958,414,763,474,349,0.97204894,3,0,2,0.7362869198312236,
8,2,car,van,493,951,415,764,458,349,0.96600556,3,0,2,0.7620087336244541,
9,2,car,van,492,954,415,764,462,349,0.97444296,3,0,2,0.7554112554112554,
10,2,car,van,487,942,414,734,455,320,0.9520047,3,0,2,0.7032967032967034,
11,2,car,van,487,938,415,731,451,316,0.96498144,3,0,2,0.7006651884700665,
12,2,car,van,485,952,416,762,467,346,0.96896255,3,0,2,0.7408993576017131,
13,2,car,van,482,958,407,772,476,365,0.9601497,3,0,2,0.7668067226890757,
14,2,car,van,493,952,417,765,459,348,0.98740655,3,0,2,0.7581699346405228,
15,2,car,van,487,938,412,739,451,327,0.944092,3,0,2,0.7250554323725056,
16,2,car,van,486,957,408,773,471,365,0.9602443,3,0,2,0.7749469214437368,
17,2,car,van,488,952,408,769,464,361,0.95232624,3,0,2,0.7780172413793104,
18,2,car,van,490,952,416,763,462,347,0.98539907,3,0,2,0.7510822510822511,
19,2,car,van,484,954,412,769,470,357,0.9619448,3,0,2,0.7595744680851064,
20,2,car,van,485,938,414,732,453,318,0.9526754,3,0,2,0.7019867549668874,
21,2,car,van,484,955,411,765,471,354,0.967853,3,0,2,0.7515923566878981,
22,2,car,van,489,957,420,756,468,336,0.97189754,3,0,2,0.717948717948718,
23,2,car,van,492,952,415,762,460,347,0.97278863,3,0,2,0.7543478260869565,
24,2,car,van,490,956,409,768,466,359,0.9676818,3,0,2,0.7703862660944206,
25,2,car,van,488,938,413,738,450,325,0.94057816,3,0,2,0.7222222222222222,
26,2,car,van,488,957,416,762,469,346,0.97819936,3,0,2,0.7377398720682303,
27,2,car,van,486,954,414,764,468,350,0.9754412,3,0,2,0.7478632478632479,
28,2,car,van,488,936,413,735,448,322,0.9562123,3,0,2,0.71875,
29,2,car,van,486,939,414,735,453,321,0.9730841,3,0,2,0.7086092715231788,
30,2,car,van,489,940,411,737,451,326,0.94711137,3,0,2,0.7228381374722838,
31,2,car,van,488,954,411,769,466,358,0.9352239,3,0,2,0.7682403433476395,
32,2,car,van,487,955,409,768,468,359,0.96377707,3,0,2,0.7670940170940171,
33,2,car,van,483,953,413,767,470,354,0.95913815,3,0,2,0.7531914893617021,
34,2,car,van,483,955,410,769,472,359,0.95927954,3,0,2,0.760593220338983,
35,2,car,van,490,943,411,735,453,324,0.9208222,3,0,2,0.7152317880794702,
36,2,car,van,486,941,412,731,455,319,0.9610242,3,0,2,0.701098901098901,
37,2,car,van,487,953,415,761,466,346,0.97434527,3,0,2,0.7424892703862661,
38,2,car,van,486,938,416,730,452,314,0.9374376,3,0,2,0.6946902654867256,
39,2,car,van,491,949,411,769,458,358,0.9677114,3,0,2,0.7816593886462883,
40,2,car,van,485,955,412,768,470,356,0.8783675,3,0,2,0.7574468085106383,
41,2,car,van,485,941,414,730,456,316,0.9736741,3,0,2,0.6929824561403509,
42,2,car,van,485,948,416,761,463,345,0.95564747,3,0,2,0.7451403887688985,
43,2,car,van,485,942,410,739,457,329,0.94875216,3,0,2,0.7199124726477024,
44,2,car,van,487,951,414,764,464,350,0.95158833,3,0,2,0.7543103448275862,
45,2,car,van,489,955,409,769,466,360,0.95695746,3,0,2,0.7725321888412017,
46,2,car,van,496,948,415,764,452,349,0.9718963,3,0,2,0.7721238938053098,
47,2,car,van,488,953,416,761,465,345,0.97468466,3,0,2,0.7419354838709677,
48,2,car,van,483,955,415,763,472,348,0.9583383,3,0,2,0.7372881355932204,
49,2,car,van,488,940,412,737,452,325,0.9648091,3,0,2,0.7190265486725663,
50,2,car,van,484,957,412,766,473,354,0.95933455,3,0,2,0.7484143763213531,
51,2,car,van,488,949,417,759,461,342,0.9826786,3,0,2,0.7418655097613883,
52,2,car,van,482,959,414,763,477,349,0.888824,3,0,2,0.7316561844863732,
53,2,car,van,487,955,420,758,468,338,0.9463203,3,0,2,0.7222222222222222,
54,2,car,van,492,952,410,768,460,358,0.9421822,3,0,2,0.7782608695652173,
55,2,car,van,488,939,416,730,451,314,0.9661252,3,0,2,0.6962305986696231,
56,2,car,van,482,955,419,756,473,337,0.94365954,3,0,2,0.7124735729386892,
57,2,car,van,494,951,409,769,457,360,0.95296556,3,0,2,0.787746170678337,
58,2,car,van,487,960,415,764,473,349,0.9687263,3,0,2,0.7378435517970402,
59,2,car,van,479,962,412,769,483,357,0.95937186,3,0,2,0.7391304347826086,
60,2,car,van,484,935,412,738,451,326,0.9526533,3,0,2,0.7228381374722838,
61,2,car,van,482,944,410,736,462,326,0.97273606,3,0,2,0.7056277056277056,
62,2,car,van,480,940,415,734,460,319,0.96075284,3,0,2,0.6934782608695652,
63,2,car,van,486,953,415,763,467,348,0.95723224,3,0,2,0.7451820128479657,
64,2,car,van,492,948,412,767,456,355,0.9304319,3,0,2,0.7785087719298246,
65,2,car,van,489,956,411,768,467,357,0.906528,3,0,2,0.7644539614561028,
66,2,car,van,484,940,413,733,456,320,0.97553414,3,0,2,0.7017543859649122,
67,2,car,van,488,936,413,735,448,322,0.9737919,3,0,2,0.71875,
68,2,car,van,490,956,413,763,466,350,0.9481417,3,0,2,0.7510729613733905,
69,2,car,van,482,952,419,760,470,341,0.9468499,3,0,2,0.725531914893617,
70,2,car,van,590,944,439,693,354,254,0.9859484,3,0,2,0.7175141242937854,
71,2,car,van,589,949,437,697,360,260,0.98192203,3,0,2,0.7222222222222222,
72,2,car,van,590,946,439,698,356,259,0.96922255,3,0,2,0.7275280898876404,
0,2,car,van,487,960,412,767,473,355,0.96341676,3,0,2,0.7505285412262156,
1,2,car,van,487,935,412,739,448,327,0.94020814,3,0,2,0.7299107142857143,
2,2,car,van,482,955,413,766,473,353,0.9732442,3,0,2,0.7463002114164905,
3,2,car,van,487,955,409,769,468,360,0.96269614,3,0,2,0.7692307692307693,
4,2,car,van,486,936,413,738,450,325,0.96561056,3,0,2,0.7222222222222222,
5,2,car,van,481,957,412,766,476,354,0.92372614,3,0,2,0.7436974789915967,
6,2,car,van,490,953,410,767,463,357,0.9787868,3,0,2,0.7710583153347732,
7,2,car,van,488,937,411,738,449,327,0.9417135,3,0,2,0.7282850779510023,
8,2,car,van,484,958,414,763,474,349,0.97204894,3,0,2,0.7362869198312236,
9,2,car,van,493,951,415,764,458,349,0.96600556,3,0,2,0.7620087336244541,
10,2,car,van,492,954,415,764,462,349,0.97444296,3,0,2,0.7554112554112554,
11,2,car,van,487,942,414,734,455,320,0.9520047,3,0,2,0.7032967032967034,
12,2,car,van,487,938,415,731,451,316,0.96498144,3,0,2,0.7006651884700665,
13,2,car,van,485,952,416,762,467,346,0.96896255,3,0,2,0.7408993576017131,
14,2,car,van,482,958,407,772,476,365,0.9601497,3,0,2,0.7668067226890757,
15,2,car,van,493,952,417,765,459,348,0.98740655,3,0,2,0.7581699346405228,
16,2,car,van,487,938,412,739,451,327,0.944092,3,0,2,0.7250554323725056,
17,2,car,van,486,957,408,773,471,365,0.9602443,3,0,2,0.7749469214437368,
18,2,car,van,488,952,408,769,464,361,0.95232624,3,0,2,0.7780172413793104,
19,2,car,van,490,952,416,763,462,347,0.98539907,3,0,2,0.7510822510822511,
20,2,car,van,484,954,412,769,470,357,0.9619448,3,0,2,0.7595744680851064,
21,2,car,van,485,938,414,732,453,318,0.9526754,3,0,2,0.7019867549668874,
22,2,car,van,484,955,411,765,471,354,0.967853,3,0,2,0.7515923566878981,
23,2,car,van,489,957,420,756,468,336,0.97189754,3,0,2,0.717948717948718,
24,2,car,van,492,952,415,762,460,347,0.97278863,3,0,2,0.7543478260869565,
25,2,car,van,490,956,409,768,466,359,0.9676818,3,0,2,0.7703862660944206,
26,2,car,van,488,938,413,738,450,325,0.94057816,3,0,2,0.7222222222222222,
27,2,car,van,488,957,416,762,469,346,0.97819936,3,0,2,0.7377398720682303,
28,2,car,van,486,954,414,764,468,350,0.9754412,3,0,2,0.7478632478632479,
29,2,car,van,488,936,413,735,448,322,0.9562123,3,0,2,0.71875,
30,2,car,van,486,939,414,735,453,321,0.9730841,3,0,2,0.7086092715231788,
31,2,car,van,489,940,411,737,451,326,0.94711137,3,0,2,0.7228381374722838,
32,2,car,van,488,954,411,769,466,358,0.9352239,3,0,2,0.7682403433476395,
33,2,car,van,487,955,409,768,468,359,0.96377707,3,0,2,0.7670940170940171,
34,2,car,van,483,953,413,767,470,354,0.95913815,3,0,2,0.7531914893617021,
35,2,car,van,483,955,410,769,472,359,0.95927954,3,0,2,0.760593220338983,
36,2,car,van,490,943,411,735,453,324,0.9208222,3,0,2,0.7152317880794702,
37,2,car,van,486,941,412,731,455,319,0.9610242,3,0,2,0.701098901098901,
38,2,car,van,487,953,415,761,466,346,0.97434527,3,0,2,0.7424892703862661,
39,2,car,van,486,938,416,730,452,314,0.9374376,3,0,2,0.6946902654867256,
40,2,car,van,491,949,411,769,458,358,0.9677114,3,0,2,0.7816593886462883,
41,2,car,van,485,955,412,768,470,356,0.8783675,3,0,2,0.7574468085106383,
42,2,car,van,485,941,414,730,456,316,0.9736741,3,0,2,0.6929824561403509,
43,2,car,van,485,948,416,761,463,345,0.95564747,3,0,2,0.7451403887688985,
44,2,car,van,485,942,410,739,457,329,0.94875216,3,0,2,0.7199124726477024,
45,2,car,van,487,951,414,764,464,350,0.95158833,3,0,2,0.7543103448275862,
46,2,car,van,489,955,409,769,466,360,0.95695746,3,0,2,0.7725321888412017,
47,2,car,van,496,948,415,764,452,349,0.9718963,3,0,2,0.7721238938053098,
48,2,car,van,488,953,416,761,465,345,0.97468466,3,0,2,0.7419354838709677,
49,2,car,van,483,955,415,763,472,348,0.9583383,3,0,2,0.7372881355932204,
50,2,car,van,488,940,412,737,452,325,0.9648091,3,0,2,0.7190265486725663,
51,2,car,van,484,957,412,766,473,354,0.95933455,3,0,2,0.7484143763213531,
52,2,car,van,488,949,417,759,461,342,0.9826786,3,0,2,0.7418655097613883,
53,2,car,van,482,959,414,763,477,349,0.888824,3,0,2,0.7316561844863732,
54,2,car,van,487,955,420,758,468,338,0.9463203,3,0,2,0.7222222222222222,
55,2,car,van,492,952,410,768,460,358,0.9421822,3,0,2,0.7782608695652173,
56,2,car,van,488,939,416,730,451,314,0.9661252,3,0,2,0.6962305986696231,
57,2,car,van,482,955,419,756,473,337,0.94365954,3,0,2,0.7124735729386892,
58,2,car,van,494,951,409,769,457,360,0.95296556,3,0,2,0.787746170678337,
59,2,car,van,487,960,415,764,473,349,0.9687263,3,0,2,0.7378435517970402,
60,2,car,van,479,962,412,769,483,357,0.95937186,3,0,2,0.7391304347826086,
61,2,car,van,484,935,412,738,451,326,0.9526533,3,0,2,0.7228381374722838,
62,2,car,van,482,944,410,736,462,326,0.97273606,3,0,2,0.7056277056277056,
63,2,car,van,480,940,415,734,460,319,0.96075284,3,0,2,0.6934782608695652,
64,2,car,van,486,953,415,763,467,348,0.95723224,3,0,2,0.7451820128479657,
65,2,car,van,492,948,412,767,456,355,0.9304319,3,0,2,0.7785087719298246,
66,2,car,van,489,956,411,768,467,357,0.906528,3,0,2,0.7644539614561028,
67,2,car,van,484,940,413,733,456,320,0.97553414,3,0,2,0.7017543859649122,
68,2,car,van,488,936,413,735,448,322,0.9737919,3,0,2,0.71875,
69,2,car,van,490,956,413,763,466,350,0.9481417,3,0,2,0.7510729613733905,
70,2,car,van,482,952,419,760,470,341,0.9468499,3,0,2,0.725531914893617,
71,2,car,van,590,944,439,693,354,254,0.9859484,3,0,2,0.7175141242937854,
72,2,car,van,589,949,437,697,360,260,0.98192203,3,0,2,0.7222222222222222,
73,2,car,van,590,946,439,698,356,259,0.96922255,3,0,2,0.7275280898876404,
0,2,car,van,488,937,412,736,449,324,0.95309883,3,0,2,0.7216035634743875,
1,2,car,van,487,960,412,767,473,355,0.96341676,3,0,2,0.7505285412262156,
2,2,car,van,487,935,412,739,448,327,0.94020814,3,0,2,0.7299107142857143,
3,2,car,van,482,955,413,766,473,353,0.9732442,3,0,2,0.7463002114164905,
4,2,car,van,487,955,409,769,468,360,0.96269614,3,0,2,0.7692307692307693,
5,2,car,van,486,936,413,738,450,325,0.96561056,3,0,2,0.7222222222222222,
6,2,car,van,481,957,412,766,476,354,0.92372614,3,0,2,0.7436974789915967,
7,2,car,van,490,953,410,767,463,357,0.9787868,3,0,2,0.7710583153347732,
8,2,car,van,488,937,411,738,449,327,0.9417135,3,0,2,0.7282850779510023,
9,2,car,van,484,958,414,763,474,349,0.97204894,3,0,2,0.7362869198312236,
10,2,car,van,493,951,415,764,458,349,0.96600556,3,0,2,0.7620087336244541,
11,2,car,van,492,954,415,764,462,349,0.97444296,3,0,2,0.7554112554112554,
12,2,car,van,487,942,414,734,455,320,0.9520047,3,0,2,0.7032967032967034,
13,2,car,van,487,938,415,731,451,316,0.96498144,3,0,2,0.7006651884700665,
14,2,car,van,485,952,416,762,467,346,0.96896255,3,0,2,0.7408993576017131,
15,2,car,van,482,958,407,772,476,365,0.9601497,3,0,2,0.7668067226890757,
16,2,car,van,493,952,417,765,459,348,0.98740655,3,0,2,0.7581699346405228,
17,2,car,van,487,938,412,739,451,327,0.944092,3,0,2,0.7250554323725056,
18,2,car,van,486,957,408,773,471,365,0.9602443,3,0,2,0.7749469214437368,
19,2,car,van,488,952,408,769,464,361,0.95232624,3,0,2,0.7780172413793104,
20,2,car,van,490,952,416,763,462,347,0.98539907,3,0,2,0.7510822510822511,
21,2,car,van,484,954,412,769,470,357,0.9619448,3,0,2,0.7595744680851064,
22,2,car,van,485,938,414,732,453,318,0.9526754,3,0,2,0.7019867549668874,
23,2,car,van,484,955,411,765,471,354,0.967853,3,0,2,0.7515923566878981,
24,2,car,van,489,957,420,756,468,336,0.97189754,3,0,2,0.717948717948718,
25,2,car,van,492,952,415,762,460,347,0.97278863,3,0,2,0.7543478260869565,
26,2,car,van,490,956,409,768,466,359,0.9676818,3,0,2,0.7703862660944206,
27,2,car,van,488,938,413,738,450,325,0.94057816,3,0,2,0.7222222222222222,
28,2,car,van,488,957,416,762,469,346,0.97819936,3,0,2,0.7377398720682303,
29,2,car,van,486,954,414,764,468,350,0.9754412,3,0,2,0.7478632478632479,
30,2,car,van,488,936,413,735,448,322,0.9562123,3,0,2,0.71875,
31,2,car,van,486,939,414,735,453,321,0.9730841,3,0,2,0.7086092715231788,
32,2,car,van,489,940,411,737,451,326,0.94711137,3,0,2,0.7228381374722838,
33,2,car,van,488,954,411,769,466,358,0.9352239,3,0,2,0.7682403433476395,
34,2,car,van,487,955,409,768,468,359,0.96377707,3,0,2,0.7670940170940171,
35,2,car,van,483,953,413,767,470,354,0.95913815,3,0,2,0.7531914893617021,
36,2,car,van,483,955,410,769,472,359,0.95927954,3,0,2,0.760593220338983,
37,2,car,van,490,943,411,735,453,324,0.9208222,3,0,2,0.7152317880794702,
38,2,car,van,486,941,412,731,455,319,0.9610242,3,0,2,0.701098901098901,
39,2,car,van,487,953,415,761,466,346,0.97434527,3,0,2,0.7424892703862661,
40,2,car,van,486,938,416,730,452,314,0.9374376,3,0,2,0.6946902654867256,
41,2,car,van,491,949,411,769,458,358,0.9677114,3,0,2,0.7816593886462883,
42,2,car,van,485,955,412,768,470,356,0.8783675,3,0,2,0.7574468085106383,
43,2,car,van,485,941,414,730,456,316,0.9736741,3,0,2,0.6929824561403509,
44,2,car,van,485,948,416,761,463,345,0.95564747,3,0,2,0.7451403887688985,
45,2,car,van,485,942,410,739,457,329,0.94875216,3,0,2,0.7199124726477024,
46,2,car,van,487,951,414,764,464,350,0.95158833,3,0,2,0.7543103448275862,
47,2,car,van,489,955,409,769,466,360,0.95695746,3,0,2,0.7725321888412017,
48,2,car,van,496,948,415,764,452,349,0.9718963,3,0,2,0.7721238938053098,
49,2,car,van,488,953,416,761,465,345,0.97468466,3,0,2,0.7419354838709677,
50,2,car,van,483,955,415,763,472,348,0.9583383,3,0,2,0.7372881355932204,
51,2,car,van,488,940,412,737,452,325,0.9648091,3,0,2,0.7190265486725663,
52,2,car,van,484,957,412,766,473,354,0.95933455,3,0,2,0.7484143763213531,
53,2,car,van,488,949,417,759,461,342,0.9826786,3,0,2,0.7418655097613883,
54,2,car,van,482,959,414,763,477,349,0.888824,3,0,2,0.7316561844863732,
55,2,car,van,487,955,420,758,468,338,0.9463203,3,0,2,0.7222222222222222,
56,2,car,van,492,952,410,768,460,358,0.9421822,3,0,2,0.7782608695652173,
57,2,car,van,488,939,416,730,451,314,0.9661252,3,0,2,0.6962305986696231,
58,2,car,van,482,955,419,756,473,337,0.94365954,3,0,2,0.7124735729386892,
59,2,car,van,494,951,409,769,457,360,0.95296556,3,0,2,0.787746170678337,
60,2,car,van,487,960,415,764,473,349,0.9687263,3,0,2,0.7378435517970402,
61,2,car,van,479,962,412,769,483,357,0.95937186,3,0,2,0.7391304347826086,
62,2,car,van,484,935,412,738,451,326,0.9526533,3,0,2,0.7228381374722838,
63,2,car,van,482,944,410,736,462,326,0.97273606,3,0,2,0.7056277056277056,
64,2,car,van,480,940,415,734,460,319,0.96075284,3,0,2,0.6934782608695652,
65,2,car,van,486,953,415,763,467,348,0.95723224,3,0,2,0.7451820128479657,
66,2,car,van,492,948,412,767,456,355,0.9304319,3,0,2,0.7785087719298246,
67,2,car,van,489,956,411,768,467,357,0.906528,3,0,2,0.7644539614561028,
68,2,car,van,484,940,413,733,456,320,0.97553414,3,0,2,0.7017543859649122,
69,2,car,van,488,936,413,735,448,322,0.9737919,3,0,2,0.71875,
70,2,car,van,490,956,413,763,466,350,0.9481417,3,0,2,0.7510729613733905,
71,2,car,van,482,952,419,760,470,341,0.9468499,3,0,2,0.725531914893617,
72,2,car,van,590,944,439,693,354,254,0.9859484,3,0,2,0.7175141242937854,
73,2,car,van,589,949,437,697,360,260,0.98192203,3,0,2,0.7222222222222222,
74,2,car,van,590,946,439,698,356,259,0.96922255,3,0,2,0.7275280898876404,
0,2,car,van,492,941,413,733,449,320,0.9470818,3,0,2,0.7126948775055679,
1,2,car,van,488,937,412,736,449,324,0.95309883,3,0,2,0.7216035634743875,
2,2,car,van,487,960,412,767,473,355,0.96341676,3,0,2,0.7505285412262156,
3,2,car,van,487,935,412,739,448,327,0.94020814,3,0,2,0.7299107142857143,
4,2,car,van,482,955,413,766,473,353,0.9732442,3,0,2,0.7463002114164905,
5,2,car,van,487,955,409,769,468,360,0.96269614,3,0,2,0.7692307692307693,
6,2,car,van,486,936,413,738,450,325,0.96561056,3,0,2,0.7222222222222222,
7,2,car,van,481,957,412,766,476,354,0.92372614,3,0,2,0.7436974789915967,
8,2,car,van,490,953,410,767,463,357,0.9787868,3,0,2,0.7710583153347732,
9,2,car,van,488,937,411,738,449,327,0.9417135,3,0,2,0.7282850779510023,
10,2,car,van,484,958,414,763,474,349,0.97204894,3,0,2,0.7362869198312236,
11,2,car,van,493,951,415,764,458,349,0.96600556,3,0,2,0.7620087336244541,
12,2,car,van,492,954,415,764,462,349,0.97444296,3,0,2,0.7554112554112554,
13,2,car,van,487,942,414,734,455,320,0.9520047,3,0,2,0.7032967032967034,
14,2,car,van,487,938,415,731,451,316,0.96498144,3,0,2,0.7006651884700665,
15,2,car,van,485,952,416,762,467,346,0.96896255,3,0,2,0.7408993576017131,
16,2,car,van,482,958,407,772,476,365,0.9601497,3,0,2,0.7668067226890757,
17,2,car,van,493,952,417,765,459,348,0.98740655,3,0,2,0.7581699346405228,
18,2,car,van,487,938,412,739,451,327,0.944092,3,0,2,0.7250554323725056,
19,2,car,van,486,957,408,773,471,365,0.9602443,3,0,2,0.7749469214437368,
20,2,car,van,488,952,408,769,464,361,0.95232624,3,0,2,0.7780172413793104,
21,2,car,van,490,952,416,763,462,347,0.98539907,3,0,2,0.7510822510822511,
22,2,car,van,484,954,412,769,470,357,0.9619448,3,0,2,0.7595744680851064,
23,2,car,van,485,938,414,732,453,318,0.9526754,3,0,2,0.7019867549668874,
24,2,car,van,484,955,411,765,471,354,0.967853,3,0,2,0.7515923566878981,
25,2,car,van,489,957,420,756,468,336,0.97189754,3,0,2,0.717948717948718,
26,2,car,van,492,952,415,762,460,347,0.97278863,3,0,2,0.7543478260869565,
27,2,car,van,490,956,409,768,466,359,0.9676818,3,0,2,0.7703862660944206,
28,2,car,van,488,938,413,738,450,325,0.94057816,3,0,2,0.7222222222222222,
29,2,car,van,488,957,416,762,469,346,0.97819936,3,0,2,0.7377398720682303,
30,2,car,van,486,954,414,764,468,350,0.9754412,3,0,2,0.7478632478632479,
31,2,car,van,488,936,413,735,448,322,0.9562123,3,0,2,0.71875,
32,2,car,van,486,939,414,735,453,321,0.9730841,3,0,2,0.7086092715231788,
33,2,car,van,489,940,411,737,451,326,0.94711137,3,0,2,0.7228381374722838,
34,2,car,van,488,954,411,769,466,358,0.9352239,3,0,2,0.7682403433476395,
35,2,car,van,487,955,409,768,468,359,0.96377707,3,0,2,0.7670940170940171,
36,2,car,van,483,953,413,767,470,354,0.95913815,3,0,2,0.7531914893617021,
37,2,car,van,483,955,410,769,472,359,0.95927954,3,0,2,0.760593220338983,
38,2,car,van,490,943,411,735,453,324,0.9208222,3,0,2,0.7152317880794702,
39,2,car,van,486,941,412,731,455,319,0.9610242,3,0,2,0.701098901098901,
40,2,car,van,487,953,415,761,466,346,0.97434527,3,0,2,0.7424892703862661,
41,2,car,van,486,938,416,730,452,314,0.9374376,3,0,2,0.6946902654867256,
42,2,car,van,491,949,411,769,458,358,0.9677114,3,0,2,0.7816593886462883,
43,2,car,van,485,955,412,768,470,356,0.8783675,3,0,2,0.7574468085106383,
44,2,car,van,485,941,414,730,456,316,0.9736741,3,0,2,0.6929824561403509,
45,2,car,van,485,948,416,761,463,345,0.95564747,3,0,2,0.7451403887688985,
46,2,car,van,485,942,410,739,457,329,0.94875216,3,0,2,0.7199124726477024,
47,2,car,van,487,951,414,764,464,350,0.95158833,3,0,2,0.7543103448275862,
48,2,car,van,489,955,409,769,466,360,0.95695746,3,0,2,0.7725321888412017,
49,2,car,van,496,948,415,764,452,349,0.9718963,3,0,2,0.7721238938053098,
50,2,car,van,488,953,416,761,465,345,0.97468466,3,0,2,0.7419354838709677,
51,2,car,van,483,955,415,763,472,348,0.9583383,3,0,2,0.7372881355932204,
52,2,car,van,488,940,412,737,452,325,0.9648091,3,0,2,0.7190265486725663,
53,2,car,van,484,957,412,766,473,354,0.95933455,3,0,2,0.7484143763213531,
54,2,car,van,488,949,417,759,461,342,0.9826786,3,0,2,0.7418655097613883,
55,2,car,van,482,959,414,763,477,349,0.888824,3,0,2,0.7316561844863732,
56,2,car,van,487,955,420,758,468,338,0.9463203,3,0,2,0.7222222222222222,
57,2,car,van,492,952,410,768,460,358,0.9421822,3,0,2,0.7782608695652173,
58,2,car,van,488,939,416,730,451,314,0.9661252,3,0,2,0.6962305986696231,
59,2,car,van,482,955,419,756,473,337,0.94365954,3,0,2,0.7124735729386892,
60,2,car,van,494,951,409,769,457,360,0.95296556,3,0,2,0.787746170678337,
61,2,car,van,487,960,415,764,473,349,0.9687263,3,0,2,0.7378435517970402,
62,2,car,van,479,962,412,769,483,357,0.95937186,3,0,2,0.7391304347826086,
63,2,car,van,484,935,412,738,451,326,0.9526533,3,0,2,0.7228381374722838,
64,2,car,van,482,944,410,736,462,326,0.97273606,3,0,2,0.7056277056277056,
65,2,car,van,480,940,415,734,460,319,0.96075284,3,0,2,0.6934782608695652,
66,2,car,van,486,953,415,763,467,348,0.95723224,3,0,2,0.7451820128479657,
67,2,car,van,492,948,412,767,456,355,0.9304319,3,0,2,0.7785087719298246,
68,2,car,van,489,956,411,768,467,357,0.906528,3,0,2,0.7644539614561028,
69,2,car,van,484,940,413,733,456,320,0.97553414,3,0,2,0.7017543859649122,
70,2,car,van,488,936,413,735,448,322,0.9737919,3,0,2,0.71875,
71,2,car,van,490,956,413,763,466,350,0.9481417,3,0,2,0.7510729613733905,
72,2,car,van,482,952,419,760,470,341,0.9468499,3,0,2,0.725531914893617,
73,2,car,van,590,944,439,693,354,254,0.9859484,3,0,2,0.7175141242937854,
74,2,car,van,589,949,437,697,360,260,0.98192203,3,0,2,0.7222222222222222,
75,2,car,van,590,946,439,698,356,259,0.96922255,3,0,2,0.7275280898876404,
0,2,car,van,484,940,411,739,456,328,0.9726024,3,0,2,0.7192982456140351,
1,2,car,van,492,941,413,733,449,320,0.9470818,3,0,2,0.7126948775055679,
2,2,car,van,488,937,412,736,449,324,0.95309883,3,0,2,0.7216035634743875,
3,2,car,van,487,960,412,767,473,355,0.96341676,3,0,2,0.7505285412262156,
4,2,car,van,487,935,412,739,448,327,0.94020814,3,0,2,0.7299107142857143,
5,2,car,van,482,955,413,766,473,353,0.9732442,3,0,2,0.7463002114164905,
6,2,car,van,487,955,409,769,468,360,0.96269614,3,0,2,0.7692307692307693,
7,2,car,van,486,936,413,738,450,325,0.96561056,3,0,2,0.7222222222222222,
8,2,car,van,481,957,412,766,476,354,0.92372614,3,0,2,0.7436974789915967,
9,2,car,van,490,953,410,767,463,357,0.9787868,3,0,2,0.7710583153347732,
10,2,car,van,488,937,411,738,449,327,0.9417135,3,0,2,0.7282850779510023,
11,2,car,van,484,958,414,763,474,349,0.97204894,3,0,2,0.7362869198312236,
12,2,car,van,493,951,415,764,458,349,0.96600556,3,0,2,0.7620087336244541,
13,2,car,van,492,954,415,764,462,349,0.97444296,3,0,2,0.7554112554112554,
14,2,car,van,487,942,414,734,455,320,0.9520047,3,0,2,0.7032967032967034,
15,2,car,van,487,938,415,731,451,316,0.96498144,3,0,2,0.7006651884700665,
16,2,car,van,485,952,416,762,467,346,0.96896255,3,0,2,0.7408993576017131,
17,2,car,van,482,958,407,772,476,365,0.9601497,3,0,2,0.7668067226890757,
18,2,car,van,493,952,417,765,459,348,0.98740655,3,0,2,0.7581699346405228,
19,2,car,van,487,938,412,739,451,327,0.944092,3,0,2,0.7250554323725056,
20,2,car,van,486,957,408,773,471,365,0.9602443,3,0,2,0.7749469214437368,
21,2,car,van,488,952,408,769,464,361,0.95232624,3,0,2,0.7780172413793104,
22,2,car,van,490,952,416,763,462,347,0.98539907,3,0,2,0.7510822510822511,
23,2,car,van,484,954,412,769,470,357,0.9619448,3,0,2,0.7595744680851064,
24,2,car,van,485,938,414,732,453,318,0.9526754,3,0,2,0.7019867549668874,
25,2,car,van,484,955,411,765,471,354,0.967853,3,0,2,0.7515923566878981,
26,2,car,van,489,957,420,756,468,336,0.97189754,3,0,2,0.717948717948718,
27,2,car,van,492,952,415,762,460,347,0.97278863,3,0,2,0.7543478260869565,
28,2,car,van,490,956,409,768,466,359,0.9676818,3,0,2,0.7703862660944206,
29,2,car,van,488,938,413,738,450,325,0.94057816,3,0,2,0.7222222222222222,
30,2,car,van,488,957,416,762,469,346,0.97819936,3,0,2,0.7377398720682303,
31,2,car,van,486,954,414,764,468,350,0.9754412,3,0,2,0.7478632478632479,
32,2,car,van,488,936,413,735,448,322,0.9562123,3,0,2,0.71875,
33,2,car,van,486,939,414,735,453,321,0.9730841,3,0,2,0.7086092715231788,
34,2,car,van,489,940,411,737,451,326,0.94711137,3,0,2,0.7228381374722838,
35,2,car,van,488,954,411,769,466,358,0.9352239,3,0,2,0.7682403433476395,
36,2,car,van,487,955,409,768,468,359,0.96377707,3,0,2,0.7670940170940171,
37,2,car,van,483,953,413,767,470,354,0.95913815,3,0,2,0.7531914893617021,
38,2,car,van,483,955,410,769,472,359,0.95927954,3,0,2,0.760593220338983,
39,2,car,van,490,943,411,735,453,324,0.9208222,3,0,2,0.7152317880794702,
40,2,car,van,486,941,412,731,455,319,0.9610242,3,0,2,0.701098901098901,
41,2,car,van,487,953,415,761,466,346,0.97434527,3,0,2,0.7424892703862661,
42,2,car,van,486,938,416,730,452,314,0.9374376,3,0,2,0.6946902654867256,
43,2,car,van,491,949,411,769,458,358,0.9677114,3,0,2,0.7816593886462883,
44,2,car,van,485,955,412,768,470,356,0.8783675,3,0,2,0.7574468085106383,
45,2,car,van,485,941,414,730,456,316,0.9736741,3,0,2,0.6929824561403509,
46,2,car,van,485,948,416,761,463,345,0.95564747,3,0,2,0.7451403887688985,
47,2,car,van,485,942,410,739,457,329,0.94875216,3,0,2,0.7199124726477024,
48,2,car,van,487,951,414,764,464,350,0.95158833,3,0,2,0.7543103448275862,
49,2,car,van,489,955,409,769,466,360,0.95695746,3,0,2,0.7725321888412017,
50,2,car,van,496,948,415,764,452,349,0.9718963,3,0,2,0.7721238938053098,
51,2,car,van,488,953,416,761,465,345,0.97468466,3,0,2,0.7419354838709677,
52,2,car,van,483,955,415,763,472,348,0.9583383,3,0,2,0.7372881355932204,
53,2,car,van,488,940,412,737,452,325,0.9648091,3,0,2,0.7190265486725663,
54,2,car,van,484,957,412,766,473,354,0.95933455,3,0,2,0.7484143763213531,
55,2,car,van,488,949,417,759,461,342,0.9826786,3,0,2,0.7418655097613883,
56,2,car,van,482,959,414,763,477,349,0.888824,3,0,2,0.7316561844863732,
57,2,car,van,487,955,420,758,468,338,0.9463203,3,0,2,0.7222222222222222,
58,2,car,van,492,952,410,768,460,358,0.9421822,3,0,2,0.7782608695652173,
59,2,car,van,488,939,416,730,451,314,0.9661252,3,0,2,0.6962305986696231,
60,2,car,van,482,955,419,756,473,337,0.94365954,3,0,2,0.7124735729386892,
61,2,car,van,494,951,409,769,457,360,0.95296556,3,0,2,0.787746170678337,
62,2,car,van,487,960,415,764,473,349,0.9687263,3,0,2,0.7378435517970402,
63,2,car,van,479,962,412,769,483,357,0.95937186,3,0,2,0.7391304347826086,
64,2,car,van,484,935,412,738,451,326,0.9526533,3,0,2,0.7228381374722838,
65,2,car,van,482,944,410,736,462,326,0.97273606,3,0,2,0.7056277056277056,
66,2,car,van,480,940,415,734,460,319,0.96075284,3,0,2,0.6934782608695652,
67,2,car,van,486,953,415,763,467,348,0.95723224,3,0,2,0.7451820128479657,
68,2,car,van,492,948,412,767,456,355,0.9304319,3,0,2,0.7785087719298246,
69,2,car,van,489,956,411,768,467,357,0.906528,3,0,2,0.7644539614561028,
70,2,car,van,484,940,413,733,456,320,0.97553414,3,0,2,0.7017543859649122,
71,2,car,van,488,936,413,735,448,322,0.9737919,3,0,2,0.71875,
72,2,car,van,490,956,413,763,466,350,0.9481417,3,0,2,0.7510729613733905,
73,2,car,van,482,952,419,760,470,341,0.9468499,3,0,2,0.725531914893617,
74,2,car,van,590,944,439,693,354,254,0.9859484,3,0,2,0.7175141242937854,
75,2,car,van,589,949,437,697,360,260,0.98192203,3,0,2,0.7222222222222222,
76,2,car,van,590,946,439,698,356,259,0.96922255,3,0,2,0.7275280898876404,
0,2,car,van,492,951,409,770,459,361,0.97281927,3,0,2,0.7864923747276689,
1,2,car,van,484,940,411,739,456,328,0.9726024,3,0,2,0.7192982456140351,
2,2,car,van,492,941,413,733,449,320,0.9470818,3,0,2,0.7126948775055679,
3,2,car,van,488,937,412,736,449,324,0.95309883,3,0,2,0.7216035634743875,
4,2,car,van,487,960,412,767,473,355,0.96341676,3,0,2,0.7505285412262156,
5,2,car,van,487,935,412,739,448,327,0.94020814,3,0,2,0.7299107142857143,
6,2,car,van,482,955,413,766,473,353,0.9732442,3,0,2,0.7463002114164905,
7,2,car,van,487,955,409,769,468,360,0.96269614,3,0,2,0.7692307692307693,
8,2,car,van,486,936,413,738,450,325,0.96561056,3,0,2,0.7222222222222222,
9,2,car,van,481,957,412,766,476,354,0.92372614,3,0,2,0.7436974789915967,
10,2,car,van,490,953,410,767,463,357,0.9787868,3,0,2,0.7710583153347732,
11,2,car,van,488,937,411,738,449,327,0.9417135,3,0,2,0.7282850779510023,
12,2,car,van,484,958,414,763,474,349,0.97204894,3,0,2,0.7362869198312236,
13,2,car,van,493,951,415,764,458,349,0.96600556,3,0,2,0.7620087336244541,
14,2,car,van,492,954,415,764,462,349,0.97444296,3,0,2,0.7554112554112554,
15,2,car,van,487,942,414,734,455,320,0.9520047,3,0,2,0.7032967032967034,
16,2,car,van,487,938,415,731,451,316,0.96498144,3,0,2,0.7006651884700665,
17,2,car,van,485,952,416,762,467,346,0.96896255,3,0,2,0.7408993576017131,
18,2,car,van,482,958,407,772,476,365,0.9601497,3,0,2,0.7668067226890757,
19,2,car,van,493,952,417,765,459,348,0.98740655,3,0,2,0.7581699346405228,
20,2,car,van,487,938,412,739,451,327,0.944092,3,0,2,0.7250554323725056,
21,2,car,van,486,957,408,773,471,365,0.9602443,3,0,2,0.7749469214437368,
22,2,car,van,488,952,408,769,464,361,0.95232624,3,0,2,0.7780172413793104,
23,2,car,van,490,952,416,763,462,347,0.98539907,3,0,2,0.7510822510822511,
24,2,car,van,484,954,412,769,470,357,0.9619448,3,0,2,0.7595744680851064,
25,2,car,van,485,938,414,732,453,318,0.9526754,3,0,2,0.7019867549668874,
26,2,car,van,484,955,411,765,471,354,0.967853,3,0,2,0.7515923566878981,
27,2,car,van,489,957,420,756,468,336,0.97189754,3,0,2,0.717948717948718,
28,2,car,van,492,952,415,762,460,347,0.97278863,3,0,2,0.7543478260869565,
29,2,car,van,490,956,409,768,466,359,0.9676818,3,0,2,0.7703862660944206,
30,2,car,van,488,938,413,738,450,325,0.94057816,3,0,2,0.7222222222222222,
31,2,car,van,488,957,416,762,469,346,0.97819936,3,0,2,0.7377398720682303,
32,2,car,van,486,954,414,764,468,350,0.9754412,3,0,2,0.7478632478632479,
33,2,car,van,488,936,413,735,448,322,0.9562123,3,0,2,0.71875,
34,2,car,van,486,939,414,735,453,321,0.9730841,3,0,2,0.7086092715231788,
35,2,car,van,489,940,411,737,451,326,0.94711137,3,0,2,0.7228381374722838,
36,2,car,van,488,954,411,769,466,358,0.9352239,3,0,2,0.7682403433476395,
37,2,car,van,487,955,409,768,468,359,0.96377707,3,0,2,0.7670940170940171,
38,2,car,van,483,953,413,767,470,354,0.95913815,3,0,2,0.7531914893617021,
39,2,car,van,483,955,410,769,472,359,0.95927954,3,0,2,0.760593220338983,
40,2,car,van,490,943,411,735,453,324,0.9208222,3,0,2,0.7152317880794702,
41,2,car,van,486,941,412,731,455,319,0.9610242,3,0,2,0.701098901098901,
42,2,car,van,487,953,415,761,466,346,0.97434527,3,0,2,0.7424892703862661,
43,2,car,van,486,938,416,730,452,314,0.9374376,3,0,2,0.6946902654867256,
44,2,car,van,491,949,411,769,458,358,0.9677114,3,0,2,0.7816593886462883,
45,2,car,van,485,955,412,768,470,356,0.8783675,3,0,2,0.7574468085106383,
46,2,car,van,485,941,414,730,456,316,0.9736741,3,0,2,0.6929824561403509,
47,2,car,van,485,948,416,761,463,345,0.95564747,3,0,2,0.7451403887688985,
48,2,car,van,485,942,410,739,457,329,0.94875216,3,0,2,0.7199124726477024,
49,2,car,van,487,951,414,764,464,350,0.95158833,3,0,2,0.7543103448275862,
50,2,car,van,489,955,409,769,466,360,0.95695746,3,0,2,0.7725321888412017,
51,2,car,van,496,948,415,764,452,349,0.9718963,3,0,2,0.7721238938053098,
52,2,car,van,488,953,416,761,465,345,0.97468466,3,0,2,0.7419354838709677,
53,2,car,van,483,955,415,763,472,348,0.9583383,3,0,2,0.7372881355932204,
54,2,car,van,488,940,412,737,452,325,0.9648091,3,0,2,0.7190265486725663,
55,2,car,van,484,957,412,766,473,354,0.95933455,3,0,2,0.7484143763213531,
56,2,car,van,488,949,417,759,461,342,0.9826786,3,0,2,0.7418655097613883,
57,2,car,van,482,959,414,763,477,349,0.888824,3,0,2,0.7316561844863732,
58,2,car,van,487,955,420,758,468,338,0.9463203,3,0,2,0.7222222222222222,
59,2,car,van,492,952,410,768,460,358,0.9421822,3,0,2,0.7782608695652173,
60,2,car,van,488,939,416,730,451,314,0.9661252,3,0,2,0.6962305986696231,
61,2,car,van,482,955,419,756,473,337,0.94365954,3,0,2,0.7124735729386892,
62,2,car,van,494,951,409,769,457,360,0.95296556,3,0,2,0.787746170678337,
63,2,car,van,487,960,415,764,473,349,0.9687263,3,0,2,0.7378435517970402,
64,2,car,van,479,962,412,769,483,357,0.95937186,3,0,2,0.7391304347826086,
65,2,car,van,484,935,412,738,451,326,0.9526533,3,0,2,0.7228381374722838,
66,2,car,van,482,944,410,736,462,326,0.97273606,3,0,2,0.7056277056277056,
67,2,car,van,480,940,415,734,460,319,0.96075284,3,0,2,0.6934782608695652,
68,2,car,van,486,953,415,763,467,348,0.95723224,3,0,2,0.7451820128479657,
69,2,car,van,492,948,412,767,456,355,0.9304319,3,0,2,0.7785087719298246,
70,2,car,van,489,956,411,768,467,357,0.906528,3,0,2,0.7644539614561028,
71,2,car,van,484,940,413,733,456,320,0.97553414,3,0,2,0.7017543859649122,
72,2,car,van,488,936,413,735,448,322,0.9737919,3,0,2,0.71875,
73,2,car,van,490,956,413,763,466,350,0.9481417,3,0,2,0.7510729613733905,
74,2,car,van,482,952,419,760,470,341,0.9468499,3,0,2,0.725531914893617,
75,2,car,van,590,944,439,693,354,254,0.9859484,3,0,2,0.7175141242937854,
76,2,car,van,589,949,437,697,360,260,0.98192203,3,0,2,0.7222222222222222,
77,2,car,van,590,946,439,698,356,259,0.96922255,3,0,2,0.7275280898876404,
0,2,car,van,487,956,414,765,469,351,0.9626456,3,0,2,0.7484008528784648,
1,2,car,van,492,951,409,770,459,361,0.97281927,3,0,2,0.7864923747276689,
2,2,car,van,484,940,411,739,456,328,0.9726024,3,0,2,0.7192982456140351,
3,2,car,van,492,941,413,733,449,320,0.9470818,3,0,2,0.7126948775055679,
4,2,car,van,488,937,412,736,449,324,0.95309883,3,0,2,0.7216035634743875,
5,2,car,van,487,960,412,767,473,355,0.96341676,3,0,2,0.7505285412262156,
6,2,car,van,487,935,412,739,448,327,0.94020814,3,0,2,0.7299107142857143,
7,2,car,van,482,955,413,766,473,353,0.9732442,3,0,2,0.7463002114164905,
8,2,car,van,487,955,409,769,468,360,0.96269614,3,0,2,0.7692307692307693,
9,2,car,van,486,936,413,738,450,325,0.96561056,3,0,2,0.7222222222222222,
10,2,car,van,481,957,412,766,476,354,0.92372614,3,0,2,0.7436974789915967,
11,2,car,van,490,953,410,767,463,357,0.9787868,3,0,2,0.7710583153347732,
12,2,car,van,488,937,411,738,449,327,0.9417135,3,0,2,0.7282850779510023,
13,2,car,van,484,958,414,763,474,349,0.97204894,3,0,2,0.7362869198312236,
14,2,car,van,493,951,415,764,458,349,0.96600556,3,0,2,0.7620087336244541,
15,2,car,van,492,954,415,764,462,349,0.97444296,3,0,2,0.7554112554112554,
16,2,car,van,487,942,414,734,455,320,0.9520047,3,0,2,0.7032967032967034,
17,2,car,van,487,938,415,731,451,316,0.96498144,3,0,2,0.7006651884700665,
18,2,car,van,485,952,416,762,467,346,0.96896255,3,0,2,0.7408993576017131,
19,2,car,van,482,958,407,772,476,365,0.9601497,3,0,2,0.7668067226890757,
20,2,car,van,493,952,417,765,459,348,0.98740655,3,0,2,0.7581699346405228,
21,2,car,van,487,938,412,739,451,327,0.944092,3,0,2,0.7250554323725056,
22,2,car,van,486,957,408,773,471,365,0.9602443,3,0,2,0.7749469214437368,
23,2,car,van,488,952,408,769,464,361,0.95232624,3,0,2,0.7780172413793104,
24,2,car,van,490,952,416,763,462,347,0.98539907,3,0,2,0.7510822510822511,
25,2,car,van,484,954,412,769,470,357,0.9619448,3,0,2,0.7595744680851064,
26,2,car,van,485,938,414,732,453,318,0.9526754,3,0,2,0.7019867549668874,
27,2,car,van,484,955,411,765,471,354,0.967853,3,0,2,0.7515923566878981,
28,2,car,van,489,957,420,756,468,336,0.97189754,3,0,2,0.717948717948718,
29,2,car,van,492,952,415,762,460,347,0.97278863,3,0,2,0.7543478260869565,
30,2,car,van,490,956,409,768,466,359,0.9676818,3,0,2,0.7703862660944206,
31,2,car,van,488,938,413,738,450,325,0.94057816,3,0,2,0.7222222222222222,
32,2,car,van,488,957,416,762,469,346,0.97819936,3,0,2,0.7377398720682303,
33,2,car,van,486,954,414,764,468,350,0.9754412,3,0,2,0.7478632478632479,
34,2,car,van,488,936,413,735,448,322,0.9562123,3,0,2,0.71875,
35,2,car,van,486,939,414,735,453,321,0.9730841,3,0,2,0.7086092715231788,
36,2,car,van,489,940,411,737,451,326,0.94711137,3,0,2,0.7228381374722838,
37,2,car,van,488,954,411,769,466,358,0.9352239,3,0,2,0.7682403433476395,
38,2,car,van,487,955,409,768,468,359,0.96377707,3,0,2,0.7670940170940171,
39,2,car,van,483,953,413,767,470,354,0.95913815,3,0,2,0.7531914893617021,
40,2,car,van,483,955,410,769,472,359,0.95927954,3,0,2,0.760593220338983,
41,2,car,van,490,943,411,735,453,324,0.9208222,3,0,2,0.7152317880794702,
42,2,car,van,486,941,412,731,455,319,0.9610242,3,0,2,0.701098901098901,
43,2,car,van,487,953,415,761,466,346,0.97434527,3,0,2,0.7424892703862661,
44,2,car,van,486,938,416,730,452,314,0.9374376,3,0,2,0.6946902654867256,
45,2,car,van,491,949,411,769,458,358,0.9677114,3,0,2,0.7816593886462883,
46,2,car,van,485,955,412,768,470,356,0.8783675,3,0,2,0.7574468085106383,
47,2,car,van,485,941,414,730,456,316,0.9736741,3,0,2,0.6929824561403509,
48,2,car,van,485,948,416,761,463,345,0.95564747,3,0,2,0.7451403887688985,
49,2,car,van,485,942,410,739,457,329,0.94875216,3,0,2,0.7199124726477024,
50,2,car,van,487,951,414,764,464,350,0.95158833,3,0,2,0.7543103448275862,
51,2,car,van,489,955,409,769,466,360,0.95695746,3,0,2,0.7725321888412017,
52,2,car,van,496,948,415,764,452,349,0.9718963,3,0,2,0.7721238938053098,
53,2,car,van,488,953,416,761,465,345,0.97468466,3,0,2,0.7419354838709677,
54,2,car,van,483,955,415,763,472,348,0.9583383,3,0,2,0.7372881355932204,
55,2,car,van,488,940,412,737,452,325,0.9648091,3,0,2,0.7190265486725663,
56,2,car,van,484,957,412,766,473,354,0.95933455,3,0,2,0.7484143763213531,
57,2,car,van,488,949,417,759,461,342,0.9826786,3,0,2,0.7418655097613883,
58,2,car,van,482,959,414,763,477,349,0.888824,3,0,2,0.7316561844863732,
59,2,car,van,487,955,420,758,468,338,0.9463203,3,0,2,0.7222222222222222,
60,2,car,van,492,952,410,768,460,358,0.9421822,3,0,2,0.7782608695652173,
61,2,car,van,488,939,416,730,451,314,0.9661252,3,0,2,0.6962305986696231,
62,2,car,van,482,955,419,756,473,337,0.94365954,3,0,2,0.7124735729386892,
63,2,car,van,494,951,409,769,457,360,0.95296556,3,0,2,0.787746170678337,
64,2,car,van,487,960,415,764,473,349,0.9687263,3,0,2,0.7378435517970402,
65,2,car,van,479,962,412,769,483,357,0.95937186,3,0,2,0.7391304347826086,
66,2,car,van,484,935,412,738,451,326,0.9526533,3,0,2,0.7228381374722838,
67,2,car,van,482,944,410,736,462,326,0.97273606,3,0,2,0.7056277056277056,
68,2,car,van,480,940,415,734,460,319,0.96075284,3,0,2,0.6934782608695652,
69,2,car,van,486,953,415,763,467,348,0.95723224,3,0,2,0.7451820128479657,
70,2,car,van,492,948,412,767,456,355,0.9304319,3,0,2,0.7785087719298246,
71,2,car,van,489,956,411,768,467,357,0.906528,3,0,2,0.7644539614561028,
72,2,car,van,484,940,413,733,456,320,0.97553414,3,0,2,0.7017543859649122,
73,2,car,van,488,936,413,735,448,322,0.9737919,3,0,2,0.71875,
74,2,car,van,490,956,413,763,466,350,0.9481417,3,0,2,0.7510729613733905,
75,2,car,van,482,952,419,760,470,341,0.9468499,3,0,2,0.725531914893617,
76,2,car,van,590,944,439,693,354,254,0.9859484,3,0,2,0.7175141242937854,
77,2,car,van,589,949,437,697,360,260,0.98192203,3,0,2,0.7222222222222222,
78,2,car,van,590,946,439,698,356,259,0.96922255,3,0,2,0.7275280898876404,
