,cid,label,vehicle,left,right,top,bottom,width,height,score,distance_estimate,angle_estimate,real_distance,ratio,elapsed_time
0,2,car,van,493,951,415,764,458,349,0.96600556,3,0,2,0.7620087336244541,
0,2,car,van,488,937,411,738,449,327,0.9417135,3,0,2,0.7282850779510023,
1,2,car,van,493,951,415,764,458,349,0.96600556,3,0,2,0.7620087336244541,
0,2,car,van,481,957,412,766,476,354,0.92372614,3,0,2,0.7436974789915967,
1,2,car,van,488,937,411,738,449,327,0.9417135,3,0,2,0.7282850779510023,
2,2,car,van,493,951,415,764,458,349,0.96600556,3,0,2,0.7620087336244541,
0,2,car,van,253,746,435,749,493,314,0.9651378,3,0,2,0.6369168356997972,
1,2,car,van,481,957,412,766,476,354,0.92372614,3,0,2,0.7436974789915967,
2,2,car,van,488,937,411,738,449,327,0.9417135,3,0,2,0.7282850779510023,
3,2,car,van,493,951,415,764,458,349,0.96600556,3,0,2,0.7620087336244541,
0,2,car,van,249,754,431,751,505,320,0.9686244,3,0,2,0.6336633663366337,
1,2,car,van,253,746,435,749,493,314,0.9651378,3,0,2,0.6369168356997972,
2,2,car,van,481,957,412,766,476,354,0.92372614,3,0,2,0.7436974789915967,
3,2,car,van,488,937,411,738,449,327,0.9417135,3,0,2,0.7282850779510023,
4,2,car,van,493,951,415,764,458,349,0.96600556,3,0,2,0.7620087336244541,
0,2,car,van,250,748,435,744,498,309,0.99397635,3,0,2,0.6204819277108434,
1,2,car,van,249,754,431,751,505,320,0.9686244,3,0,2,0.6336633663366337,
2,2,car,van,253,746,435,749,493,314,0.9651378,3,0,2,0.6369168356997972,
3,2,car,van,481,957,412,766,476,354,0.92372614,3,0,2,0.7436974789915967,
4,2,car,van,488,937,411,738,449,327,0.9417135,3,0,2,0.7282850779510023,
5,2,car,van,493,951,415,764,458,349,0.96600556,3,0,2,0.7620087336244541,
0,2,car,van,241,755,435,746,514,311,0.95389324,3,30,2,0.6050583657587548,
1,2,car,van,250,748,435,744,498,309,0.99397635,3,0,2,0.6204819277108434,
2,2,car,van,249,754,431,751,505,320,0.9686244,3,0,2,0.6336633663366337,
3,2,car,van,253,746,435,749,493,314,0.9651378,3,0,2,0.6369168356997972,
4,2,car,van,481,957,412,766,476,354,0.92372614,3,0,2,0.7436974789915967,
5,2,car,van,488,937,411,738,449,327,0.9417135,3,0,2,0.7282850779510023,
6,2,car,van,493,951,415,764,458,349,0.96600556,3,0,2,0.7620087336244541,
0,2,car,van,247,752,432,754,505,322,0.9881196,3,0,2,0.6376237623762376,
1,2,car,van,241,755,435,746,514,311,0.95389324,3,30,2,0.6050583657587548,
2,2,car,van,250,748,435,744,498,309,0.99397635,3,0,2,0.6204819277108434,
3,2,car,van,249,754,431,751,505,320,0.9686244,3,0,2,0.6336633663366337,
4,2,car,van,253,746,435,749,493,314,0.9651378,3,0,2,0.6369168356997972,
5,2,car,van,481,957,412,766,476,354,0.92372614,3,0,2,0.7436974789915967,
6,2,car,van,488,937,411,738,449,327,0.9417135,3,0,2,0.7282850779510023,
7,2,car,van,493,951,415,764,458,349,0.96600556,3,0,2,0.7620087336244541,
0,2,car,van,245,754,432,751,509,319,0.9489522,3,0,2,0.6267190569744597,
1,2,car,van,247,752,432,754,505,322,0.9881196,3,0,2,0.6376237623762376,
2,2,car,van,241,755,435,746,514,311,0.95389324,3,30,2,0.6050583657587548,
3,2,car,van,250,748,435,744,498,309,0.99397635,3,0,2,0.6204819277108434,
4,2,car,van,249,754,431,751,505,320,0.9686244,3,0,2,0.6336633663366337,
5,2,car,van,253,746,435,749,493,314,0.9651378,3,0,2,0.6369168356997972,
6,2,car,van,481,957,412,766,476,354,0.92372614,3,0,2,0.7436974789915967,
7,2,car,van,488,937,411,738,449,327,0.9417135,3,0,2,0.7282850779510023,
8,2,car,van,493,951,415,764,458,349,0.96600556,3,0,2,0.7620087336244541,
0,2,car,van,247,759,432,746,512,314,0.9786135,3,0,2,0.61328125,
1,2,car,van,245,754,432,751,509,319,0.9489522,3,0,2,0.6267190569744597,
2,2,car,van,247,752,432,754,505,322,0.9881196,3,0,2,0.6376237623762376,
3,2,car,van,241,755,435,746,514,311,0.95389324,3,30,2,0.6050583657587548,
4,2,car,van,250,748,435,744,498,309,0.99397635,3,0,2,0.6204819277108434,
5,2,car,van,249,754,431,751,505,320,0.9686244,3,0,2,0.6336633663366337,
6,2,car,van,253,746,435,749,493,314,0.9651378,3,0,2,0.6369168356997972,
7,2,car,van,481,957,412,766,476,354,0.92372614,3,0,2,0.7436974789915967,
8,2,car,van,488,937,411,738,449,327,0.9417135,3,0,2,0.7282850779510023,
9,2,car,van,493,951,415,764,458,349,0.96600556,3,0,2,0.7620087336244541,
0,2,car,van,247,751,432,750,504,318,0.98905355,3,0,2,0.6309523809523809,
1,2,car,van,247,759,432,746,512,314,0.9786135,3,0,2,0.61328125,
2,2,car,van,245,754,432,751,509,319,0.9489522,3,0,2,0.6267190569744597,
3,2,car,van,247,752,432,754,505,322,0.9881196,3,0,2,0.6376237623762376,
4,2,car,van,241,755,435,746,514,311,0.95389324,3,30,2,0.6050583657587548,
5,2,car,van,250,748,435,744,498,309,0.99397635,3,0,2,0.6204819277108434,
6,2,car,van,249,754,431,751,505,320,0.9686244,3,0,2,0.6336633663366337,
7,2,car,van,253,746,435,749,493,314,0.9651378,3,0,2,0.6369168356997972,
8,2,car,van,481,957,412,766,476,354,0.92372614,3,0,2,0.7436974789915967,
9,2,car,van,488,937,411,738,449,327,0.9417135,3,0,2,0.7282850779510023,
10,2,car,van,493,951,415,764,458,349,0.96600556,3,0,2,0.7620087336244541,
0,2,car,van,242,759,432,752,517,320,0.97504705,3,0,2,0.6189555125725339,
1,2,car,van,247,751,432,750,504,318,0.98905355,3,0,2,0.6309523809523809,
2,2,car,van,247,759,432,746,512,314,0.9786135,3,0,2,0.61328125,
3,2,car,van,245,754,432,751,509,319,0.9489522,3,0,2,0.6267190569744597,
4,2,car,van,247,752,432,754,505,322,0.9881196,3,0,2,0.6376237623762376,
5,2,car,van,241,755,435,746,514,311,0.95389324,3,30,2,0.6050583657587548,
6,2,car,van,250,748,435,744,498,309,0.99397635,3,0,2,0.6204819277108434,
7,2,car,van,249,754,431,751,505,320,0.9686244,3,0,2,0.6336633663366337,
8,2,car,van,253,746,435,749,493,314,0.9651378,3,0,2,0.6369168356997972,
9,2,car,van,481,957,412,766,476,354,0.92372614,3,0,2,0.7436974789915967,
10,2,car,van,488,937,411,738,449,327,0.9417135,3,0,2,0.7282850779510023,
11,2,car,van,493,951,415,764,458,349,0.96600556,3,0,2,0.7620087336244541,
0,2,car,van,245,752,436,751,507,315,0.9661207,3,0,2,0.621301775147929,
1,2,car,van,242,759,432,752,517,320,0.97504705,3,0,2,0.6189555125725339,
2,2,car,van,247,751,432,750,504,318,0.98905355,3,0,2,0.6309523809523809,
3,2,car,van,247,759,432,746,512,314,0.9786135,3,0,2,0.61328125,
4,2,car,van,245,754,432,751,509,319,0.9489522,3,0,2,0.6267190569744597,
5,2,car,van,247,752,432,754,505,322,0.9881196,3,0,2,0.6376237623762376,
6,2,car,van,241,755,435,746,514,311,0.95389324,3,30,2,0.6050583657587548,
7,2,car,van,250,748,435,744,498,309,0.99397635,3,0,2,0.6204819277108434,
8,2,car,van,249,754,431,751,505,320,0.9686244,3,0,2,0.6336633663366337,
9,2,car,van,253,746,435,749,493,314,0.9651378,3,0,2,0.6369168356997972,
10,2,car,van,481,957,412,766,476,354,0.92372614,3,0,2,0.7436974789915967,
11,2,car,van,488,937,411,738,449,327,0.9417135,3,0,2,0.7282850779510023,
12,2,car,van,493,951,415,764,458,349,0.96600556,3,0,2,0.7620087336244541,
0,2,car,van,248,753,435,751,505,316,0.9665193,3,0,2,0.6257425742574257,
1,2,car,van,245,752,436,751,507,315,0.9661207,3,0,2,0.621301775147929,
2,2,car,van,242,759,432,752,517,320,0.97504705,3,0,2,0.6189555125725339,
3,2,car,van,247,751,432,750,504,318,0.98905355,3,0,2,0.6309523809523809,
4,2,car,van,247,759,432,746,512,314,0.9786135,3,0,2,0.61328125,
5,2,car,van,245,754,432,751,509,319,0.9489522,3,0,2,0.6267190569744597,
6,2,car,van,247,752,432,754,505,322,0.9881196,3,0,2,0.6376237623762376,
7,2,car,van,241,755,435,746,514,311,0.95389324,3,30,2,0.6050583657587548,
8,2,car,van,250,748,435,744,498,309,0.99397635,3,0,2,0.6204819277108434,
9,2,car,van,249,754,431,751,505,320,0.9686244,3,0,2,0.6336633663366337,
10,2,car,van,253,746,435,749,493,314,0.9651378,3,0,2,0.6369168356997972,
11,2,car,van,481,957,412,766,476,354,0.92372614,3,0,2,0.7436974789915967,
12,2,car,van,488,937,411,738,449,327,0.9417135,3,0,2,0.7282850779510023,
13,2,car,van,493,951,415,764,458,349,0.96600556,3,0,2,0.7620087336244541,
0,2,car,van,242,750,437,749,508,312,0.9798773,3,0,2,0.6141732283464567,
1,2,car,van,248,753,435,751,505,316,0.9665193,3,0,2,0.6257425742574257,
2,2,car,van,245,752,436,751,507,315,0.9661207,3,0,2,0.621301775147929,
3,2,car,van,242,759,432,752,517,320,0.97504705,3,0,2,0.6189555125725339,
4,2,car,van,247,751,432,750,504,318,0.98905355,3,0,2,0.6309523809523809,
5,2,car,van,247,759,432,746,512,314,0.9786135,3,0,2,0.61328125,
6,2,car,van,245,754,432,751,509,319,0.9489522,3,0,2,0.6267190569744597,
7,2,car,van,247,752,432,754,505,322,0.9881196,3,0,2,0.6376237623762376,
8,2,car,van,241,755,435,746,514,311,0.95389324,3,30,2,0.6050583657587548,
9,2,car,van,250,748,435,744,498,309,0.99397635,3,0,2,0.6204819277108434,
10,2,car,van,249,754,431,751,505,320,0.9686244,3,0,2,0.6336633663366337,
11,2,car,van,253,746,435,749,493,314,0.9651378,3,0,2,0.6369168356997972,
12,2,car,van,481,957,412,766,476,354,0.92372614,3,0,2,0.7436974789915967,
13,2,car,van,488,937,411,738,449,327,0.9417135,3,0,2,0.7282850779510023,
14,2,car,van,493,951,415,764,458,349,0.96600556,3,0,2,0.7620087336244541,
0,2,car,van,250,751,434,746,501,312,0.98451245,3,0,2,0.6227544910179641,
1,2,car,van,242,750,437,749,508,312,0.9798773,3,0,2,0.6141732283464567,
2,2,car,van,248,753,435,751,505,316,0.9665193,3,0,2,0.6257425742574257,
3,2,car,van,245,752,436,751,507,315,0.9661207,3,0,2,0.621301775147929,
4,2,car,van,242,759,432,752,517,320,0.97504705,3,0,2,0.6189555125725339,
5,2,car,van,247,751,432,750,504,318,0.98905355,3,0,2,0.6309523809523809,
6,2,car,van,247,759,432,746,512,314,0.9786135,3,0,2,0.61328125,
7,2,car,van,245,754,432,751,509,319,0.9489522,3,0,2,0.6267190569744597,
8,2,car,van,247,752,432,754,505,322,0.9881196,3,0,2,0.6376237623762376,
9,2,car,van,241,755,435,746,514,311,0.95389324,3,30,2,0.6050583657587548,
10,2,car,van,250,748,435,744,498,309,0.99397635,3,0,2,0.6204819277108434,
11,2,car,van,249,754,431,751,505,320,0.9686244,3,0,2,0.6336633663366337,
12,2,car,van,253,746,435,749,493,314,0.9651378,3,0,2,0.6369168356997972,
13,2,car,van,481,957,412,766,476,354,0.92372614,3,0,2,0.7436974789915967,
14,2,car,van,488,937,411,738,449,327,0.9417135,3,0,2,0.7282850779510023,
15,2,car,van,493,951,415,764,458,349,0.96600556,3,0,2,0.7620087336244541,
0,2,car,van,248,754,435,750,506,315,0.9802954,3,0,2,0.6225296442687747,
1,2,car,van,250,751,434,746,501,312,0.98451245,3,0,2,0.6227544910179641,
2,2,car,van,242,750,437,749,508,312,0.9798773,3,0,2,0.6141732283464567,
3,2,car,van,248,753,435,751,505,316,0.9665193,3,0,2,0.6257425742574257,
4,2,car,van,245,752,436,751,507,315,0.9661207,3,0,2,0.621301775147929,
5,2,car,van,242,759,432,752,517,320,0.97504705,3,0,2,0.6189555125725339,
6,2,car,van,247,751,432,750,504,318,0.98905355,3,0,2,0.6309523809523809,
7,2,car,van,247,759,432,746,512,314,0.9786135,3,0,2,0.61328125,
8,2,car,van,245,754,432,751,509,319,0.9489522,3,0,2,0.6267190569744597,
9,2,car,van,247,752,432,754,505,322,0.9881196,3,0,2,0.6376237623762376,
10,2,car,van,241,755,435,746,514,311,0.95389324,3,30,2,0.6050583657587548,
11,2,car,van,250,748,435,744,498,309,0.99397635,3,0,2,0.6204819277108434,
12,2,car,van,249,754,431,751,505,320,0.9686244,3,0,2,0.6336633663366337,
13,2,car,van,253,746,435,749,493,314,0.9651378,3,0,2,0.6369168356997972,
14,2,car,van,481,957,412,766,476,354,0.92372614,3,0,2,0.7436974789915967,
15,2,car,van,488,937,411,738,449,327,0.9417135,3,0,2,0.7282850779510023,
16,2,car,van,493,951,415,764,458,349,0.96600556,3,0,2,0.7620087336244541,
0,2,car,van,244,753,436,748,509,312,0.9376707,3,0,2,0.6129666011787819,
1,2,car,van,248,754,435,750,506,315,0.9802954,3,0,2,0.6225296442687747,
2,2,car,van,250,751,434,746,501,312,0.98451245,3,0,2,0.6227544910179641,
3,2,car,van,242,750,437,749,508,312,0.9798773,3,0,2,0.6141732283464567,
4,2,car,van,248,753,435,751,505,316,0.9665193,3,0,2,0.6257425742574257,
5,2,car,van,245,752,436,751,507,315,0.9661207,3,0,2,0.621301775147929,
6,2,car,van,242,759,432,752,517,320,0.97504705,3,0,2,0.6189555125725339,
7,2,car,van,247,751,432,750,504,318,0.98905355,3,0,2,0.6309523809523809,
8,2,car,van,247,759,432,746,512,314,0.9786135,3,0,2,0.61328125,
9,2,car,van,245,754,432,751,509,319,0.9489522,3,0,2,0.6267190569744597,
10,2,car,van,247,752,432,754,505,322,0.9881196,3,0,2,0.6376237623762376,
11,2,car,van,241,755,435,746,514,311,0.95389324,3,30,2,0.6050583657587548,
12,2,car,van,250,748,435,744,498,309,0.99397635,3,0,2,0.6204819277108434,
13,2,car,van,249,754,431,751,505,320,0.9686244,3,0,2,0.6336633663366337,
14,2,car,van,253,746,435,749,493,314,0.9651378,3,0,2,0.6369168356997972,
15,2,car,van,481,957,412,766,476,354,0.92372614,3,0,2,0.7436974789915967,
16,2,car,van,488,937,411,738,449,327,0.9417135,3,0,2,0.7282850779510023,
17,2,car,van,493,951,415,764,458,349,0.96600556,3,0,2,0.7620087336244541,
0,2,car,van,252,750,432,753,498,321,0.9831583,3,0,2,0.6445783132530121,
1,2,car,van,244,753,436,748,509,312,0.9376707,3,0,2,0.6129666011787819,
2,2,car,van,248,754,435,750,506,315,0.9802954,3,0,2,0.6225296442687747,
3,2,car,van,250,751,434,746,501,312,0.98451245,3,0,2,0.6227544910179641,
4,2,car,van,242,750,437,749,508,312,0.9798773,3,0,2,0.6141732283464567,
5,2,car,van,248,753,435,751,505,316,0.9665193,3,0,2,0.6257425742574257,
6,2,car,van,245,752,436,751,507,315,0.9661207,3,0,2,0.621301775147929,
7,2,car,van,242,759,432,752,517,320,0.97504705,3,0,2,0.6189555125725339,
8,2,car,van,247,751,432,750,504,318,0.98905355,3,0,2,0.6309523809523809,
9,2,car,van,247,759,432,746,512,314,0.9786135,3,0,2,0.61328125,
10,2,car,van,245,754,432,751,509,319,0.9489522,3,0,2,0.6267190569744597,
11,2,car,van,247,752,432,754,505,322,0.9881196,3,0,2,0.6376237623762376,
12,2,car,van,241,755,435,746,514,311,0.95389324,3,30,2,0.6050583657587548,
13,2,car,van,250,748,435,744,498,309,0.99397635,3,0,2,0.6204819277108434,
14,2,car,van,249,754,431,751,505,320,0.9686244,3,0,2,0.6336633663366337,
15,2,car,van,253,746,435,749,493,314,0.9651378,3,0,2,0.6369168356997972,
16,2,car,van,481,957,412,766,476,354,0.92372614,3,0,2,0.7436974789915967,
17,2,car,van,488,937,411,738,449,327,0.9417135,3,0,2,0.7282850779510023,
18,2,car,van,493,951,415,764,458,349,0.96600556,3,0,2,0.7620087336244541,
0,2,car,van,249,751,437,744,502,307,0.98877203,3,0,2,0.6115537848605578,
1,2,car,van,252,750,432,753,498,321,0.9831583,3,0,2,0.6445783132530121,
2,2,car,van,244,753,436,748,509,312,0.9376707,3,0,2,0.6129666011787819,
3,2,car,van,248,754,435,750,506,315,0.9802954,3,0,2,0.6225296442687747,
4,2,car,van,250,751,434,746,501,312,0.98451245,3,0,2,0.6227544910179641,
5,2,car,van,242,750,437,749,508,312,0.9798773,3,0,2,0.6141732283464567,
6,2,car,van,248,753,435,751,505,316,0.9665193,3,0,2,0.6257425742574257,
7,2,car,van,245,752,436,751,507,315,0.9661207,3,0,2,0.621301775147929,
8,2,car,van,242,759,432,752,517,320,0.97504705,3,0,2,0.6189555125725339,
9,2,car,van,247,751,432,750,504,318,0.98905355,3,0,2,0.6309523809523809,
10,2,car,van,247,759,432,746,512,314,0.9786135,3,0,2,0.61328125,
11,2,car,van,245,754,432,751,509,319,0.9489522,3,0,2,0.6267190569744597,
12,2,car,van,247,752,432,754,505,322,0.9881196,3,0,2,0.6376237623762376,
13,2,car,van,241,755,435,746,514,311,0.95389324,3,30,2,0.6050583657587548,
14,2,car,van,250,748,435,744,498,309,0.99397635,3,0,2,0.6204819277108434,
15,2,car,van,249,754,431,751,505,320,0.9686244,3,0,2,0.6336633663366337,
16,2,car,van,253,746,435,749,493,314,0.9651378,3,0,2,0.6369168356997972,
17,2,car,van,481,957,412,766,476,354,0.92372614,3,0,2,0.7436974789915967,
18,2,car,van,488,937,411,738,449,327,0.9417135,3,0,2,0.7282850779510023,
19,2,car,van,493,951,415,764,458,349,0.96600556,3,0,2,0.7620087336244541,
0,2,car,van,252,747,435,746,495,311,0.9611737,3,0,2,0.6282828282828283,
1,2,car,van,249,751,437,744,502,307,0.98877203,3,0,2,0.6115537848605578,
2,2,car,van,252,750,432,753,498,321,0.9831583,3,0,2,0.6445783132530121,
3,2,car,van,244,753,436,748,509,312,0.9376707,3,0,2,0.6129666011787819,
4,2,car,van,248,754,435,750,506,315,0.9802954,3,0,2,0.6225296442687747,
5,2,car,van,250,751,434,746,501,312,0.98451245,3,0,2,0.6227544910179641,
6,2,car,van,242,750,437,749,508,312,0.9798773,3,0,2,0.6141732283464567,
7,2,car,van,248,753,435,751,505,316,0.9665193,3,0,2,0.6257425742574257,
8,2,car,van,245,752,436,751,507,315,0.9661207,3,0,2,0.621301775147929,
9,2,car,van,242,759,432,752,517,320,0.97504705,3,0,2,0.6189555125725339,
10,2,car,van,247,751,432,750,504,318,0.98905355,3,0,2,0.6309523809523809,
11,2,car,van,247,759,432,746,512,314,0.9786135,3,0,2,0.61328125,
12,2,car,van,245,754,432,751,509,319,0.9489522,3,0,2,0.6267190569744597,
13,2,car,van,247,752,432,754,505,322,0.9881196,3,0,2,0.6376237623762376,
14,2,car,van,241,755,435,746,514,311,0.95389324,3,30,2,0.6050583657587548,
15,2,car,van,250,748,435,744,498,309,0.99397635,3,0,2,0.6204819277108434,
16,2,car,van,249,754,431,751,505,320,0.9686244,3,0,2,0.6336633663366337,
17,2,car,van,253,746,435,749,493,314,0.9651378,3,0,2,0.6369168356997972,
18,2,car,van,481,957,412,766,476,354,0.92372614,3,0,2,0.7436974789915967,
19,2,car,van,488,937,411,738,449,327,0.9417135,3,0,2,0.7282850779510023,
20,2,car,van,493,951,415,764,458,349,0.96600556,3,0,2,0.7620087336244541,
0,2,car,van,245,758,436,745,513,309,0.9737028,3,30,2,0.6023391812865497,
1,2,car,van,252,747,435,746,495,311,0.9611737,3,0,2,0.6282828282828283,
2,2,car,van,249,751,437,744,502,307,0.98877203,3,0,2,0.6115537848605578,
3,2,car,van,252,750,432,753,498,321,0.9831583,3,0,2,0.6445783132530121,
4,2,car,van,244,753,436,748,509,312,0.9376707,3,0,2,0.6129666011787819,
5,2,car,van,248,754,435,750,506,315,0.9802954,3,0,2,0.6225296442687747,
6,2,car,van,250,751,434,746,501,312,0.98451245,3,0,2,0.6227544910179641,
7,2,car,van,242,750,437,749,508,312,0.9798773,3,0,2,0.6141732283464567,
8,2,car,van,248,753,435,751,505,316,0.9665193,3,0,2,0.6257425742574257,
9,2,car,van,245,752,436,751,507,315,0.9661207,3,0,2,0.621301775147929,
10,2,car,van,242,759,432,752,517,320,0.97504705,3,0,2,0.6189555125725339,
11,2,car,van,247,751,432,750,504,318,0.98905355,3,0,2,0.6309523809523809,
12,2,car,van,247,759,432,746,512,314,0.9786135,3,0,2,0.61328125,
13,2,car,van,245,754,432,751,509,319,0.9489522,3,0,2,0.6267190569744597,
14,2,car,van,247,752,432,754,505,322,0.9881196,3,0,2,0.6376237623762376,
15,2,car,van,241,755,435,746,514,311,0.95389324,3,30,2,0.6050583657587548,
16,2,car,van,250,748,435,744,498,309,0.99397635,3,0,2,0.6204819277108434,
17,2,car,van,249,754,431,751,505,320,0.9686244,3,0,2,0.6336633663366337,
18,2,car,van,253,746,435,749,493,314,0.9651378,3,0,2,0.6369168356997972,
19,2,car,van,481,957,412,766,476,354,0.92372614,3,0,2,0.7436974789915967,
20,2,car,van,488,937,411,738,449,327,0.9417135,3,0,2,0.7282850779510023,
21,2,car,van,493,951,415,764,458,349,0.96600556,3,0,2,0.7620087336244541,
0,2,car,van,252,756,430,755,504,325,0.9911878,3,0,2,0.6448412698412699,
1,2,car,van,245,758,436,745,513,309,0.9737028,3,30,2,0.6023391812865497,
2,2,car,van,252,747,435,746,495,311,0.9611737,3,0,2,0.6282828282828283,
3,2,car,van,249,751,437,744,502,307,0.98877203,3,0,2,0.6115537848605578,
4,2,car,van,252,750,432,753,498,321,0.9831583,3,0,2,0.6445783132530121,
5,2,car,van,244,753,436,748,509,312,0.9376707,3,0,2,0.6129666011787819,
6,2,car,van,248,754,435,750,506,315,0.9802954,3,0,2,0.6225296442687747,
7,2,car,van,250,751,434,746,501,312,0.98451245,3,0,2,0.6227544910179641,
8,2,car,van,242,750,437,749,508,312,0.9798773,3,0,2,0.6141732283464567,
9,2,car,van,248,753,435,751,505,316,0.9665193,3,0,2,0.6257425742574257,
10,2,car,van,245,752,436,751,507,315,0.9661207,3,0,2,0.621301775147929,
11,2,car,van,242,759,432,752,517,320,0.97504705,3,0,2,0.6189555125725339,
12,2,car,van,247,751,432,750,504,318,0.98905355,3,0,2,0.6309523809523809,
13,2,car,van,247,759,432,746,512,314,0.9786135,3,0,2,0.61328125,
14,2,car,van,245,754,432,751,509,319,0.9489522,3,0,2,0.6267190569744597,
15,2,car,van,247,752,432,754,505,322,0.9881196,3,0,2,0.6376237623762376,
16,2,car,van,241,755,435,746,514,311,0.95389324,3,30,2,0.6050583657587548,
17,2,car,van,250,748,435,744,498,309,0.99397635,3,0,2,0.6204819277108434,
18,2,car,van,249,754,431,751,505,320,0.9686244,3,0,2,0.6336633663366337,
19,2,car,van,253,746,435,749,493,314,0.9651378,3,0,2,0.6369168356997972,
20,2,car,van,481,957,412,766,476,354,0.92372614,3,0,2,0.7436974789915967,
21,2,car,van,488,937,411,738,449,327,0.9417135,3,0,2,0.7282850779510023,
22,2,car,van,493,951,415,764,458,349,0.96600556,3,0,2,0.7620087336244541,
0,2,car,van,248,756,432,750,508,318,0.97406626,3,0,2,0.6259842519685039,
1,2,car,van,252,756,430,755,504,325,0.9911878,3,0,2,0.6448412698412699,
2,2,car,van,245,758,436,745,513,309,0.9737028,3,30,2,0.6023391812865497,
3,2,car,van,252,747,435,746,495,311,0.9611737,3,0,2,0.6282828282828283,
4,2,car,van,249,751,437,744,502,307,0.98877203,3,0,2,0.6115537848605578,
5,2,car,van,252,750,432,753,498,321,0.9831583,3,0,2,0.6445783132530121,
6,2,car,van,244,753,436,748,509,312,0.9376707,3,0,2,0.6129666011787819,
7,2,car,van,248,754,435,750,506,315,0.9802954,3,0,2,0.6225296442687747,
8,2,car,van,250,751,434,746,501,312,0.98451245,3,0,2,0.6227544910179641,
9,2,car,van,242,750,437,749,508,312,0.9798773,3,0,2,0.6141732283464567,
10,2,car,van,248,753,435,751,505,316,0.9665193,3,0,2,0.6257425742574257,
11,2,car,van,245,752,436,751,507,315,0.9661207,3,0,2,0.621301775147929,
12,2,car,van,242,759,432,752,517,320,0.97504705,3,0,2,0.6189555125725339,
13,2,car,van,247,751,432,750,504,318,0.98905355,3,0,2,0.6309523809523809,
14,2,car,van,247,759,432,746,512,314,0.9786135,3,0,2,0.61328125,
15,2,car,van,245,754,432,751,509,319,0.9489522,3,0,2,0.6267190569744597,
16,2,car,van,247,752,432,754,505,322,0.9881196,3,0,2,0.6376237623762376,
17,2,car,van,241,755,435,746,514,311,0.95389324,3,30,2,0.6050583657587548,
18,2,car,van,250,748,435,744,498,309,0.99397635,3,0,2,0.6204819277108434,
19,2,car,van,249,754,431,751,505,320,0.9686244,3,0,2,0.6336633663366337,
20,2,car,van,253,746,435,749,493,314,0.9651378,3,0,2,0.6369168356997972,
21,2,car,van,481,957,412,766,476,354,0.92372614,3,0,2,0.7436974789915967,
22,2,car,van,488,937,411,738,449,327,0.9417135,3,0,2,0.7282850779510023,
23,2,car,van,493,951,415,764,458,349,0.96600556,3,0,2,0.7620087336244541,
0,2,car,van,249,752,435,745,503,310,0.96325326,3,0,2,0.6163021868787276,
1,2,car,van,248,756,432,750,508,318,0.97406626,3,0,2,0.6259842519685039,
2,2,car,van,252,756,430,755,504,325,0.9911878,3,0,2,0.6448412698412699,
3,2,car,van,245,758,436,745,513,309,0.9737028,3,30,2,0.6023391812865497,
4,2,car,van,252,747,435,746,495,311,0.9611737,3,0,2,0.6282828282828283,
5,2,car,van,249,751,437,744,502,307,0.98877203,3,0,2,0.6115537848605578,
6,2,car,van,252,750,432,753,498,321,0.9831583,3,0,2,0.6445783132530121,
7,2,car,van,244,753,436,748,509,312,0.9376707,3,0,2,0.6129666011787819,
8,2,car,van,248,754,435,750,506,315,0.9802954,3,0,2,0.6225296442687747,
9,2,car,van,250,751,434,746,501,312,0.98451245,3,0,2,0.6227544910179641,
10,2,car,van,242,750,437,749,508,312,0.9798773,3,0,2,0.6141732283464567,
11,2,car,van,248,753,435,751,505,316,0.9665193,3,0,2,0.6257425742574257,
12,2,car,van,245,752,436,751,507,315,0.9661207,3,0,2,0.621301775147929,
13,2,car,van,242,759,432,752,517,320,0.97504705,3,0,2,0.6189555125725339,
14,2,car,van,247,751,432,750,504,318,0.98905355,3,0,2,0.6309523809523809,
15,2,car,van,247,759,432,746,512,314,0.9786135,3,0,2,0.61328125,
16,2,car,van,245,754,432,751,509,319,0.9489522,3,0,2,0.6267190569744597,
17,2,car,van,247,752,432,754,505,322,0.9881196,3,0,2,0.6376237623762376,
18,2,car,van,241,755,435,746,514,311,0.95389324,3,30,2,0.6050583657587548,
19,2,car,van,250,748,435,744,498,309,0.99397635,3,0,2,0.6204819277108434,
20,2,car,van,249,754,431,751,505,320,0.9686244,3,0,2,0.6336633663366337,
21,2,car,van,253,746,435,749,493,314,0.9651378,3,0,2,0.6369168356997972,
22,2,car,van,481,957,412,766,476,354,0.92372614,3,0,2,0.7436974789915967,
23,2,car,van,488,937,411,738,449,327,0.9417135,3,0,2,0.7282850779510023,
24,2,car,van,493,951,415,764,458,349,0.96600556,3,0,2,0.7620087336244541,
0,2,car,van,252,750,433,748,498,315,0.9852432,3,0,2,0.6325301204819277,
1,2,car,van,249,752,435,745,503,310,0.96325326,3,0,2,0.6163021868787276,
2,2,car,van,248,756,432,750,508,318,0.97406626,3,0,2,0.6259842519685039,
3,2,car,van,252,756,430,755,504,325,0.9911878,3,0,2,0.6448412698412699,
4,2,car,van,245,758,436,745,513,309,0.9737028,3,30,2,0.6023391812865497,
5,2,car,van,252,747,435,746,495,311,0.9611737,3,0,2,0.6282828282828283,
6,2,car,van,249,751,437,744,502,307,0.98877203,3,0,2,0.6115537848605578,
7,2,car,van,252,750,432,753,498,321,0.9831583,3,0,2,0.6445783132530121,
8,2,car,van,244,753,436,748,509,312,0.9376707,3,0,2,0.6129666011787819,
9,2,car,van,248,754,435,750,506,315,0.9802954,3,0,2,0.6225296442687747,
10,2,car,van,250,751,434,746,501,312,0.98451245,3,0,2,0.6227544910179641,
11,2,car,van,242,750,437,749,508,312,0.9798773,3,0,2,0.6141732283464567,
12,2,car,van,248,753,435,751,505,316,0.9665193,3,0,2,0.6257425742574257,
13,2,car,van,245,752,436,751,507,315,0.9661207,3,0,2,0.621301775147929,
14,2,car,van,242,759,432,752,517,320,0.97504705,3,0,2,0.6189555125725339,
15,2,car,van,247,751,432,750,504,318,0.98905355,3,0,2,0.6309523809523809,
16,2,car,van,247,759,432,746,512,314,0.9786135,3,0,2,0.61328125,
17,2,car,van,245,754,432,751,509,319,0.9489522,3,0,2,0.6267190569744597,
18,2,car,van,247,752,432,754,505,322,0.9881196,3,0,2,0.6376237623762376,
19,2,car,van,241,755,435,746,514,311,0.95389324,3,30,2,0.6050583657587548,
20,2,car,van,250,748,435,744,498,309,0.99397635,3,0,2,0.6204819277108434,
21,2,car,van,249,754,431,751,505,320,0.9686244,3,0,2,0.6336633663366337,
22,2,car,van,253,746,435,749,493,314,0.9651378,3,0,2,0.6369168356997972,
23,2,car,van,481,957,412,766,476,354,0.92372614,3,0,2,0.7436974789915967,
24,2,car,van,488,937,411,738,449,327,0.9417135,3,0,2,0.7282850779510023,
25,2,car,van,493,951,415,764,458,349,0.96600556,3,0,2,0.7620087336244541,
0,2,car,van,251,745,433,748,494,315,0.9901451,3,0,2,0.6376518218623481,
1,2,car,van,252,750,433,748,498,315,0.9852432,3,0,2,0.6325301204819277,
2,2,car,van,249,752,435,745,503,310,0.96325326,3,0,2,0.6163021868787276,
3,2,car,van,248,756,432,750,508,318,0.97406626,3,0,2,0.6259842519685039,
4,2,car,van,252,756,430,755,504,325,0.9911878,3,0,2,0.6448412698412699,
5,2,car,van,245,758,436,745,513,309,0.9737028,3,30,2,0.6023391812865497,
6,2,car,van,252,747,435,746,495,311,0.9611737,3,0,2,0.6282828282828283,
7,2,car,van,249,751,437,744,502,307,0.98877203,3,0,2,0.6115537848605578,
8,2,car,van,252,750,432,753,498,321,0.9831583,3,0,2,0.6445783132530121,
9,2,car,van,244,753,436,748,509,312,0.9376707,3,0,2,0.6129666011787819,
10,2,car,van,248,754,435,750,506,315,0.9802954,3,0,2,0.6225296442687747,
11,2,car,van,250,751,434,746,501,312,0.98451245,3,0,2,0.6227544910179641,
12,2,car,van,242,750,437,749,508,312,0.9798773,3,0,2,0.6141732283464567,
13,2,car,van,248,753,435,751,505,316,0.9665193,3,0,2,0.6257425742574257,
14,2,car,van,245,752,436,751,507,315,0.9661207,3,0,2,0.621301775147929,
15,2,car,van,242,759,432,752,517,320,0.97504705,3,0,2,0.6189555125725339,
16,2,car,van,247,751,432,750,504,318,0.98905355,3,0,2,0.6309523809523809,
17,2,car,van,247,759,432,746,512,314,0.9786135,3,0,2,0.61328125,
18,2,car,van,245,754,432,751,509,319,0.9489522,3,0,2,0.6267190569744597,
19,2,car,van,247,752,432,754,505,322,0.9881196,3,0,2,0.6376237623762376,
20,2,car,van,241,755,435,746,514,311,0.95389324,3,30,2,0.6050583657587548,
21,2,car,van,250,748,435,744,498,309,0.99397635,3,0,2,0.6204819277108434,
22,2,car,van,249,754,431,751,505,320,0.9686244,3,0,2,0.6336633663366337,
23,2,car,van,253,746,435,749,493,314,0.9651378,3,0,2,0.6369168356997972,
24,2,car,van,481,957,412,766,476,354,0.92372614,3,0,2,0.7436974789915967,
25,2,car,van,488,937,411,738,449,327,0.9417135,3,0,2,0.7282850779510023,
26,2,car,van,493,951,415,764,458,349,0.96600556,3,0,2,0.7620087336244541,
0,2,car,van,246,753,436,750,507,314,0.9711972,3,0,2,0.6193293885601578,
1,2,car,van,251,745,433,748,494,315,0.9901451,3,0,2,0.6376518218623481,
2,2,car,van,252,750,433,748,498,315,0.9852432,3,0,2,0.6325301204819277,
3,2,car,van,249,752,435,745,503,310,0.96325326,3,0,2,0.6163021868787276,
4,2,car,van,248,756,432,750,508,318,0.97406626,3,0,2,0.6259842519685039,
5,2,car,van,252,756,430,755,504,325,0.9911878,3,0,2,0.6448412698412699,
6,2,car,van,245,758,436,745,513,309,0.9737028,3,30,2,0.6023391812865497,
7,2,car,van,252,747,435,746,495,311,0.9611737,3,0,2,0.6282828282828283,
8,2,car,van,249,751,437,744,502,307,0.98877203,3,0,2,0.6115537848605578,
9,2,car,van,252,750,432,753,498,321,0.9831583,3,0,2,0.6445783132530121,
10,2,car,van,244,753,436,748,509,312,0.9376707,3,0,2,0.6129666011787819,
11,2,car,van,248,754,435,750,506,315,0.9802954,3,0,2,0.6225296442687747,
12,2,car,van,250,751,434,746,501,312,0.98451245,3,0,2,0.6227544910179641,
13,2,car,van,242,750,437,749,508,312,0.9798773,3,0,2,0.6141732283464567,
14,2,car,van,248,753,435,751,505,316,0.9665193,3,0,2,0.6257425742574257,
15,2,car,van,245,752,436,751,507,315,0.9661207,3,0,2,0.621301775147929,
16,2,car,van,242,759,432,752,517,320,0.97504705,3,0,2,0.6189555125725339,
17,2,car,van,247,751,432,750,504,318,0.98905355,3,0,2,0.6309523809523809,
18,2,car,van,247,759,432,746,512,314,0.9786135,3,0,2,0.61328125,
19,2,car,van,245,754,432,751,509,319,0.9489522,3,0,2,0.6267190569744597,
20,2,car,van,247,752,432,754,505,322,0.9881196,3,0,2,0.6376237623762376,
21,2,car,van,241,755,435,746,514,311,0.95389324,3,30,2,0.6050583657587548,
22,2,car,van,250,748,435,744,498,309,0.99397635,3,0,2,0.6204819277108434,
23,2,car,van,249,754,431,751,505,320,0.9686244,3,0,2,0.6336633663366337,
24,2,car,van,253,746,435,749,493,314,0.9651378,3,0,2,0.6369168356997972,
25,2,car,van,481,957,412,766,476,354,0.92372614,3,0,2,0.7436974789915967,
26,2,car,van,488,937,411,738,449,327,0.9417135,3,0,2,0.7282850779510023,
27,2,car,van,493,951,415,764,458,349,0.96600556,3,0,2,0.7620087336244541,
0,2,car,van,241,763,433,751,522,318,0.7548614,3,30,2,0.6091954022988506,
1,2,car,van,246,753,436,750,507,314,0.9711972,3,0,2,0.6193293885601578,
2,2,car,van,251,745,433,748,494,315,0.9901451,3,0,2,0.6376518218623481,
3,2,car,van,252,750,433,748,498,315,0.9852432,3,0,2,0.6325301204819277,
4,2,car,van,249,752,435,745,503,310,0.96325326,3,0,2,0.6163021868787276,
5,2,car,van,248,756,432,750,508,318,0.97406626,3,0,2,0.6259842519685039,
6,2,car,van,252,756,430,755,504,325,0.9911878,3,0,2,0.6448412698412699,
7,2,car,van,245,758,436,745,513,309,0.9737028,3,30,2,0.6023391812865497,
8,2,car,van,252,747,435,746,495,311,0.9611737,3,0,2,0.6282828282828283,
9,2,car,van,249,751,437,744,502,307,0.98877203,3,0,2,0.6115537848605578,
10,2,car,van,252,750,432,753,498,321,0.9831583,3,0,2,0.6445783132530121,
11,2,car,van,244,753,436,748,509,312,0.9376707,3,0,2,0.6129666011787819,
12,2,car,van,248,754,435,750,506,315,0.9802954,3,0,2,0.6225296442687747,
13,2,car,van,250,751,434,746,501,312,0.98451245,3,0,2,0.6227544910179641,
14,2,car,van,242,750,437,749,508,312,0.9798773,3,0,2,0.6141732283464567,
15,2,car,van,248,753,435,751,505,316,0.9665193,3,0,2,0.6257425742574257,
16,2,car,van,245,752,436,751,507,315,0.9661207,3,0,2,0.621301775147929,
17,2,car,van,242,759,432,752,517,320,0.97504705,3,0,2,0.6189555125725339,
18,2,car,van,247,751,432,750,504,318,0.98905355,3,0,2,0.6309523809523809,
19,2,car,van,247,759,432,746,512,314,0.9786135,3,0,2,0.61328125,
20,2,car,van,245,754,432,751,509,319,0.9489522,3,0,2,0.6267190569744597,
21,2,car,van,247,752,432,754,505,322,0.9881196,3,0,2,0.6376237623762376,
22,2,car,van,241,755,435,746,514,311,0.95389324,3,30,2,0.6050583657587548,
23,2,car,van,250,748,435,744,498,309,0.99397635,3,0,2,0.6204819277108434,
24,2,car,van,249,754,431,751,505,320,0.9686244,3,0,2,0.6336633663366337,
25,2,car,van,253,746,435,749,493,314,0.9651378,3,0,2,0.6369168356997972,
26,2,car,van,481,957,412,766,476,354,0.92372614,3,0,2,0.7436974789915967,
27,2,car,van,488,937,411,738,449,327,0.9417135,3,0,2,0.7282850779510023,
28,2,car,van,493,951,415,764,458,349,0.96600556,3,0,2,0.7620087336244541,
0,2,car,van,246,751,436,753,505,317,0.9723565,3,0,2,0.6277227722772277,
1,2,car,van,241,763,433,751,522,318,0.7548614,3,30,2,0.6091954022988506,
2,2,car,van,246,753,436,750,507,314,0.9711972,3,0,2,0.6193293885601578,
3,2,car,van,251,745,433,748,494,315,0.9901451,3,0,2,0.6376518218623481,
4,2,car,van,252,750,433,748,498,315,0.9852432,3,0,2,0.6325301204819277,
5,2,car,van,249,752,435,745,503,310,0.96325326,3,0,2,0.6163021868787276,
6,2,car,van,248,756,432,750,508,318,0.97406626,3,0,2,0.6259842519685039,
7,2,car,van,252,756,430,755,504,325,0.9911878,3,0,2,0.6448412698412699,
8,2,car,van,245,758,436,745,513,309,0.9737028,3,30,2,0.6023391812865497,
9,2,car,van,252,747,435,746,495,311,0.9611737,3,0,2,0.6282828282828283,
10,2,car,van,249,751,437,744,502,307,0.98877203,3,0,2,0.6115537848605578,
11,2,car,van,252,750,432,753,498,321,0.9831583,3,0,2,0.6445783132530121,
12,2,car,van,244,753,436,748,509,312,0.9376707,3,0,2,0.6129666011787819,
13,2,car,van,248,754,435,750,506,315,0.9802954,3,0,2,0.6225296442687747,
14,2,car,van,250,751,434,746,501,312,0.98451245,3,0,2,0.6227544910179641,
15,2,car,van,242,750,437,749,508,312,0.9798773,3,0,2,0.6141732283464567,
16,2,car,van,248,753,435,751,505,316,0.9665193,3,0,2,0.6257425742574257,
17,2,car,van,245,752,436,751,507,315,0.9661207,3,0,2,0.621301775147929,
18,2,car,van,242,759,432,752,517,320,0.97504705,3,0,2,0.6189555125725339,
19,2,car,van,247,751,432,750,504,318,0.98905355,3,0,2,0.6309523809523809,
20,2,car,van,247,759,432,746,512,314,0.9786135,3,0,2,0.61328125,
21,2,car,van,245,754,432,751,509,319,0.9489522,3,0,2,0.6267190569744597,
22,2,car,van,247,752,432,754,505,322,0.9881196,3,0,2,0.6376237623762376,
23,2,car,van,241,755,435,746,514,311,0.95389324,3,30,2,0.6050583657587548,
24,2,car,van,250,748,435,744,498,309,0.99397635,3,0,2,0.6204819277108434,
25,2,car,van,249,754,431,751,505,320,0.9686244,3,0,2,0.6336633663366337,
26,2,car,van,253,746,435,749,493,314,0.9651378,3,0,2,0.6369168356997972,
27,2,car,van,481,957,412,766,476,354,0.92372614,3,0,2,0.7436974789915967,
28,2,car,van,488,937,411,738,449,327,0.9417135,3,0,2,0.7282850779510023,
29,2,car,van,493,951,415,764,458,349,0.96600556,3,0,2,0.7620087336244541,
0,2,car,van,249,749,436,744,500,308,0.9823882,3,0,2,0.616,
1,2,car,van,246,751,436,753,505,317,0.9723565,3,0,2,0.6277227722772277,
2,2,car,van,241,763,433,751,522,318,0.7548614,3,30,2,0.6091954022988506,
3,2,car,van,246,753,436,750,507,314,0.9711972,3,0,2,0.6193293885601578,
4,2,car,van,251,745,433,748,494,315,0.9901451,3,0,2,0.6376518218623481,
5,2,car,van,252,750,433,748,498,315,0.9852432,3,0,2,0.6325301204819277,
6,2,car,van,249,752,435,745,503,310,0.96325326,3,0,2,0.6163021868787276,
7,2,car,van,248,756,432,750,508,318,0.97406626,3,0,2,0.6259842519685039,
8,2,car,van,252,756,430,755,504,325,0.9911878,3,0,2,0.6448412698412699,
9,2,car,van,245,758,436,745,513,309,0.9737028,3,30,2,0.6023391812865497,
10,2,car,van,252,747,435,746,495,311,0.9611737,3,0,2,0.6282828282828283,
11,2,car,van,249,751,437,744,502,307,0.98877203,3,0,2,0.6115537848605578,
12,2,car,van,252,750,432,753,498,321,0.9831583,3,0,2,0.6445783132530121,
13,2,car,van,244,753,436,748,509,312,0.9376707,3,0,2,0.6129666011787819,
14,2,car,van,248,754,435,750,506,315,0.9802954,3,0,2,0.6225296442687747,
15,2,car,van,250,751,434,746,501,312,0.98451245,3,0,2,0.6227544910179641,
16,2,car,van,242,750,437,749,508,312,0.9798773,3,0,2,0.6141732283464567,
17,2,car,van,248,753,435,751,505,316,0.9665193,3,0,2,0.6257425742574257,
18,2,car,van,245,752,436,751,507,315,0.9661207,3,0,2,0.621301775147929,
19,2,car,van,242,759,432,752,517,320,0.97504705,3,0,2,0.6189555125725339,
20,2,car,van,247,751,432,750,504,318,0.98905355,3,0,2,0.6309523809523809,
21,2,car,van,247,759,432,746,512,314,0.9786135,3,0,2,0.61328125,
22,2,car,van,245,754,432,751,509,319,0.9489522,3,0,2,0.6267190569744597,
23,2,car,van,247,752,432,754,505,322,0.9881196,3,0,2,0.6376237623762376,
24,2,car,van,241,755,435,746,514,311,0.95389324,3,30,2,0.6050583657587548,
25,2,car,van,250,748,435,744,498,309,0.99397635,3,0,2,0.6204819277108434,
26,2,car,van,249,754,431,751,505,320,0.9686244,3,0,2,0.6336633663366337,
27,2,car,van,253,746,435,749,493,314,0.9651378,3,0,2,0.6369168356997972,
28,2,car,van,481,957,412,766,476,354,0.92372614,3,0,2,0.7436974789915967,
29,2,car,van,488,937,411,738,449,327,0.9417135,3,0,2,0.7282850779510023,
30,2,car,van,493,951,415,764,458,349,0.96600556,3,0,2,0.7620087336244541,
0,2,car,van,251,745,436,749,494,313,0.98894763,3,0,2,0.6336032388663968,
1,2,car,van,249,749,436,744,500,308,0.9823882,3,0,2,0.616,
2,2,car,van,246,751,436,753,505,317,0.9723565,3,0,2,0.6277227722772277,
3,2,car,van,241,763,433,751,522,318,0.7548614,3,30,2,0.6091954022988506,
4,2,car,van,246,753,436,750,507,314,0.9711972,3,0,2,0.6193293885601578,
5,2,car,van,251,745,433,748,494,315,0.9901451,3,0,2,0.6376518218623481,
6,2,car,van,252,750,433,748,498,315,0.9852432,3,0,2,0.6325301204819277,
7,2,car,van,249,752,435,745,503,310,0.96325326,3,0,2,0.6163021868787276,
8,2,car,van,248,756,432,750,508,318,0.97406626,3,0,2,0.6259842519685039,
9,2,car,van,252,756,430,755,504,325,0.9911878,3,0,2,0.6448412698412699,
10,2,car,van,245,758,436,745,513,309,0.9737028,3,30,2,0.6023391812865497,
11,2,car,van,252,747,435,746,495,311,0.9611737,3,0,2,0.6282828282828283,
12,2,car,van,249,751,437,744,502,307,0.98877203,3,0,2,0.6115537848605578,
13,2,car,van,252,750,432,753,498,321,0.9831583,3,0,2,0.6445783132530121,
14,2,car,van,244,753,436,748,509,312,0.9376707,3,0,2,0.6129666011787819,
15,2,car,van,248,754,435,750,506,315,0.9802954,3,0,2,0.6225296442687747,
16,2,car,van,250,751,434,746,501,312,0.98451245,3,0,2,0.6227544910179641,
17,2,car,van,242,750,437,749,508,312,0.9798773,3,0,2,0.6141732283464567,
18,2,car,van,248,753,435,751,505,316,0.9665193,3,0,2,0.6257425742574257,
19,2,car,van,245,752,436,751,507,315,0.9661207,3,0,2,0.621301775147929,
20,2,car,van,242,759,432,752,517,320,0.97504705,3,0,2,0.6189555125725339,
21,2,car,van,247,751,432,750,504,318,0.98905355,3,0,2,0.6309523809523809,
22,2,car,van,247,759,432,746,512,314,0.9786135,3,0,2,0.61328125,
23,2,car,van,245,754,432,751,509,319,0.9489522,3,0,2,0.6267190569744597,
24,2,car,van,247,752,432,754,505,322,0.9881196,3,0,2,0.6376237623762376,
25,2,car,van,241,755,435,746,514,311,0.95389324,3,30,2,0.6050583657587548,
26,2,car,van,250,748,435,744,498,309,0.99397635,3,0,2,0.6204819277108434,
27,2,car,van,249,754,431,751,505,320,0.9686244,3,0,2,0.6336633663366337,
28,2,car,van,253,746,435,749,493,314,0.9651378,3,0,2,0.6369168356997972,
29,2,car,van,481,957,412,766,476,354,0.92372614,3,0,2,0.7436974789915967,
30,2,car,van,488,937,411,738,449,327,0.9417135,3,0,2,0.7282850779510023,
31,2,car,van,493,951,415,764,458,349,0.96600556,3,0,2,0.7620087336244541,
0,2,car,van,138,1285,388,830,1147,442,0.22838312,3,0,2,0.3853530950305144,
1,2,car,van,248,753,436,745,505,309,0.91183275,3,0,2,0.3853530950305144,
2,2,car,van,251,745,436,749,494,313,0.98894763,3,0,2,0.6336032388663968,
3,2,car,van,249,749,436,744,500,308,0.9823882,3,0,2,0.616,
4,2,car,van,246,751,436,753,505,317,0.9723565,3,0,2,0.6277227722772277,
5,2,car,van,241,763,433,751,522,318,0.7548614,3,30,2,0.6091954022988506,
6,2,car,van,246,753,436,750,507,314,0.9711972,3,0,2,0.6193293885601578,
7,2,car,van,251,745,433,748,494,315,0.9901451,3,0,2,0.6376518218623481,
8,2,car,van,252,750,433,748,498,315,0.9852432,3,0,2,0.6325301204819277,
9,2,car,van,249,752,435,745,503,310,0.96325326,3,0,2,0.6163021868787276,
10,2,car,van,248,756,432,750,508,318,0.97406626,3,0,2,0.6259842519685039,
11,2,car,van,252,756,430,755,504,325,0.9911878,3,0,2,0.6448412698412699,
12,2,car,van,245,758,436,745,513,309,0.9737028,3,30,2,0.6023391812865497,
13,2,car,van,252,747,435,746,495,311,0.9611737,3,0,2,0.6282828282828283,
14,2,car,van,249,751,437,744,502,307,0.98877203,3,0,2,0.6115537848605578,
15,2,car,van,252,750,432,753,498,321,0.9831583,3,0,2,0.6445783132530121,
16,2,car,van,244,753,436,748,509,312,0.9376707,3,0,2,0.6129666011787819,
17,2,car,van,248,754,435,750,506,315,0.9802954,3,0,2,0.6225296442687747,
18,2,car,van,250,751,434,746,501,312,0.98451245,3,0,2,0.6227544910179641,
19,2,car,van,242,750,437,749,508,312,0.9798773,3,0,2,0.6141732283464567,
20,2,car,van,248,753,435,751,505,316,0.9665193,3,0,2,0.6257425742574257,
21,2,car,van,245,752,436,751,507,315,0.9661207,3,0,2,0.621301775147929,
22,2,car,van,242,759,432,752,517,320,0.97504705,3,0,2,0.6189555125725339,
23,2,car,van,247,751,432,750,504,318,0.98905355,3,0,2,0.6309523809523809,
24,2,car,van,247,759,432,746,512,314,0.9786135,3,0,2,0.61328125,
25,2,car,van,245,754,432,751,509,319,0.9489522,3,0,2,0.6267190569744597,
26,2,car,van,247,752,432,754,505,322,0.9881196,3,0,2,0.6376237623762376,
27,2,car,van,241,755,435,746,514,311,0.95389324,3,30,2,0.6050583657587548,
28,2,car,van,250,748,435,744,498,309,0.99397635,3,0,2,0.6204819277108434,
29,2,car,van,249,754,431,751,505,320,0.9686244,3,0,2,0.6336633663366337,
30,2,car,van,253,746,435,749,493,314,0.9651378,3,0,2,0.6369168356997972,
31,2,car,van,481,957,412,766,476,354,0.92372614,3,0,2,0.7436974789915967,
32,2,car,van,488,937,411,738,449,327,0.9417135,3,0,2,0.7282850779510023,
33,2,car,van,493,951,415,764,458,349,0.96600556,3,0,2,0.7620087336244541,
0,2,car,van,165,1258,386,819,1093,433,0.2378989,3,0,2,0.39615736505032023,
1,2,car,van,248,756,432,751,508,319,0.9556341,3,0,2,0.39615736505032023,
2,2,car,van,138,1285,388,830,1147,442,0.22838312,3,0,2,0.3853530950305144,
3,2,car,van,248,753,436,745,505,309,0.91183275,3,0,2,0.3853530950305144,
4,2,car,van,251,745,436,749,494,313,0.98894763,3,0,2,0.6336032388663968,
5,2,car,van,249,749,436,744,500,308,0.9823882,3,0,2,0.616,
6,2,car,van,246,751,436,753,505,317,0.9723565,3,0,2,0.6277227722772277,
7,2,car,van,241,763,433,751,522,318,0.7548614,3,30,2,0.6091954022988506,
8,2,car,van,246,753,436,750,507,314,0.9711972,3,0,2,0.6193293885601578,
9,2,car,van,251,745,433,748,494,315,0.9901451,3,0,2,0.6376518218623481,
10,2,car,van,252,750,433,748,498,315,0.9852432,3,0,2,0.6325301204819277,
11,2,car,van,249,752,435,745,503,310,0.96325326,3,0,2,0.6163021868787276,
12,2,car,van,248,756,432,750,508,318,0.97406626,3,0,2,0.6259842519685039,
13,2,car,van,252,756,430,755,504,325,0.9911878,3,0,2,0.6448412698412699,
14,2,car,van,245,758,436,745,513,309,0.9737028,3,30,2,0.6023391812865497,
15,2,car,van,252,747,435,746,495,311,0.9611737,3,0,2,0.6282828282828283,
16,2,car,van,249,751,437,744,502,307,0.98877203,3,0,2,0.6115537848605578,
17,2,car,van,252,750,432,753,498,321,0.9831583,3,0,2,0.6445783132530121,
18,2,car,van,244,753,436,748,509,312,0.9376707,3,0,2,0.6129666011787819,
19,2,car,van,248,754,435,750,506,315,0.9802954,3,0,2,0.6225296442687747,
20,2,car,van,250,751,434,746,501,312,0.98451245,3,0,2,0.6227544910179641,
21,2,car,van,242,750,437,749,508,312,0.9798773,3,0,2,0.6141732283464567,
22,2,car,van,248,753,435,751,505,316,0.9665193,3,0,2,0.6257425742574257,
23,2,car,van,245,752,436,751,507,315,0.9661207,3,0,2,0.621301775147929,
24,2,car,van,242,759,432,752,517,320,0.97504705,3,0,2,0.6189555125725339,
25,2,car,van,247,751,432,750,504,318,0.98905355,3,0,2,0.6309523809523809,
26,2,car,van,247,759,432,746,512,314,0.9786135,3,0,2,0.61328125,
27,2,car,van,245,754,432,751,509,319,0.9489522,3,0,2,0.6267190569744597,
28,2,car,van,247,752,432,754,505,322,0.9881196,3,0,2,0.6376237623762376,
29,2,car,van,241,755,435,746,514,311,0.95389324,3,30,2,0.6050583657587548,
30,2,car,van,250,748,435,744,498,309,0.99397635,3,0,2,0.6204819277108434,
31,2,car,van,249,754,431,751,505,320,0.9686244,3,0,2,0.6336633663366337,
32,2,car,van,253,746,435,749,493,314,0.9651378,3,0,2,0.6369168356997972,
33,2,car,van,481,957,412,766,476,354,0.92372614,3,0,2,0.7436974789915967,
34,2,car,van,488,937,411,738,449,327,0.9417135,3,0,2,0.7282850779510023,
35,2,car,van,493,951,415,764,458,349,0.96600556,3,0,2,0.7620087336244541,
0,2,car,van,243,749,435,752,506,317,0.97919697,3,0,2,0.6264822134387352,
1,2,car,van,165,1258,386,819,1093,433,0.2378989,3,0,2,0.39615736505032023,
2,2,car,van,248,756,432,751,508,319,0.9556341,3,0,2,0.39615736505032023,
3,2,car,van,138,1285,388,830,1147,442,0.22838312,3,0,2,0.3853530950305144,
4,2,car,van,248,753,436,745,505,309,0.91183275,3,0,2,0.3853530950305144,
5,2,car,van,251,745,436,749,494,313,0.98894763,3,0,2,0.6336032388663968,
6,2,car,van,249,749,436,744,500,308,0.9823882,3,0,2,0.616,
7,2,car,van,246,751,436,753,505,317,0.9723565,3,0,2,0.6277227722772277,
8,2,car,van,241,763,433,751,522,318,0.7548614,3,30,2,0.6091954022988506,
9,2,car,van,246,753,436,750,507,314,0.9711972,3,0,2,0.6193293885601578,
10,2,car,van,251,745,433,748,494,315,0.9901451,3,0,2,0.6376518218623481,
11,2,car,van,252,750,433,748,498,315,0.9852432,3,0,2,0.6325301204819277,
12,2,car,van,249,752,435,745,503,310,0.96325326,3,0,2,0.6163021868787276,
13,2,car,van,248,756,432,750,508,318,0.97406626,3,0,2,0.6259842519685039,
14,2,car,van,252,756,430,755,504,325,0.9911878,3,0,2,0.6448412698412699,
15,2,car,van,245,758,436,745,513,309,0.9737028,3,30,2,0.6023391812865497,
16,2,car,van,252,747,435,746,495,311,0.9611737,3,0,2,0.6282828282828283,
17,2,car,van,249,751,437,744,502,307,0.98877203,3,0,2,0.6115537848605578,
18,2,car,van,252,750,432,753,498,321,0.9831583,3,0,2,0.6445783132530121,
19,2,car,van,244,753,436,748,509,312,0.9376707,3,0,2,0.6129666011787819,
20,2,car,van,248,754,435,750,506,315,0.9802954,3,0,2,0.6225296442687747,
21,2,car,van,250,751,434,746,501,312,0.98451245,3,0,2,0.6227544910179641,
22,2,car,van,242,750,437,749,508,312,0.9798773,3,0,2,0.6141732283464567,
23,2,car,van,248,753,435,751,505,316,0.9665193,3,0,2,0.6257425742574257,
24,2,car,van,245,752,436,751,507,315,0.9661207,3,0,2,0.621301775147929,
25,2,car,van,242,759,432,752,517,320,0.97504705,3,0,2,0.6189555125725339,
26,2,car,van,247,751,432,750,504,318,0.98905355,3,0,2,0.6309523809523809,
27,2,car,van,247,759,432,746,512,314,0.9786135,3,0,2,0.61328125,
28,2,car,van,245,754,432,751,509,319,0.9489522,3,0,2,0.6267190569744597,
29,2,car,van,247,752,432,754,505,322,0.9881196,3,0,2,0.6376237623762376,
30,2,car,van,241,755,435,746,514,311,0.95389324,3,30,2,0.6050583657587548,
31,2,car,van,250,748,435,744,498,309,0.99397635,3,0,2,0.6204819277108434,
32,2,car,van,249,754,431,751,505,320,0.9686244,3,0,2,0.6336633663366337,
33,2,car,van,253,746,435,749,493,314,0.9651378,3,0,2,0.6369168356997972,
34,2,car,van,481,957,412,766,476,354,0.92372614,3,0,2,0.7436974789915967,
35,2,car,van,488,937,411,738,449,327,0.9417135,3,0,2,0.7282850779510023,
36,2,car,van,493,951,415,764,458,349,0.96600556,3,0,2,0.7620087336244541,
0,2,car,van,249,754,435,745,505,310,0.98174345,3,0,2,0.6138613861386139,
1,2,car,van,243,749,435,752,506,317,0.97919697,3,0,2,0.6264822134387352,
2,2,car,van,165,1258,386,819,1093,433,0.2378989,3,0,2,0.39615736505032023,
3,2,car,van,248,756,432,751,508,319,0.9556341,3,0,2,0.39615736505032023,
4,2,car,van,138,1285,388,830,1147,442,0.22838312,3,0,2,0.3853530950305144,
5,2,car,van,248,753,436,745,505,309,0.91183275,3,0,2,0.3853530950305144,
6,2,car,van,251,745,436,749,494,313,0.98894763,3,0,2,0.6336032388663968,
7,2,car,van,249,749,436,744,500,308,0.9823882,3,0,2,0.616,
8,2,car,van,246,751,436,753,505,317,0.9723565,3,0,2,0.6277227722772277,
9,2,car,van,241,763,433,751,522,318,0.7548614,3,30,2,0.6091954022988506,
10,2,car,van,246,753,436,750,507,314,0.9711972,3,0,2,0.6193293885601578,
11,2,car,van,251,745,433,748,494,315,0.9901451,3,0,2,0.6376518218623481,
12,2,car,van,252,750,433,748,498,315,0.9852432,3,0,2,0.6325301204819277,
13,2,car,van,249,752,435,745,503,310,0.96325326,3,0,2,0.6163021868787276,
14,2,car,van,248,756,432,750,508,318,0.97406626,3,0,2,0.6259842519685039,
15,2,car,van,252,756,430,755,504,325,0.9911878,3,0,2,0.6448412698412699,
16,2,car,van,245,758,436,745,513,309,0.9737028,3,30,2,0.6023391812865497,
17,2,car,van,252,747,435,746,495,311,0.9611737,3,0,2,0.6282828282828283,
18,2,car,van,249,751,437,744,502,307,0.98877203,3,0,2,0.6115537848605578,
19,2,car,van,252,750,432,753,498,321,0.9831583,3,0,2,0.6445783132530121,
20,2,car,van,244,753,436,748,509,312,0.9376707,3,0,2,0.6129666011787819,
21,2,car,van,248,754,435,750,506,315,0.9802954,3,0,2,0.6225296442687747,
22,2,car,van,250,751,434,746,501,312,0.98451245,3,0,2,0.6227544910179641,
23,2,car,van,242,750,437,749,508,312,0.9798773,3,0,2,0.6141732283464567,
24,2,car,van,248,753,435,751,505,316,0.9665193,3,0,2,0.6257425742574257,
25,2,car,van,245,752,436,751,507,315,0.9661207,3,0,2,0.621301775147929,
26,2,car,van,242,759,432,752,517,320,0.97504705,3,0,2,0.6189555125725339,
27,2,car,van,247,751,432,750,504,318,0.98905355,3,0,2,0.6309523809523809,
28,2,car,van,247,759,432,746,512,314,0.9786135,3,0,2,0.61328125,
29,2,car,van,245,754,432,751,509,319,0.9489522,3,0,2,0.6267190569744597,
30,2,car,van,247,752,432,754,505,322,0.9881196,3,0,2,0.6376237623762376,
31,2,car,van,241,755,435,746,514,311,0.95389324,3,30,2,0.6050583657587548,
32,2,car,van,250,748,435,744,498,309,0.99397635,3,0,2,0.6204819277108434,
33,2,car,van,249,754,431,751,505,320,0.9686244,3,0,2,0.6336633663366337,
34,2,car,van,253,746,435,749,493,314,0.9651378,3,0,2,0.6369168356997972,
35,2,car,van,481,957,412,766,476,354,0.92372614,3,0,2,0.7436974789915967,
36,2,car,van,488,937,411,738,449,327,0.9417135,3,0,2,0.7282850779510023,
37,2,car,van,493,951,415,764,458,349,0.96600556,3,0,2,0.7620087336244541,
0,2,car,van,247,752,438,745,505,307,0.98776233,3,30,2,0.6079207920792079,
1,2,car,van,249,754,435,745,505,310,0.98174345,3,0,2,0.6138613861386139,
2,2,car,van,243,749,435,752,506,317,0.97919697,3,0,2,0.6264822134387352,
3,2,car,van,165,1258,386,819,1093,433,0.2378989,3,0,2,0.39615736505032023,
4,2,car,van,248,756,432,751,508,319,0.9556341,3,0,2,0.39615736505032023,
5,2,car,van,138,1285,388,830,1147,442,0.22838312,3,0,2,0.3853530950305144,
6,2,car,van,248,753,436,745,505,309,0.91183275,3,0,2,0.3853530950305144,
7,2,car,van,251,745,436,749,494,313,0.98894763,3,0,2,0.6336032388663968,
8,2,car,van,249,749,436,744,500,308,0.9823882,3,0,2,0.616,
9,2,car,van,246,751,436,753,505,317,0.9723565,3,0,2,0.6277227722772277,
10,2,car,van,241,763,433,751,522,318,0.7548614,3,30,2,0.6091954022988506,
11,2,car,van,246,753,436,750,507,314,0.9711972,3,0,2,0.6193293885601578,
12,2,car,van,251,745,433,748,494,315,0.9901451,3,0,2,0.6376518218623481,
13,2,car,van,252,750,433,748,498,315,0.9852432,3,0,2,0.6325301204819277,
14,2,car,van,249,752,435,745,503,310,0.96325326,3,0,2,0.6163021868787276,
15,2,car,van,248,756,432,750,508,318,0.97406626,3,0,2,0.6259842519685039,
16,2,car,van,252,756,430,755,504,325,0.9911878,3,0,2,0.6448412698412699,
17,2,car,van,245,758,436,745,513,309,0.9737028,3,30,2,0.6023391812865497,
18,2,car,van,252,747,435,746,495,311,0.9611737,3,0,2,0.6282828282828283,
19,2,car,van,249,751,437,744,502,307,0.98877203,3,0,2,0.6115537848605578,
20,2,car,van,252,750,432,753,498,321,0.9831583,3,0,2,0.6445783132530121,
21,2,car,van,244,753,436,748,509,312,0.9376707,3,0,2,0.6129666011787819,
22,2,car,van,248,754,435,750,506,315,0.9802954,3,0,2,0.6225296442687747,
23,2,car,van,250,751,434,746,501,312,0.98451245,3,0,2,0.6227544910179641,
24,2,car,van,242,750,437,749,508,312,0.9798773,3,0,2,0.6141732283464567,
25,2,car,van,248,753,435,751,505,316,0.9665193,3,0,2,0.6257425742574257,
26,2,car,van,245,752,436,751,507,315,0.9661207,3,0,2,0.621301775147929,
27,2,car,van,242,759,432,752,517,320,0.97504705,3,0,2,0.6189555125725339,
28,2,car,van,247,751,432,750,504,318,0.98905355,3,0,2,0.6309523809523809,
29,2,car,van,247,759,432,746,512,314,0.9786135,3,0,2,0.61328125,
30,2,car,van,245,754,432,751,509,319,0.9489522,3,0,2,0.6267190569744597,
31,2,car,van,247,752,432,754,505,322,0.9881196,3,0,2,0.6376237623762376,
32,2,car,van,241,755,435,746,514,311,0.95389324,3,30,2,0.6050583657587548,
33,2,car,van,250,748,435,744,498,309,0.99397635,3,0,2,0.6204819277108434,
34,2,car,van,249,754,431,751,505,320,0.9686244,3,0,2,0.6336633663366337,
35,2,car,van,253,746,435,749,493,314,0.9651378,3,0,2,0.6369168356997972,
36,2,car,van,481,957,412,766,476,354,0.92372614,3,0,2,0.7436974789915967,
37,2,car,van,488,937,411,738,449,327,0.9417135,3,0,2,0.7282850779510023,
38,2,car,van,493,951,415,764,458,349,0.96600556,3,0,2,0.7620087336244541,
0,2,car,van,158,1263,389,812,1105,423,0.27788413,3,30,2,0.38280542986425337,
1,2,car,van,248,759,437,744,511,307,0.95875967,3,30,2,0.38280542986425337,
2,2,car,van,247,752,438,745,505,307,0.98776233,3,30,2,0.6079207920792079,
3,2,car,van,249,754,435,745,505,310,0.98174345,3,0,2,0.6138613861386139,
4,2,car,van,243,749,435,752,506,317,0.97919697,3,0,2,0.6264822134387352,
5,2,car,van,165,1258,386,819,1093,433,0.2378989,3,0,2,0.39615736505032023,
6,2,car,van,248,756,432,751,508,319,0.9556341,3,0,2,0.39615736505032023,
7,2,car,van,138,1285,388,830,1147,442,0.22838312,3,0,2,0.3853530950305144,
8,2,car,van,248,753,436,745,505,309,0.91183275,3,0,2,0.3853530950305144,
9,2,car,van,251,745,436,749,494,313,0.98894763,3,0,2,0.6336032388663968,
10,2,car,van,249,749,436,744,500,308,0.9823882,3,0,2,0.616,
11,2,car,van,246,751,436,753,505,317,0.9723565,3,0,2,0.6277227722772277,
12,2,car,van,241,763,433,751,522,318,0.7548614,3,30,2,0.6091954022988506,
13,2,car,van,246,753,436,750,507,314,0.9711972,3,0,2,0.6193293885601578,
14,2,car,van,251,745,433,748,494,315,0.9901451,3,0,2,0.6376518218623481,
15,2,car,van,252,750,433,748,498,315,0.9852432,3,0,2,0.6325301204819277,
16,2,car,van,249,752,435,745,503,310,0.96325326,3,0,2,0.6163021868787276,
17,2,car,van,248,756,432,750,508,318,0.97406626,3,0,2,0.6259842519685039,
18,2,car,van,252,756,430,755,504,325,0.9911878,3,0,2,0.6448412698412699,
19,2,car,van,245,758,436,745,513,309,0.9737028,3,30,2,0.6023391812865497,
20,2,car,van,252,747,435,746,495,311,0.9611737,3,0,2,0.6282828282828283,
21,2,car,van,249,751,437,744,502,307,0.98877203,3,0,2,0.6115537848605578,
22,2,car,van,252,750,432,753,498,321,0.9831583,3,0,2,0.6445783132530121,
23,2,car,van,244,753,436,748,509,312,0.9376707,3,0,2,0.6129666011787819,
24,2,car,van,248,754,435,750,506,315,0.9802954,3,0,2,0.6225296442687747,
25,2,car,van,250,751,434,746,501,312,0.98451245,3,0,2,0.6227544910179641,
26,2,car,van,242,750,437,749,508,312,0.9798773,3,0,2,0.6141732283464567,
27,2,car,van,248,753,435,751,505,316,0.9665193,3,0,2,0.6257425742574257,
28,2,car,van,245,752,436,751,507,315,0.9661207,3,0,2,0.621301775147929,
29,2,car,van,242,759,432,752,517,320,0.97504705,3,0,2,0.6189555125725339,
30,2,car,van,247,751,432,750,504,318,0.98905355,3,0,2,0.6309523809523809,
31,2,car,van,247,759,432,746,512,314,0.9786135,3,0,2,0.61328125,
32,2,car,van,245,754,432,751,509,319,0.9489522,3,0,2,0.6267190569744597,
33,2,car,van,247,752,432,754,505,322,0.9881196,3,0,2,0.6376237623762376,
34,2,car,van,241,755,435,746,514,311,0.95389324,3,30,2,0.6050583657587548,
35,2,car,van,250,748,435,744,498,309,0.99397635,3,0,2,0.6204819277108434,
36,2,car,van,249,754,431,751,505,320,0.9686244,3,0,2,0.6336633663366337,
37,2,car,van,253,746,435,749,493,314,0.9651378,3,0,2,0.6369168356997972,
38,2,car,van,481,957,412,766,476,354,0.92372614,3,0,2,0.7436974789915967,
39,2,car,van,488,937,411,738,449,327,0.9417135,3,0,2,0.7282850779510023,
40,2,car,van,493,951,415,764,458,349,0.96600556,3,0,2,0.7620087336244541,
0,2,car,van,165,1257,388,812,1092,424,0.2704866,3,0,2,0.3882783882783883,
1,2,car,van,253,750,437,746,497,309,0.9709216,3,0,2,0.3882783882783883,
2,2,car,van,158,1263,389,812,1105,423,0.27788413,3,30,2,0.38280542986425337,
3,2,car,van,248,759,437,744,511,307,0.95875967,3,30,2,0.38280542986425337,
4,2,car,van,247,752,438,745,505,307,0.98776233,3,30,2,0.6079207920792079,
5,2,car,van,249,754,435,745,505,310,0.98174345,3,0,2,0.6138613861386139,
6,2,car,van,243,749,435,752,506,317,0.97919697,3,0,2,0.6264822134387352,
7,2,car,van,165,1258,386,819,1093,433,0.2378989,3,0,2,0.39615736505032023,
8,2,car,van,248,756,432,751,508,319,0.9556341,3,0,2,0.39615736505032023,
9,2,car,van,138,1285,388,830,1147,442,0.22838312,3,0,2,0.3853530950305144,
10,2,car,van,248,753,436,745,505,309,0.91183275,3,0,2,0.3853530950305144,
11,2,car,van,251,745,436,749,494,313,0.98894763,3,0,2,0.6336032388663968,
12,2,car,van,249,749,436,744,500,308,0.9823882,3,0,2,0.616,
13,2,car,van,246,751,436,753,505,317,0.9723565,3,0,2,0.6277227722772277,
14,2,car,van,241,763,433,751,522,318,0.7548614,3,30,2,0.6091954022988506,
15,2,car,van,246,753,436,750,507,314,0.9711972,3,0,2,0.6193293885601578,
16,2,car,van,251,745,433,748,494,315,0.9901451,3,0,2,0.6376518218623481,
17,2,car,van,252,750,433,748,498,315,0.9852432,3,0,2,0.6325301204819277,
18,2,car,van,249,752,435,745,503,310,0.96325326,3,0,2,0.6163021868787276,
19,2,car,van,248,756,432,750,508,318,0.97406626,3,0,2,0.6259842519685039,
20,2,car,van,252,756,430,755,504,325,0.9911878,3,0,2,0.6448412698412699,
21,2,car,van,245,758,436,745,513,309,0.9737028,3,30,2,0.6023391812865497,
22,2,car,van,252,747,435,746,495,311,0.9611737,3,0,2,0.6282828282828283,
23,2,car,van,249,751,437,744,502,307,0.98877203,3,0,2,0.6115537848605578,
24,2,car,van,252,750,432,753,498,321,0.9831583,3,0,2,0.6445783132530121,
25,2,car,van,244,753,436,748,509,312,0.9376707,3,0,2,0.6129666011787819,
26,2,car,van,248,754,435,750,506,315,0.9802954,3,0,2,0.6225296442687747,
27,2,car,van,250,751,434,746,501,312,0.98451245,3,0,2,0.6227544910179641,
28,2,car,van,242,750,437,749,508,312,0.9798773,3,0,2,0.6141732283464567,
29,2,car,van,248,753,435,751,505,316,0.9665193,3,0,2,0.6257425742574257,
30,2,car,van,245,752,436,751,507,315,0.9661207,3,0,2,0.621301775147929,
31,2,car,van,242,759,432,752,517,320,0.97504705,3,0,2,0.6189555125725339,
32,2,car,van,247,751,432,750,504,318,0.98905355,3,0,2,0.6309523809523809,
33,2,car,van,247,759,432,746,512,314,0.9786135,3,0,2,0.61328125,
34,2,car,van,245,754,432,751,509,319,0.9489522,3,0,2,0.6267190569744597,
35,2,car,van,247,752,432,754,505,322,0.9881196,3,0,2,0.6376237623762376,
36,2,car,van,241,755,435,746,514,311,0.95389324,3,30,2,0.6050583657587548,
37,2,car,van,250,748,435,744,498,309,0.99397635,3,0,2,0.6204819277108434,
38,2,car,van,249,754,431,751,505,320,0.9686244,3,0,2,0.6336633663366337,
39,2,car,van,253,746,435,749,493,314,0.9651378,3,0,2,0.6369168356997972,
40,2,car,van,481,957,412,766,476,354,0.92372614,3,0,2,0.7436974789915967,
41,2,car,van,488,937,411,738,449,327,0.9417135,3,0,2,0.7282850779510023,
42,2,car,van,493,951,415,764,458,349,0.96600556,3,0,2,0.7620087336244541,
0,2,car,van,244,752,438,745,508,307,0.9769956,3,30,2,0.6043307086614174,
1,2,car,van,165,1257,388,812,1092,424,0.2704866,3,0,2,0.3882783882783883,
2,2,car,van,253,750,437,746,497,309,0.9709216,3,0,2,0.3882783882783883,
3,2,car,van,158,1263,389,812,1105,423,0.27788413,3,30,2,0.38280542986425337,
4,2,car,van,248,759,437,744,511,307,0.95875967,3,30,2,0.38280542986425337,
5,2,car,van,247,752,438,745,505,307,0.98776233,3,30,2,0.6079207920792079,
6,2,car,van,249,754,435,745,505,310,0.98174345,3,0,2,0.6138613861386139,
7,2,car,van,243,749,435,752,506,317,0.97919697,3,0,2,0.6264822134387352,
8,2,car,van,165,1258,386,819,1093,433,0.2378989,3,0,2,0.39615736505032023,
9,2,car,van,248,756,432,751,508,319,0.9556341,3,0,2,0.39615736505032023,
10,2,car,van,138,1285,388,830,1147,442,0.22838312,3,0,2,0.3853530950305144,
11,2,car,van,248,753,436,745,505,309,0.91183275,3,0,2,0.3853530950305144,
12,2,car,van,251,745,436,749,494,313,0.98894763,3,0,2,0.6336032388663968,
13,2,car,van,249,749,436,744,500,308,0.9823882,3,0,2,0.616,
14,2,car,van,246,751,436,753,505,317,0.9723565,3,0,2,0.6277227722772277,
15,2,car,van,241,763,433,751,522,318,0.7548614,3,30,2,0.6091954022988506,
16,2,car,van,246,753,436,750,507,314,0.9711972,3,0,2,0.6193293885601578,
17,2,car,van,251,745,433,748,494,315,0.9901451,3,0,2,0.6376518218623481,
18,2,car,van,252,750,433,748,498,315,0.9852432,3,0,2,0.6325301204819277,
19,2,car,van,249,752,435,745,503,310,0.96325326,3,0,2,0.6163021868787276,
20,2,car,van,248,756,432,750,508,318,0.97406626,3,0,2,0.6259842519685039,
21,2,car,van,252,756,430,755,504,325,0.9911878,3,0,2,0.6448412698412699,
22,2,car,van,245,758,436,745,513,309,0.9737028,3,30,2,0.6023391812865497,
23,2,car,van,252,747,435,746,495,311,0.9611737,3,0,2,0.6282828282828283,
24,2,car,van,249,751,437,744,502,307,0.98877203,3,0,2,0.6115537848605578,
25,2,car,van,252,750,432,753,498,321,0.9831583,3,0,2,0.6445783132530121,
26,2,car,van,244,753,436,748,509,312,0.9376707,3,0,2,0.6129666011787819,
27,2,car,van,248,754,435,750,506,315,0.9802954,3,0,2,0.6225296442687747,
28,2,car,van,250,751,434,746,501,312,0.98451245,3,0,2,0.6227544910179641,
29,2,car,van,242,750,437,749,508,312,0.9798773,3,0,2,0.6141732283464567,
30,2,car,van,248,753,435,751,505,316,0.9665193,3,0,2,0.6257425742574257,
31,2,car,van,245,752,436,751,507,315,0.9661207,3,0,2,0.621301775147929,
32,2,car,van,242,759,432,752,517,320,0.97504705,3,0,2,0.6189555125725339,
33,2,car,van,247,751,432,750,504,318,0.98905355,3,0,2,0.6309523809523809,
34,2,car,van,247,759,432,746,512,314,0.9786135,3,0,2,0.61328125,
35,2,car,van,245,754,432,751,509,319,0.9489522,3,0,2,0.6267190569744597,
36,2,car,van,247,752,432,754,505,322,0.9881196,3,0,2,0.6376237623762376,
37,2,car,van,241,755,435,746,514,311,0.95389324,3,30,2,0.6050583657587548,
38,2,car,van,250,748,435,744,498,309,0.99397635,3,0,2,0.6204819277108434,
39,2,car,van,249,754,431,751,505,320,0.9686244,3,0,2,0.6336633663366337,
40,2,car,van,253,746,435,749,493,314,0.9651378,3,0,2,0.6369168356997972,
41,2,car,van,481,957,412,766,476,354,0.92372614,3,0,2,0.7436974789915967,
42,2,car,van,488,937,411,738,449,327,0.9417135,3,0,2,0.7282850779510023,
43,2,car,van,493,951,415,764,458,349,0.96600556,3,0,2,0.7620087336244541,
0,2,car,van,164,1257,378,836,1093,458,0.43167558,3,30,2,0.41903019213174747,
1,2,car,van,242,762,435,750,520,315,0.8491126,3,30,2,0.41903019213174747,
2,2,car,van,244,752,438,745,508,307,0.9769956,3,30,2,0.6043307086614174,
3,2,car,van,165,1257,388,812,1092,424,0.2704866,3,0,2,0.3882783882783883,
4,2,car,van,253,750,437,746,497,309,0.9709216,3,0,2,0.3882783882783883,
5,2,car,van,158,1263,389,812,1105,423,0.27788413,3,30,2,0.38280542986425337,
6,2,car,van,248,759,437,744,511,307,0.95875967,3,30,2,0.38280542986425337,
7,2,car,van,247,752,438,745,505,307,0.98776233,3,30,2,0.6079207920792079,
8,2,car,van,249,754,435,745,505,310,0.98174345,3,0,2,0.6138613861386139,
9,2,car,van,243,749,435,752,506,317,0.97919697,3,0,2,0.6264822134387352,
10,2,car,van,165,1258,386,819,1093,433,0.2378989,3,0,2,0.39615736505032023,
11,2,car,van,248,756,432,751,508,319,0.9556341,3,0,2,0.39615736505032023,
12,2,car,van,138,1285,388,830,1147,442,0.22838312,3,0,2,0.3853530950305144,
13,2,car,van,248,753,436,745,505,309,0.91183275,3,0,2,0.3853530950305144,
14,2,car,van,251,745,436,749,494,313,0.98894763,3,0,2,0.6336032388663968,
15,2,car,van,249,749,436,744,500,308,0.9823882,3,0,2,0.616,
16,2,car,van,246,751,436,753,505,317,0.9723565,3,0,2,0.6277227722772277,
17,2,car,van,241,763,433,751,522,318,0.7548614,3,30,2,0.6091954022988506,
18,2,car,van,246,753,436,750,507,314,0.9711972,3,0,2,0.6193293885601578,
19,2,car,van,251,745,433,748,494,315,0.9901451,3,0,2,0.6376518218623481,
20,2,car,van,252,750,433,748,498,315,0.9852432,3,0,2,0.6325301204819277,
21,2,car,van,249,752,435,745,503,310,0.96325326,3,0,2,0.6163021868787276,
22,2,car,van,248,756,432,750,508,318,0.97406626,3,0,2,0.6259842519685039,
23,2,car,van,252,756,430,755,504,325,0.9911878,3,0,2,0.6448412698412699,
24,2,car,van,245,758,436,745,513,309,0.9737028,3,30,2,0.6023391812865497,
25,2,car,van,252,747,435,746,495,311,0.9611737,3,0,2,0.6282828282828283,
26,2,car,van,249,751,437,744,502,307,0.98877203,3,0,2,0.6115537848605578,
27,2,car,van,252,750,432,753,498,321,0.9831583,3,0,2,0.6445783132530121,
28,2,car,van,244,753,436,748,509,312,0.9376707,3,0,2,0.6129666011787819,
29,2,car,van,248,754,435,750,506,315,0.9802954,3,0,2,0.6225296442687747,
30,2,car,van,250,751,434,746,501,312,0.98451245,3,0,2,0.6227544910179641,
31,2,car,van,242,750,437,749,508,312,0.9798773,3,0,2,0.6141732283464567,
32,2,car,van,248,753,435,751,505,316,0.9665193,3,0,2,0.6257425742574257,
33,2,car,van,245,752,436,751,507,315,0.9661207,3,0,2,0.621301775147929,
34,2,car,van,242,759,432,752,517,320,0.97504705,3,0,2,0.6189555125725339,
35,2,car,van,247,751,432,750,504,318,0.98905355,3,0,2,0.6309523809523809,
36,2,car,van,247,759,432,746,512,314,0.9786135,3,0,2,0.61328125,
37,2,car,van,245,754,432,751,509,319,0.9489522,3,0,2,0.6267190569744597,
38,2,car,van,247,752,432,754,505,322,0.9881196,3,0,2,0.6376237623762376,
39,2,car,van,241,755,435,746,514,311,0.95389324,3,30,2,0.6050583657587548,
40,2,car,van,250,748,435,744,498,309,0.99397635,3,0,2,0.6204819277108434,
41,2,car,van,249,754,431,751,505,320,0.9686244,3,0,2,0.6336633663366337,
42,2,car,van,253,746,435,749,493,314,0.9651378,3,0,2,0.6369168356997972,
43,2,car,van,481,957,412,766,476,354,0.92372614,3,0,2,0.7436974789915967,
44,2,car,van,488,937,411,738,449,327,0.9417135,3,0,2,0.7282850779510023,
45,2,car,van,493,951,415,764,458,349,0.96600556,3,0,2,0.7620087336244541,
0,2,car,van,165,1262,383,825,1097,442,0.22265343,3,0,2,0.4029170464904284,
1,2,car,van,249,754,434,748,505,314,0.9467645,3,0,2,0.4029170464904284,
2,2,car,van,164,1257,378,836,1093,458,0.43167558,3,30,2,0.41903019213174747,
3,2,car,van,242,762,435,750,520,315,0.8491126,3,30,2,0.41903019213174747,
4,2,car,van,244,752,438,745,508,307,0.9769956,3,30,2,0.6043307086614174,
5,2,car,van,165,1257,388,812,1092,424,0.2704866,3,0,2,0.3882783882783883,
6,2,car,van,253,750,437,746,497,309,0.9709216,3,0,2,0.3882783882783883,
7,2,car,van,158,1263,389,812,1105,423,0.27788413,3,30,2,0.38280542986425337,
8,2,car,van,248,759,437,744,511,307,0.95875967,3,30,2,0.38280542986425337,
9,2,car,van,247,752,438,745,505,307,0.98776233,3,30,2,0.6079207920792079,
10,2,car,van,249,754,435,745,505,310,0.98174345,3,0,2,0.6138613861386139,
11,2,car,van,243,749,435,752,506,317,0.97919697,3,0,2,0.6264822134387352,
12,2,car,van,165,1258,386,819,1093,433,0.2378989,3,0,2,0.39615736505032023,
13,2,car,van,248,756,432,751,508,319,0.9556341,3,0,2,0.39615736505032023,
14,2,car,van,138,1285,388,830,1147,442,0.22838312,3,0,2,0.3853530950305144,
15,2,car,van,248,753,436,745,505,309,0.91183275,3,0,2,0.3853530950305144,
16,2,car,van,251,745,436,749,494,313,0.98894763,3,0,2,0.6336032388663968,
17,2,car,van,249,749,436,744,500,308,0.9823882,3,0,2,0.616,
18,2,car,van,246,751,436,753,505,317,0.9723565,3,0,2,0.6277227722772277,
19,2,car,van,241,763,433,751,522,318,0.7548614,3,30,2,0.6091954022988506,
20,2,car,van,246,753,436,750,507,314,0.9711972,3,0,2,0.6193293885601578,
21,2,car,van,251,745,433,748,494,315,0.9901451,3,0,2,0.6376518218623481,
22,2,car,van,252,750,433,748,498,315,0.9852432,3,0,2,0.6325301204819277,
23,2,car,van,249,752,435,745,503,310,0.96325326,3,0,2,0.6163021868787276,
24,2,car,van,248,756,432,750,508,318,0.97406626,3,0,2,0.6259842519685039,
25,2,car,van,252,756,430,755,504,325,0.9911878,3,0,2,0.6448412698412699,
26,2,car,van,245,758,436,745,513,309,0.9737028,3,30,2,0.6023391812865497,
27,2,car,van,252,747,435,746,495,311,0.9611737,3,0,2,0.6282828282828283,
28,2,car,van,249,751,437,744,502,307,0.98877203,3,0,2,0.6115537848605578,
29,2,car,van,252,750,432,753,498,321,0.9831583,3,0,2,0.6445783132530121,
30,2,car,van,244,753,436,748,509,312,0.9376707,3,0,2,0.6129666011787819,
31,2,car,van,248,754,435,750,506,315,0.9802954,3,0,2,0.6225296442687747,
32,2,car,van,250,751,434,746,501,312,0.98451245,3,0,2,0.6227544910179641,
33,2,car,van,242,750,437,749,508,312,0.9798773,3,0,2,0.6141732283464567,
34,2,car,van,248,753,435,751,505,316,0.9665193,3,0,2,0.6257425742574257,
35,2,car,van,245,752,436,751,507,315,0.9661207,3,0,2,0.621301775147929,
36,2,car,van,242,759,432,752,517,320,0.97504705,3,0,2,0.6189555125725339,
37,2,car,van,247,751,432,750,504,318,0.98905355,3,0,2,0.6309523809523809,
38,2,car,van,247,759,432,746,512,314,0.9786135,3,0,2,0.61328125,
39,2,car,van,245,754,432,751,509,319,0.9489522,3,0,2,0.6267190569744597,
40,2,car,van,247,752,432,754,505,322,0.9881196,3,0,2,0.6376237623762376,
41,2,car,van,241,755,435,746,514,311,0.95389324,3,30,2,0.6050583657587548,
42,2,car,van,250,748,435,744,498,309,0.99397635,3,0,2,0.6204819277108434,
43,2,car,van,249,754,431,751,505,320,0.9686244,3,0,2,0.6336633663366337,
44,2,car,van,253,746,435,749,493,314,0.9651378,3,0,2,0.6369168356997972,
45,2,car,van,481,957,412,766,476,354,0.92372614,3,0,2,0.7436974789915967,
46,2,car,van,488,937,411,738,449,327,0.9417135,3,0,2,0.7282850779510023,
47,2,car,van,493,951,415,764,458,349,0.96600556,3,0,2,0.7620087336244541,
0,2,car,van,244,758,439,741,514,302,0.97896934,3,30,2,0.5875486381322957,
1,2,car,van,165,1262,383,825,1097,442,0.22265343,3,0,2,0.4029170464904284,
2,2,car,van,249,754,434,748,505,314,0.9467645,3,0,2,0.4029170464904284,
3,2,car,van,164,1257,378,836,1093,458,0.43167558,3,30,2,0.41903019213174747,
4,2,car,van,242,762,435,750,520,315,0.8491126,3,30,2,0.41903019213174747,
5,2,car,van,244,752,438,745,508,307,0.9769956,3,30,2,0.6043307086614174,
6,2,car,van,165,1257,388,812,1092,424,0.2704866,3,0,2,0.3882783882783883,
7,2,car,van,253,750,437,746,497,309,0.9709216,3,0,2,0.3882783882783883,
8,2,car,van,158,1263,389,812,1105,423,0.27788413,3,30,2,0.38280542986425337,
9,2,car,van,248,759,437,744,511,307,0.95875967,3,30,2,0.38280542986425337,
10,2,car,van,247,752,438,745,505,307,0.98776233,3,30,2,0.6079207920792079,
11,2,car,van,249,754,435,745,505,310,0.98174345,3,0,2,0.6138613861386139,
12,2,car,van,243,749,435,752,506,317,0.97919697,3,0,2,0.6264822134387352,
13,2,car,van,165,1258,386,819,1093,433,0.2378989,3,0,2,0.39615736505032023,
14,2,car,van,248,756,432,751,508,319,0.9556341,3,0,2,0.39615736505032023,
15,2,car,van,138,1285,388,830,1147,442,0.22838312,3,0,2,0.3853530950305144,
16,2,car,van,248,753,436,745,505,309,0.91183275,3,0,2,0.3853530950305144,
17,2,car,van,251,745,436,749,494,313,0.98894763,3,0,2,0.6336032388663968,
18,2,car,van,249,749,436,744,500,308,0.9823882,3,0,2,0.616,
19,2,car,van,246,751,436,753,505,317,0.9723565,3,0,2,0.6277227722772277,
20,2,car,van,241,763,433,751,522,318,0.7548614,3,30,2,0.6091954022988506,
21,2,car,van,246,753,436,750,507,314,0.9711972,3,0,2,0.6193293885601578,
22,2,car,van,251,745,433,748,494,315,0.9901451,3,0,2,0.6376518218623481,
23,2,car,van,252,750,433,748,498,315,0.9852432,3,0,2,0.6325301204819277,
24,2,car,van,249,752,435,745,503,310,0.96325326,3,0,2,0.6163021868787276,
25,2,car,van,248,756,432,750,508,318,0.97406626,3,0,2,0.6259842519685039,
26,2,car,van,252,756,430,755,504,325,0.9911878,3,0,2,0.6448412698412699,
27,2,car,van,245,758,436,745,513,309,0.9737028,3,30,2,0.6023391812865497,
28,2,car,van,252,747,435,746,495,311,0.9611737,3,0,2,0.6282828282828283,
29,2,car,van,249,751,437,744,502,307,0.98877203,3,0,2,0.6115537848605578,
30,2,car,van,252,750,432,753,498,321,0.9831583,3,0,2,0.6445783132530121,
31,2,car,van,244,753,436,748,509,312,0.9376707,3,0,2,0.6129666011787819,
32,2,car,van,248,754,435,750,506,315,0.9802954,3,0,2,0.6225296442687747,
33,2,car,van,250,751,434,746,501,312,0.98451245,3,0,2,0.6227544910179641,
34,2,car,van,242,750,437,749,508,312,0.9798773,3,0,2,0.6141732283464567,
35,2,car,van,248,753,435,751,505,316,0.9665193,3,0,2,0.6257425742574257,
36,2,car,van,245,752,436,751,507,315,0.9661207,3,0,2,0.621301775147929,
37,2,car,van,242,759,432,752,517,320,0.97504705,3,0,2,0.6189555125725339,
38,2,car,van,247,751,432,750,504,318,0.98905355,3,0,2,0.6309523809523809,
39,2,car,van,247,759,432,746,512,314,0.9786135,3,0,2,0.61328125,
40,2,car,van,245,754,432,751,509,319,0.9489522,3,0,2,0.6267190569744597,
41,2,car,van,247,752,432,754,505,322,0.9881196,3,0,2,0.6376237623762376,
42,2,car,van,241,755,435,746,514,311,0.95389324,3,30,2,0.6050583657587548,
43,2,car,van,250,748,435,744,498,309,0.99397635,3,0,2,0.6204819277108434,
44,2,car,van,249,754,431,751,505,320,0.9686244,3,0,2,0.6336633663366337,
45,2,car,van,253,746,435,749,493,314,0.9651378,3,0,2,0.6369168356997972,
46,2,car,van,481,957,412,766,476,354,0.92372614,3,0,2,0.7436974789915967,
47,2,car,van,488,937,411,738,449,327,0.9417135,3,0,2,0.7282850779510023,
48,2,car,van,493,951,415,764,458,349,0.96600556,3,0,2,0.7620087336244541,
0,2,car,van,248,755,436,749,507,313,0.97860545,3,0,2,0.6173570019723866,
1,2,car,van,244,758,439,741,514,302,0.97896934,3,30,2,0.5875486381322957,
2,2,car,van,165,1262,383,825,1097,442,0.22265343,3,0,2,0.4029170464904284,
3,2,car,van,249,754,434,748,505,314,0.9467645,3,0,2,0.4029170464904284,
4,2,car,van,164,1257,378,836,1093,458,0.43167558,3,30,2,0.41903019213174747,
5,2,car,van,242,762,435,750,520,315,0.8491126,3,30,2,0.41903019213174747,
6,2,car,van,244,752,438,745,508,307,0.9769956,3,30,2,0.6043307086614174,
7,2,car,van,165,1257,388,812,1092,424,0.2704866,3,0,2,0.3882783882783883,
8,2,car,van,253,750,437,746,497,309,0.9709216,3,0,2,0.3882783882783883,
9,2,car,van,158,1263,389,812,1105,423,0.27788413,3,30,2,0.38280542986425337,
10,2,car,van,248,759,437,744,511,307,0.95875967,3,30,2,0.38280542986425337,
11,2,car,van,247,752,438,745,505,307,0.98776233,3,30,2,0.6079207920792079,
12,2,car,van,249,754,435,745,505,310,0.98174345,3,0,2,0.6138613861386139,
13,2,car,van,243,749,435,752,506,317,0.97919697,3,0,2,0.6264822134387352,
14,2,car,van,165,1258,386,819,1093,433,0.2378989,3,0,2,0.39615736505032023,
15,2,car,van,248,756,432,751,508,319,0.9556341,3,0,2,0.39615736505032023,
16,2,car,van,138,1285,388,830,1147,442,0.22838312,3,0,2,0.3853530950305144,
17,2,car,van,248,753,436,745,505,309,0.91183275,3,0,2,0.3853530950305144,
18,2,car,van,251,745,436,749,494,313,0.98894763,3,0,2,0.6336032388663968,
19,2,car,van,249,749,436,744,500,308,0.9823882,3,0,2,0.616,
20,2,car,van,246,751,436,753,505,317,0.9723565,3,0,2,0.6277227722772277,
21,2,car,van,241,763,433,751,522,318,0.7548614,3,30,2,0.6091954022988506,
22,2,car,van,246,753,436,750,507,314,0.9711972,3,0,2,0.6193293885601578,
23,2,car,van,251,745,433,748,494,315,0.9901451,3,0,2,0.6376518218623481,
24,2,car,van,252,750,433,748,498,315,0.9852432,3,0,2,0.6325301204819277,
25,2,car,van,249,752,435,745,503,310,0.96325326,3,0,2,0.6163021868787276,
26,2,car,van,248,756,432,750,508,318,0.97406626,3,0,2,0.6259842519685039,
27,2,car,van,252,756,430,755,504,325,0.9911878,3,0,2,0.6448412698412699,
28,2,car,van,245,758,436,745,513,309,0.9737028,3,30,2,0.6023391812865497,
29,2,car,van,252,747,435,746,495,311,0.9611737,3,0,2,0.6282828282828283,
30,2,car,van,249,751,437,744,502,307,0.98877203,3,0,2,0.6115537848605578,
31,2,car,van,252,750,432,753,498,321,0.9831583,3,0,2,0.6445783132530121,
32,2,car,van,244,753,436,748,509,312,0.9376707,3,0,2,0.6129666011787819,
33,2,car,van,248,754,435,750,506,315,0.9802954,3,0,2,0.6225296442687747,
34,2,car,van,250,751,434,746,501,312,0.98451245,3,0,2,0.6227544910179641,
35,2,car,van,242,750,437,749,508,312,0.9798773,3,0,2,0.6141732283464567,
36,2,car,van,248,753,435,751,505,316,0.9665193,3,0,2,0.6257425742574257,
37,2,car,van,245,752,436,751,507,315,0.9661207,3,0,2,0.621301775147929,
38,2,car,van,242,759,432,752,517,320,0.97504705,3,0,2,0.6189555125725339,
39,2,car,van,247,751,432,750,504,318,0.98905355,3,0,2,0.6309523809523809,
40,2,car,van,247,759,432,746,512,314,0.9786135,3,0,2,0.61328125,
41,2,car,van,245,754,432,751,509,319,0.9489522,3,0,2,0.6267190569744597,
42,2,car,van,247,752,432,754,505,322,0.9881196,3,0,2,0.6376237623762376,
43,2,car,van,241,755,435,746,514,311,0.95389324,3,30,2,0.6050583657587548,
44,2,car,van,250,748,435,744,498,309,0.99397635,3,0,2,0.6204819277108434,
45,2,car,van,249,754,431,751,505,320,0.9686244,3,0,2,0.6336633663366337,
46,2,car,van,253,746,435,749,493,314,0.9651378,3,0,2,0.6369168356997972,
47,2,car,van,481,957,412,766,476,354,0.92372614,3,0,2,0.7436974789915967,
48,2,car,van,488,937,411,738,449,327,0.9417135,3,0,2,0.7282850779510023,
49,2,car,van,493,951,415,764,458,349,0.96600556,3,0,2,0.7620087336244541,
0,2,car,van,247,751,437,742,504,305,0.9810417,3,30,2,0.6051587301587301,
1,2,car,van,248,755,436,749,507,313,0.97860545,3,0,2,0.6173570019723866,
2,2,car,van,244,758,439,741,514,302,0.97896934,3,30,2,0.5875486381322957,
3,2,car,van,165,1262,383,825,1097,442,0.22265343,3,0,2,0.4029170464904284,
4,2,car,van,249,754,434,748,505,314,0.9467645,3,0,2,0.4029170464904284,
5,2,car,van,164,1257,378,836,1093,458,0.43167558,3,30,2,0.41903019213174747,
6,2,car,van,242,762,435,750,520,315,0.8491126,3,30,2,0.41903019213174747,
7,2,car,van,244,752,438,745,508,307,0.9769956,3,30,2,0.6043307086614174,
8,2,car,van,165,1257,388,812,1092,424,0.2704866,3,0,2,0.3882783882783883,
9,2,car,van,253,750,437,746,497,309,0.9709216,3,0,2,0.3882783882783883,
10,2,car,van,158,1263,389,812,1105,423,0.27788413,3,30,2,0.38280542986425337,
11,2,car,van,248,759,437,744,511,307,0.95875967,3,30,2,0.38280542986425337,
12,2,car,van,247,752,438,745,505,307,0.98776233,3,30,2,0.6079207920792079,
13,2,car,van,249,754,435,745,505,310,0.98174345,3,0,2,0.6138613861386139,
14,2,car,van,243,749,435,752,506,317,0.97919697,3,0,2,0.6264822134387352,
15,2,car,van,165,1258,386,819,1093,433,0.2378989,3,0,2,0.39615736505032023,
16,2,car,van,248,756,432,751,508,319,0.9556341,3,0,2,0.39615736505032023,
17,2,car,van,138,1285,388,830,1147,442,0.22838312,3,0,2,0.3853530950305144,
18,2,car,van,248,753,436,745,505,309,0.91183275,3,0,2,0.3853530950305144,
19,2,car,van,251,745,436,749,494,313,0.98894763,3,0,2,0.6336032388663968,
20,2,car,van,249,749,436,744,500,308,0.9823882,3,0,2,0.616,
21,2,car,van,246,751,436,753,505,317,0.9723565,3,0,2,0.6277227722772277,
22,2,car,van,241,763,433,751,522,318,0.7548614,3,30,2,0.6091954022988506,
23,2,car,van,246,753,436,750,507,314,0.9711972,3,0,2,0.6193293885601578,
24,2,car,van,251,745,433,748,494,315,0.9901451,3,0,2,0.6376518218623481,
25,2,car,van,252,750,433,748,498,315,0.9852432,3,0,2,0.6325301204819277,
26,2,car,van,249,752,435,745,503,310,0.96325326,3,0,2,0.6163021868787276,
27,2,car,van,248,756,432,750,508,318,0.97406626,3,0,2,0.6259842519685039,
28,2,car,van,252,756,430,755,504,325,0.9911878,3,0,2,0.6448412698412699,
29,2,car,van,245,758,436,745,513,309,0.9737028,3,30,2,0.6023391812865497,
30,2,car,van,252,747,435,746,495,311,0.9611737,3,0,2,0.6282828282828283,
31,2,car,van,249,751,437,744,502,307,0.98877203,3,0,2,0.6115537848605578,
32,2,car,van,252,750,432,753,498,321,0.9831583,3,0,2,0.6445783132530121,
33,2,car,van,244,753,436,748,509,312,0.9376707,3,0,2,0.6129666011787819,
34,2,car,van,248,754,435,750,506,315,0.9802954,3,0,2,0.6225296442687747,
35,2,car,van,250,751,434,746,501,312,0.98451245,3,0,2,0.6227544910179641,
36,2,car,van,242,750,437,749,508,312,0.9798773,3,0,2,0.6141732283464567,
37,2,car,van,248,753,435,751,505,316,0.9665193,3,0,2,0.6257425742574257,
38,2,car,van,245,752,436,751,507,315,0.9661207,3,0,2,0.621301775147929,
39,2,car,van,242,759,432,752,517,320,0.97504705,3,0,2,0.6189555125725339,
40,2,car,van,247,751,432,750,504,318,0.98905355,3,0,2,0.6309523809523809,
41,2,car,van,247,759,432,746,512,314,0.9786135,3,0,2,0.61328125,
42,2,car,van,245,754,432,751,509,319,0.9489522,3,0,2,0.6267190569744597,
43,2,car,van,247,752,432,754,505,322,0.9881196,3,0,2,0.6376237623762376,
44,2,car,van,241,755,435,746,514,311,0.95389324,3,30,2,0.6050583657587548,
45,2,car,van,250,748,435,744,498,309,0.99397635,3,0,2,0.6204819277108434,
46,2,car,van,249,754,431,751,505,320,0.9686244,3,0,2,0.6336633663366337,
47,2,car,van,253,746,435,749,493,314,0.9651378,3,0,2,0.6369168356997972,
48,2,car,van,481,957,412,766,476,354,0.92372614,3,0,2,0.7436974789915967,
49,2,car,van,488,937,411,738,449,327,0.9417135,3,0,2,0.7282850779510023,
50,2,car,van,493,951,415,764,458,349,0.96600556,3,0,2,0.7620087336244541,
0,2,car,van,250,749,434,746,499,312,0.9798736,3,0,2,0.625250501002004,
1,2,car,van,247,751,437,742,504,305,0.9810417,3,30,2,0.6051587301587301,
2,2,car,van,248,755,436,749,507,313,0.97860545,3,0,2,0.6173570019723866,
3,2,car,van,244,758,439,741,514,302,0.97896934,3,30,2,0.5875486381322957,
4,2,car,van,165,1262,383,825,1097,442,0.22265343,3,0,2,0.4029170464904284,
5,2,car,van,249,754,434,748,505,314,0.9467645,3,0,2,0.4029170464904284,
6,2,car,van,164,1257,378,836,1093,458,0.43167558,3,30,2,0.41903019213174747,
7,2,car,van,242,762,435,750,520,315,0.8491126,3,30,2,0.41903019213174747,
8,2,car,van,244,752,438,745,508,307,0.9769956,3,30,2,0.6043307086614174,
9,2,car,van,165,1257,388,812,1092,424,0.2704866,3,0,2,0.3882783882783883,
10,2,car,van,253,750,437,746,497,309,0.9709216,3,0,2,0.3882783882783883,
11,2,car,van,158,1263,389,812,1105,423,0.27788413,3,30,2,0.38280542986425337,
12,2,car,van,248,759,437,744,511,307,0.95875967,3,30,2,0.38280542986425337,
13,2,car,van,247,752,438,745,505,307,0.98776233,3,30,2,0.6079207920792079,
14,2,car,van,249,754,435,745,505,310,0.98174345,3,0,2,0.6138613861386139,
15,2,car,van,243,749,435,752,506,317,0.97919697,3,0,2,0.6264822134387352,
16,2,car,van,165,1258,386,819,1093,433,0.2378989,3,0,2,0.39615736505032023,
17,2,car,van,248,756,432,751,508,319,0.9556341,3,0,2,0.39615736505032023,
18,2,car,van,138,1285,388,830,1147,442,0.22838312,3,0,2,0.3853530950305144,
19,2,car,van,248,753,436,745,505,309,0.91183275,3,0,2,0.3853530950305144,
20,2,car,van,251,745,436,749,494,313,0.98894763,3,0,2,0.6336032388663968,
21,2,car,van,249,749,436,744,500,308,0.9823882,3,0,2,0.616,
22,2,car,van,246,751,436,753,505,317,0.9723565,3,0,2,0.6277227722772277,
23,2,car,van,241,763,433,751,522,318,0.7548614,3,30,2,0.6091954022988506,
24,2,car,van,246,753,436,750,507,314,0.9711972,3,0,2,0.6193293885601578,
25,2,car,van,251,745,433,748,494,315,0.9901451,3,0,2,0.6376518218623481,
26,2,car,van,252,750,433,748,498,315,0.9852432,3,0,2,0.6325301204819277,
27,2,car,van,249,752,435,745,503,310,0.96325326,3,0,2,0.6163021868787276,
28,2,car,van,248,756,432,750,508,318,0.97406626,3,0,2,0.6259842519685039,
29,2,car,van,252,756,430,755,504,325,0.9911878,3,0,2,0.6448412698412699,
30,2,car,van,245,758,436,745,513,309,0.9737028,3,30,2,0.6023391812865497,
31,2,car,van,252,747,435,746,495,311,0.9611737,3,0,2,0.6282828282828283,
32,2,car,van,249,751,437,744,502,307,0.98877203,3,0,2,0.6115537848605578,
33,2,car,van,252,750,432,753,498,321,0.9831583,3,0,2,0.6445783132530121,
34,2,car,van,244,753,436,748,509,312,0.9376707,3,0,2,0.6129666011787819,
35,2,car,van,248,754,435,750,506,315,0.9802954,3,0,2,0.6225296442687747,
36,2,car,van,250,751,434,746,501,312,0.98451245,3,0,2,0.6227544910179641,
37,2,car,van,242,750,437,749,508,312,0.9798773,3,0,2,0.6141732283464567,
38,2,car,van,248,753,435,751,505,316,0.9665193,3,0,2,0.6257425742574257,
39,2,car,van,245,752,436,751,507,315,0.9661207,3,0,2,0.621301775147929,
40,2,car,van,242,759,432,752,517,320,0.97504705,3,0,2,0.6189555125725339,
41,2,car,van,247,751,432,750,504,318,0.98905355,3,0,2,0.6309523809523809,
42,2,car,van,247,759,432,746,512,314,0.9786135,3,0,2,0.61328125,
43,2,car,van,245,754,432,751,509,319,0.9489522,3,0,2,0.6267190569744597,
44,2,car,van,247,752,432,754,505,322,0.9881196,3,0,2,0.6376237623762376,
45,2,car,van,241,755,435,746,514,311,0.95389324,3,30,2,0.6050583657587548,
46,2,car,van,250,748,435,744,498,309,0.99397635,3,0,2,0.6204819277108434,
47,2,car,van,249,754,431,751,505,320,0.9686244,3,0,2,0.6336633663366337,
48,2,car,van,253,746,435,749,493,314,0.9651378,3,0,2,0.6369168356997972,
49,2,car,van,481,957,412,766,476,354,0.92372614,3,0,2,0.7436974789915967,
50,2,car,van,488,937,411,738,449,327,0.9417135,3,0,2,0.7282850779510023,
51,2,car,van,493,951,415,764,458,349,0.96600556,3,0,2,0.7620087336244541,
0,2,car,van,245,758,433,749,513,316,0.9734916,3,0,2,0.6159844054580896,
1,2,car,van,250,749,434,746,499,312,0.9798736,3,0,2,0.625250501002004,
2,2,car,van,247,751,437,742,504,305,0.9810417,3,30,2,0.6051587301587301,
3,2,car,van,248,755,436,749,507,313,0.97860545,3,0,2,0.6173570019723866,
4,2,car,van,244,758,439,741,514,302,0.97896934,3,30,2,0.5875486381322957,
5,2,car,van,165,1262,383,825,1097,442,0.22265343,3,0,2,0.4029170464904284,
6,2,car,van,249,754,434,748,505,314,0.9467645,3,0,2,0.4029170464904284,
7,2,car,van,164,1257,378,836,1093,458,0.43167558,3,30,2,0.41903019213174747,
8,2,car,van,242,762,435,750,520,315,0.8491126,3,30,2,0.41903019213174747,
9,2,car,van,244,752,438,745,508,307,0.9769956,3,30,2,0.6043307086614174,
10,2,car,van,165,1257,388,812,1092,424,0.2704866,3,0,2,0.3882783882783883,
11,2,car,van,253,750,437,746,497,309,0.9709216,3,0,2,0.3882783882783883,
12,2,car,van,158,1263,389,812,1105,423,0.27788413,3,30,2,0.38280542986425337,
13,2,car,van,248,759,437,744,511,307,0.95875967,3,30,2,0.38280542986425337,
14,2,car,van,247,752,438,745,505,307,0.98776233,3,30,2,0.6079207920792079,
15,2,car,van,249,754,435,745,505,310,0.98174345,3,0,2,0.6138613861386139,
16,2,car,van,243,749,435,752,506,317,0.97919697,3,0,2,0.6264822134387352,
17,2,car,van,165,1258,386,819,1093,433,0.2378989,3,0,2,0.39615736505032023,
18,2,car,van,248,756,432,751,508,319,0.9556341,3,0,2,0.39615736505032023,
19,2,car,van,138,1285,388,830,1147,442,0.22838312,3,0,2,0.3853530950305144,
20,2,car,van,248,753,436,745,505,309,0.91183275,3,0,2,0.3853530950305144,
21,2,car,van,251,745,436,749,494,313,0.98894763,3,0,2,0.6336032388663968,
22,2,car,van,249,749,436,744,500,308,0.9823882,3,0,2,0.616,
23,2,car,van,246,751,436,753,505,317,0.9723565,3,0,2,0.6277227722772277,
24,2,car,van,241,763,433,751,522,318,0.7548614,3,30,2,0.6091954022988506,
25,2,car,van,246,753,436,750,507,314,0.9711972,3,0,2,0.6193293885601578,
26,2,car,van,251,745,433,748,494,315,0.9901451,3,0,2,0.6376518218623481,
27,2,car,van,252,750,433,748,498,315,0.9852432,3,0,2,0.6325301204819277,
28,2,car,van,249,752,435,745,503,310,0.96325326,3,0,2,0.6163021868787276,
29,2,car,van,248,756,432,750,508,318,0.97406626,3,0,2,0.6259842519685039,
30,2,car,van,252,756,430,755,504,325,0.9911878,3,0,2,0.6448412698412699,
31,2,car,van,245,758,436,745,513,309,0.9737028,3,30,2,0.6023391812865497,
32,2,car,van,252,747,435,746,495,311,0.9611737,3,0,2,0.6282828282828283,
33,2,car,van,249,751,437,744,502,307,0.98877203,3,0,2,0.6115537848605578,
34,2,car,van,252,750,432,753,498,321,0.9831583,3,0,2,0.6445783132530121,
35,2,car,van,244,753,436,748,509,312,0.9376707,3,0,2,0.6129666011787819,
36,2,car,van,248,754,435,750,506,315,0.9802954,3,0,2,0.6225296442687747,
37,2,car,van,250,751,434,746,501,312,0.98451245,3,0,2,0.6227544910179641,
38,2,car,van,242,750,437,749,508,312,0.9798773,3,0,2,0.6141732283464567,
39,2,car,van,248,753,435,751,505,316,0.9665193,3,0,2,0.6257425742574257,
40,2,car,van,245,752,436,751,507,315,0.9661207,3,0,2,0.621301775147929,
41,2,car,van,242,759,432,752,517,320,0.97504705,3,0,2,0.6189555125725339,
42,2,car,van,247,751,432,750,504,318,0.98905355,3,0,2,0.6309523809523809,
43,2,car,van,247,759,432,746,512,314,0.9786135,3,0,2,0.61328125,
44,2,car,van,245,754,432,751,509,319,0.9489522,3,0,2,0.6267190569744597,
45,2,car,van,247,752,432,754,505,322,0.9881196,3,0,2,0.6376237623762376,
46,2,car,van,241,755,435,746,514,311,0.95389324,3,30,2,0.6050583657587548,
47,2,car,van,250,748,435,744,498,309,0.99397635,3,0,2,0.6204819277108434,
48,2,car,van,249,754,431,751,505,320,0.9686244,3,0,2,0.6336633663366337,
49,2,car,van,253,746,435,749,493,314,0.9651378,3,0,2,0.6369168356997972,
50,2,car,van,481,957,412,766,476,354,0.92372614,3,0,2,0.7436974789915967,
51,2,car,van,488,937,411,738,449,327,0.9417135,3,0,2,0.7282850779510023,
52,2,car,van,493,951,415,764,458,349,0.96600556,3,0,2,0.7620087336244541,
0,2,car,van,144,1270,384,833,1126,449,0.22333507,3,30,2,0.3987566607460036,
1,2,car,van,243,753,438,744,510,306,0.91827255,3,30,2,0.3987566607460036,
2,2,car,van,245,758,433,749,513,316,0.9734916,3,0,2,0.6159844054580896,
3,2,car,van,250,749,434,746,499,312,0.9798736,3,0,2,0.625250501002004,
4,2,car,van,247,751,437,742,504,305,0.9810417,3,30,2,0.6051587301587301,
5,2,car,van,248,755,436,749,507,313,0.97860545,3,0,2,0.6173570019723866,
6,2,car,van,244,758,439,741,514,302,0.97896934,3,30,2,0.5875486381322957,
7,2,car,van,165,1262,383,825,1097,442,0.22265343,3,0,2,0.4029170464904284,
8,2,car,van,249,754,434,748,505,314,0.9467645,3,0,2,0.4029170464904284,
9,2,car,van,164,1257,378,836,1093,458,0.43167558,3,30,2,0.41903019213174747,
10,2,car,van,242,762,435,750,520,315,0.8491126,3,30,2,0.41903019213174747,
11,2,car,van,244,752,438,745,508,307,0.9769956,3,30,2,0.6043307086614174,
12,2,car,van,165,1257,388,812,1092,424,0.2704866,3,0,2,0.3882783882783883,
13,2,car,van,253,750,437,746,497,309,0.9709216,3,0,2,0.3882783882783883,
14,2,car,van,158,1263,389,812,1105,423,0.27788413,3,30,2,0.38280542986425337,
15,2,car,van,248,759,437,744,511,307,0.95875967,3,30,2,0.38280542986425337,
16,2,car,van,247,752,438,745,505,307,0.98776233,3,30,2,0.6079207920792079,
17,2,car,van,249,754,435,745,505,310,0.98174345,3,0,2,0.6138613861386139,
18,2,car,van,243,749,435,752,506,317,0.97919697,3,0,2,0.6264822134387352,
19,2,car,van,165,1258,386,819,1093,433,0.2378989,3,0,2,0.39615736505032023,
20,2,car,van,248,756,432,751,508,319,0.9556341,3,0,2,0.39615736505032023,
21,2,car,van,138,1285,388,830,1147,442,0.22838312,3,0,2,0.3853530950305144,
22,2,car,van,248,753,436,745,505,309,0.91183275,3,0,2,0.3853530950305144,
23,2,car,van,251,745,436,749,494,313,0.98894763,3,0,2,0.6336032388663968,
24,2,car,van,249,749,436,744,500,308,0.9823882,3,0,2,0.616,
25,2,car,van,246,751,436,753,505,317,0.9723565,3,0,2,0.6277227722772277,
26,2,car,van,241,763,433,751,522,318,0.7548614,3,30,2,0.6091954022988506,
27,2,car,van,246,753,436,750,507,314,0.9711972,3,0,2,0.6193293885601578,
28,2,car,van,251,745,433,748,494,315,0.9901451,3,0,2,0.6376518218623481,
29,2,car,van,252,750,433,748,498,315,0.9852432,3,0,2,0.6325301204819277,
30,2,car,van,249,752,435,745,503,310,0.96325326,3,0,2,0.6163021868787276,
31,2,car,van,248,756,432,750,508,318,0.97406626,3,0,2,0.6259842519685039,
32,2,car,van,252,756,430,755,504,325,0.9911878,3,0,2,0.6448412698412699,
33,2,car,van,245,758,436,745,513,309,0.9737028,3,30,2,0.6023391812865497,
34,2,car,van,252,747,435,746,495,311,0.9611737,3,0,2,0.6282828282828283,
35,2,car,van,249,751,437,744,502,307,0.98877203,3,0,2,0.6115537848605578,
36,2,car,van,252,750,432,753,498,321,0.9831583,3,0,2,0.6445783132530121,
37,2,car,van,244,753,436,748,509,312,0.9376707,3,0,2,0.6129666011787819,
38,2,car,van,248,754,435,750,506,315,0.9802954,3,0,2,0.6225296442687747,
39,2,car,van,250,751,434,746,501,312,0.98451245,3,0,2,0.6227544910179641,
40,2,car,van,242,750,437,749,508,312,0.9798773,3,0,2,0.6141732283464567,
41,2,car,van,248,753,435,751,505,316,0.9665193,3,0,2,0.6257425742574257,
42,2,car,van,245,752,436,751,507,315,0.9661207,3,0,2,0.621301775147929,
43,2,car,van,242,759,432,752,517,320,0.97504705,3,0,2,0.6189555125725339,
44,2,car,van,247,751,432,750,504,318,0.98905355,3,0,2,0.6309523809523809,
45,2,car,van,247,759,432,746,512,314,0.9786135,3,0,2,0.61328125,
46,2,car,van,245,754,432,751,509,319,0.9489522,3,0,2,0.6267190569744597,
47,2,car,van,247,752,432,754,505,322,0.9881196,3,0,2,0.6376237623762376,
48,2,car,van,241,755,435,746,514,311,0.95389324,3,30,2,0.6050583657587548,
49,2,car,van,250,748,435,744,498,309,0.99397635,3,0,2,0.6204819277108434,
50,2,car,van,249,754,431,751,505,320,0.9686244,3,0,2,0.6336633663366337,
51,2,car,van,253,746,435,749,493,314,0.9651378,3,0,2,0.6369168356997972,
52,2,car,van,481,957,412,766,476,354,0.92372614,3,0,2,0.7436974789915967,
53,2,car,van,488,937,411,738,449,327,0.9417135,3,0,2,0.7282850779510023,
54,2,car,van,493,951,415,764,458,349,0.96600556,3,0,2,0.7620087336244541,
0,2,car,van,257,748,433,747,491,314,0.98516905,3,0,2,0.639511201629328,
1,2,car,van,144,1270,384,833,1126,449,0.22333507,3,30,2,0.3987566607460036,
2,2,car,van,243,753,438,744,510,306,0.91827255,3,30,2,0.3987566607460036,
3,2,car,van,245,758,433,749,513,316,0.9734916,3,0,2,0.6159844054580896,
4,2,car,van,250,749,434,746,499,312,0.9798736,3,0,2,0.625250501002004,
5,2,car,van,247,751,437,742,504,305,0.9810417,3,30,2,0.6051587301587301,
6,2,car,van,248,755,436,749,507,313,0.97860545,3,0,2,0.6173570019723866,
7,2,car,van,244,758,439,741,514,302,0.97896934,3,30,2,0.5875486381322957,
8,2,car,van,165,1262,383,825,1097,442,0.22265343,3,0,2,0.4029170464904284,
9,2,car,van,249,754,434,748,505,314,0.9467645,3,0,2,0.4029170464904284,
10,2,car,van,164,1257,378,836,1093,458,0.43167558,3,30,2,0.41903019213174747,
11,2,car,van,242,762,435,750,520,315,0.8491126,3,30,2,0.41903019213174747,
12,2,car,van,244,752,438,745,508,307,0.9769956,3,30,2,0.6043307086614174,
13,2,car,van,165,1257,388,812,1092,424,0.2704866,3,0,2,0.3882783882783883,
14,2,car,van,253,750,437,746,497,309,0.9709216,3,0,2,0.3882783882783883,
15,2,car,van,158,1263,389,812,1105,423,0.27788413,3,30,2,0.38280542986425337,
16,2,car,van,248,759,437,744,511,307,0.95875967,3,30,2,0.38280542986425337,
17,2,car,van,247,752,438,745,505,307,0.98776233,3,30,2,0.6079207920792079,
18,2,car,van,249,754,435,745,505,310,0.98174345,3,0,2,0.6138613861386139,
19,2,car,van,243,749,435,752,506,317,0.97919697,3,0,2,0.6264822134387352,
20,2,car,van,165,1258,386,819,1093,433,0.2378989,3,0,2,0.39615736505032023,
21,2,car,van,248,756,432,751,508,319,0.9556341,3,0,2,0.39615736505032023,
22,2,car,van,138,1285,388,830,1147,442,0.22838312,3,0,2,0.3853530950305144,
23,2,car,van,248,753,436,745,505,309,0.91183275,3,0,2,0.3853530950305144,
24,2,car,van,251,745,436,749,494,313,0.98894763,3,0,2,0.6336032388663968,
25,2,car,van,249,749,436,744,500,308,0.9823882,3,0,2,0.616,
26,2,car,van,246,751,436,753,505,317,0.9723565,3,0,2,0.6277227722772277,
27,2,car,van,241,763,433,751,522,318,0.7548614,3,30,2,0.6091954022988506,
28,2,car,van,246,753,436,750,507,314,0.9711972,3,0,2,0.6193293885601578,
29,2,car,van,251,745,433,748,494,315,0.9901451,3,0,2,0.6376518218623481,
30,2,car,van,252,750,433,748,498,315,0.9852432,3,0,2,0.6325301204819277,
31,2,car,van,249,752,435,745,503,310,0.96325326,3,0,2,0.6163021868787276,
32,2,car,van,248,756,432,750,508,318,0.97406626,3,0,2,0.6259842519685039,
33,2,car,van,252,756,430,755,504,325,0.9911878,3,0,2,0.6448412698412699,
34,2,car,van,245,758,436,745,513,309,0.9737028,3,30,2,0.6023391812865497,
35,2,car,van,252,747,435,746,495,311,0.9611737,3,0,2,0.6282828282828283,
36,2,car,van,249,751,437,744,502,307,0.98877203,3,0,2,0.6115537848605578,
37,2,car,van,252,750,432,753,498,321,0.9831583,3,0,2,0.6445783132530121,
38,2,car,van,244,753,436,748,509,312,0.9376707,3,0,2,0.6129666011787819,
39,2,car,van,248,754,435,750,506,315,0.9802954,3,0,2,0.6225296442687747,
40,2,car,van,250,751,434,746,501,312,0.98451245,3,0,2,0.6227544910179641,
41,2,car,van,242,750,437,749,508,312,0.9798773,3,0,2,0.6141732283464567,
42,2,car,van,248,753,435,751,505,316,0.9665193,3,0,2,0.6257425742574257,
43,2,car,van,245,752,436,751,507,315,0.9661207,3,0,2,0.621301775147929,
44,2,car,van,242,759,432,752,517,320,0.97504705,3,0,2,0.6189555125725339,
45,2,car,van,247,751,432,750,504,318,0.98905355,3,0,2,0.6309523809523809,
46,2,car,van,247,759,432,746,512,314,0.9786135,3,0,2,0.61328125,
47,2,car,van,245,754,432,751,509,319,0.9489522,3,0,2,0.6267190569744597,
48,2,car,van,247,752,432,754,505,322,0.9881196,3,0,2,0.6376237623762376,
49,2,car,van,241,755,435,746,514,311,0.95389324,3,30,2,0.6050583657587548,
50,2,car,van,250,748,435,744,498,309,0.99397635,3,0,2,0.6204819277108434,
51,2,car,van,249,754,431,751,505,320,0.9686244,3,0,2,0.6336633663366337,
52,2,car,van,253,746,435,749,493,314,0.9651378,3,0,2,0.6369168356997972,
53,2,car,van,481,957,412,766,476,354,0.92372614,3,0,2,0.7436974789915967,
54,2,car,van,488,937,411,738,449,327,0.9417135,3,0,2,0.7282850779510023,
55,2,car,van,493,951,415,764,458,349,0.96600556,3,0,2,0.7620087336244541,
0,2,car,van,251,754,441,741,503,300,0.9527379,3,30,2,0.5964214711729622,
1,2,car,van,257,748,433,747,491,314,0.98516905,3,0,2,0.639511201629328,
2,2,car,van,144,1270,384,833,1126,449,0.22333507,3,30,2,0.3987566607460036,
3,2,car,van,243,753,438,744,510,306,0.91827255,3,30,2,0.3987566607460036,
4,2,car,van,245,758,433,749,513,316,0.9734916,3,0,2,0.6159844054580896,
5,2,car,van,250,749,434,746,499,312,0.9798736,3,0,2,0.625250501002004,
6,2,car,van,247,751,437,742,504,305,0.9810417,3,30,2,0.6051587301587301,
7,2,car,van,248,755,436,749,507,313,0.97860545,3,0,2,0.6173570019723866,
8,2,car,van,244,758,439,741,514,302,0.97896934,3,30,2,0.5875486381322957,
9,2,car,van,165,1262,383,825,1097,442,0.22265343,3,0,2,0.4029170464904284,
10,2,car,van,249,754,434,748,505,314,0.9467645,3,0,2,0.4029170464904284,
11,2,car,van,164,1257,378,836,1093,458,0.43167558,3,30,2,0.41903019213174747,
12,2,car,van,242,762,435,750,520,315,0.8491126,3,30,2,0.41903019213174747,
13,2,car,van,244,752,438,745,508,307,0.9769956,3,30,2,0.6043307086614174,
14,2,car,van,165,1257,388,812,1092,424,0.2704866,3,0,2,0.3882783882783883,
15,2,car,van,253,750,437,746,497,309,0.9709216,3,0,2,0.3882783882783883,
16,2,car,van,158,1263,389,812,1105,423,0.27788413,3,30,2,0.38280542986425337,
17,2,car,van,248,759,437,744,511,307,0.95875967,3,30,2,0.38280542986425337,
18,2,car,van,247,752,438,745,505,307,0.98776233,3,30,2,0.6079207920792079,
19,2,car,van,249,754,435,745,505,310,0.98174345,3,0,2,0.6138613861386139,
20,2,car,van,243,749,435,752,506,317,0.97919697,3,0,2,0.6264822134387352,
21,2,car,van,165,1258,386,819,1093,433,0.2378989,3,0,2,0.39615736505032023,
22,2,car,van,248,756,432,751,508,319,0.9556341,3,0,2,0.39615736505032023,
23,2,car,van,138,1285,388,830,1147,442,0.22838312,3,0,2,0.3853530950305144,
24,2,car,van,248,753,436,745,505,309,0.91183275,3,0,2,0.3853530950305144,
25,2,car,van,251,745,436,749,494,313,0.98894763,3,0,2,0.6336032388663968,
26,2,car,van,249,749,436,744,500,308,0.9823882,3,0,2,0.616,
27,2,car,van,246,751,436,753,505,317,0.9723565,3,0,2,0.6277227722772277,
28,2,car,van,241,763,433,751,522,318,0.7548614,3,30,2,0.6091954022988506,
29,2,car,van,246,753,436,750,507,314,0.9711972,3,0,2,0.6193293885601578,
30,2,car,van,251,745,433,748,494,315,0.9901451,3,0,2,0.6376518218623481,
31,2,car,van,252,750,433,748,498,315,0.9852432,3,0,2,0.6325301204819277,
32,2,car,van,249,752,435,745,503,310,0.96325326,3,0,2,0.6163021868787276,
33,2,car,van,248,756,432,750,508,318,0.97406626,3,0,2,0.6259842519685039,
34,2,car,van,252,756,430,755,504,325,0.9911878,3,0,2,0.6448412698412699,
35,2,car,van,245,758,436,745,513,309,0.9737028,3,30,2,0.6023391812865497,
36,2,car,van,252,747,435,746,495,311,0.9611737,3,0,2,0.6282828282828283,
37,2,car,van,249,751,437,744,502,307,0.98877203,3,0,2,0.6115537848605578,
38,2,car,van,252,750,432,753,498,321,0.9831583,3,0,2,0.6445783132530121,
39,2,car,van,244,753,436,748,509,312,0.9376707,3,0,2,0.6129666011787819,
40,2,car,van,248,754,435,750,506,315,0.9802954,3,0,2,0.6225296442687747,
41,2,car,van,250,751,434,746,501,312,0.98451245,3,0,2,0.6227544910179641,
42,2,car,van,242,750,437,749,508,312,0.9798773,3,0,2,0.6141732283464567,
43,2,car,van,248,753,435,751,505,316,0.9665193,3,0,2,0.6257425742574257,
44,2,car,van,245,752,436,751,507,315,0.9661207,3,0,2,0.621301775147929,
45,2,car,van,242,759,432,752,517,320,0.97504705,3,0,2,0.6189555125725339,
46,2,car,van,247,751,432,750,504,318,0.98905355,3,0,2,0.6309523809523809,
47,2,car,van,247,759,432,746,512,314,0.9786135,3,0,2,0.61328125,
48,2,car,van,245,754,432,751,509,319,0.9489522,3,0,2,0.6267190569744597,
49,2,car,van,247,752,432,754,505,322,0.9881196,3,0,2,0.6376237623762376,
50,2,car,van,241,755,435,746,514,311,0.95389324,3,30,2,0.6050583657587548,
51,2,car,van,250,748,435,744,498,309,0.99397635,3,0,2,0.6204819277108434,
52,2,car,van,249,754,431,751,505,320,0.9686244,3,0,2,0.6336633663366337,
53,2,car,van,253,746,435,749,493,314,0.9651378,3,0,2,0.6369168356997972,
54,2,car,van,481,957,412,766,476,354,0.92372614,3,0,2,0.7436974789915967,
55,2,car,van,488,937,411,738,449,327,0.9417135,3,0,2,0.7282850779510023,
56,2,car,van,493,951,415,764,458,349,0.96600556,3,0,2,0.7620087336244541,
0,2,car,van,176,1243,386,823,1067,437,0.2645272,3,30,2,0.4095595126522962,
1,2,car,van,245,753,439,745,508,306,0.97223705,3,30,2,0.4095595126522962,
2,2,car,van,251,754,441,741,503,300,0.9527379,3,30,2,0.5964214711729622,
3,2,car,van,257,748,433,747,491,314,0.98516905,3,0,2,0.639511201629328,
4,2,car,van,144,1270,384,833,1126,449,0.22333507,3,30,2,0.3987566607460036,
5,2,car,van,243,753,438,744,510,306,0.91827255,3,30,2,0.3987566607460036,
6,2,car,van,245,758,433,749,513,316,0.9734916,3,0,2,0.6159844054580896,
7,2,car,van,250,749,434,746,499,312,0.9798736,3,0,2,0.625250501002004,
8,2,car,van,247,751,437,742,504,305,0.9810417,3,30,2,0.6051587301587301,
9,2,car,van,248,755,436,749,507,313,0.97860545,3,0,2,0.6173570019723866,
10,2,car,van,244,758,439,741,514,302,0.97896934,3,30,2,0.5875486381322957,
11,2,car,van,165,1262,383,825,1097,442,0.22265343,3,0,2,0.4029170464904284,
12,2,car,van,249,754,434,748,505,314,0.9467645,3,0,2,0.4029170464904284,
13,2,car,van,164,1257,378,836,1093,458,0.43167558,3,30,2,0.41903019213174747,
14,2,car,van,242,762,435,750,520,315,0.8491126,3,30,2,0.41903019213174747,
15,2,car,van,244,752,438,745,508,307,0.9769956,3,30,2,0.6043307086614174,
16,2,car,van,165,1257,388,812,1092,424,0.2704866,3,0,2,0.3882783882783883,
17,2,car,van,253,750,437,746,497,309,0.9709216,3,0,2,0.3882783882783883,
18,2,car,van,158,1263,389,812,1105,423,0.27788413,3,30,2,0.38280542986425337,
19,2,car,van,248,759,437,744,511,307,0.95875967,3,30,2,0.38280542986425337,
20,2,car,van,247,752,438,745,505,307,0.98776233,3,30,2,0.6079207920792079,
21,2,car,van,249,754,435,745,505,310,0.98174345,3,0,2,0.6138613861386139,
22,2,car,van,243,749,435,752,506,317,0.97919697,3,0,2,0.6264822134387352,
23,2,car,van,165,1258,386,819,1093,433,0.2378989,3,0,2,0.39615736505032023,
24,2,car,van,248,756,432,751,508,319,0.9556341,3,0,2,0.39615736505032023,
25,2,car,van,138,1285,388,830,1147,442,0.22838312,3,0,2,0.3853530950305144,
26,2,car,van,248,753,436,745,505,309,0.91183275,3,0,2,0.3853530950305144,
27,2,car,van,251,745,436,749,494,313,0.98894763,3,0,2,0.6336032388663968,
28,2,car,van,249,749,436,744,500,308,0.9823882,3,0,2,0.616,
29,2,car,van,246,751,436,753,505,317,0.9723565,3,0,2,0.6277227722772277,
30,2,car,van,241,763,433,751,522,318,0.7548614,3,30,2,0.6091954022988506,
31,2,car,van,246,753,436,750,507,314,0.9711972,3,0,2,0.6193293885601578,
32,2,car,van,251,745,433,748,494,315,0.9901451,3,0,2,0.6376518218623481,
33,2,car,van,252,750,433,748,498,315,0.9852432,3,0,2,0.6325301204819277,
34,2,car,van,249,752,435,745,503,310,0.96325326,3,0,2,0.6163021868787276,
35,2,car,van,248,756,432,750,508,318,0.97406626,3,0,2,0.6259842519685039,
36,2,car,van,252,756,430,755,504,325,0.9911878,3,0,2,0.6448412698412699,
37,2,car,van,245,758,436,745,513,309,0.9737028,3,30,2,0.6023391812865497,
38,2,car,van,252,747,435,746,495,311,0.9611737,3,0,2,0.6282828282828283,
39,2,car,van,249,751,437,744,502,307,0.98877203,3,0,2,0.6115537848605578,
40,2,car,van,252,750,432,753,498,321,0.9831583,3,0,2,0.6445783132530121,
41,2,car,van,244,753,436,748,509,312,0.9376707,3,0,2,0.6129666011787819,
42,2,car,van,248,754,435,750,506,315,0.9802954,3,0,2,0.6225296442687747,
43,2,car,van,250,751,434,746,501,312,0.98451245,3,0,2,0.6227544910179641,
44,2,car,van,242,750,437,749,508,312,0.9798773,3,0,2,0.6141732283464567,
45,2,car,van,248,753,435,751,505,316,0.9665193,3,0,2,0.6257425742574257,
46,2,car,van,245,752,436,751,507,315,0.9661207,3,0,2,0.621301775147929,
47,2,car,van,242,759,432,752,517,320,0.97504705,3,0,2,0.6189555125725339,
48,2,car,van,247,751,432,750,504,318,0.98905355,3,0,2,0.6309523809523809,
49,2,car,van,247,759,432,746,512,314,0.9786135,3,0,2,0.61328125,
50,2,car,van,245,754,432,751,509,319,0.9489522,3,0,2,0.6267190569744597,
51,2,car,van,247,752,432,754,505,322,0.9881196,3,0,2,0.6376237623762376,
52,2,car,van,241,755,435,746,514,311,0.95389324,3,30,2,0.6050583657587548,
53,2,car,van,250,748,435,744,498,309,0.99397635,3,0,2,0.6204819277108434,
54,2,car,van,249,754,431,751,505,320,0.9686244,3,0,2,0.6336633663366337,
55,2,car,van,253,746,435,749,493,314,0.9651378,3,0,2,0.6369168356997972,
56,2,car,van,481,957,412,766,476,354,0.92372614,3,0,2,0.7436974789915967,
57,2,car,van,488,937,411,738,449,327,0.9417135,3,0,2,0.7282850779510023,
58,2,car,van,493,951,415,764,458,349,0.96600556,3,0,2,0.7620087336244541,
0,2,car,van,250,752,435,747,502,312,0.95223886,3,0,2,0.6215139442231076,
1,2,car,van,176,1243,386,823,1067,437,0.2645272,3,30,2,0.4095595126522962,
2,2,car,van,245,753,439,745,508,306,0.97223705,3,30,2,0.4095595126522962,
3,2,car,van,251,754,441,741,503,300,0.9527379,3,30,2,0.5964214711729622,
4,2,car,van,257,748,433,747,491,314,0.98516905,3,0,2,0.639511201629328,
5,2,car,van,144,1270,384,833,1126,449,0.22333507,3,30,2,0.3987566607460036,
6,2,car,van,243,753,438,744,510,306,0.91827255,3,30,2,0.3987566607460036,
7,2,car,van,245,758,433,749,513,316,0.9734916,3,0,2,0.6159844054580896,
8,2,car,van,250,749,434,746,499,312,0.9798736,3,0,2,0.625250501002004,
9,2,car,van,247,751,437,742,504,305,0.9810417,3,30,2,0.6051587301587301,
10,2,car,van,248,755,436,749,507,313,0.97860545,3,0,2,0.6173570019723866,
11,2,car,van,244,758,439,741,514,302,0.97896934,3,30,2,0.5875486381322957,
12,2,car,van,165,1262,383,825,1097,442,0.22265343,3,0,2,0.4029170464904284,
13,2,car,van,249,754,434,748,505,314,0.9467645,3,0,2,0.4029170464904284,
14,2,car,van,164,1257,378,836,1093,458,0.43167558,3,30,2,0.41903019213174747,
15,2,car,van,242,762,435,750,520,315,0.8491126,3,30,2,0.41903019213174747,
16,2,car,van,244,752,438,745,508,307,0.9769956,3,30,2,0.6043307086614174,
17,2,car,van,165,1257,388,812,1092,424,0.2704866,3,0,2,0.3882783882783883,
18,2,car,van,253,750,437,746,497,309,0.9709216,3,0,2,0.3882783882783883,
19,2,car,van,158,1263,389,812,1105,423,0.27788413,3,30,2,0.38280542986425337,
20,2,car,van,248,759,437,744,511,307,0.95875967,3,30,2,0.38280542986425337,
21,2,car,van,247,752,438,745,505,307,0.98776233,3,30,2,0.6079207920792079,
22,2,car,van,249,754,435,745,505,310,0.98174345,3,0,2,0.6138613861386139,
23,2,car,van,243,749,435,752,506,317,0.97919697,3,0,2,0.6264822134387352,
24,2,car,van,165,1258,386,819,1093,433,0.2378989,3,0,2,0.39615736505032023,
25,2,car,van,248,756,432,751,508,319,0.9556341,3,0,2,0.39615736505032023,
26,2,car,van,138,1285,388,830,1147,442,0.22838312,3,0,2,0.3853530950305144,
27,2,car,van,248,753,436,745,505,309,0.91183275,3,0,2,0.3853530950305144,
28,2,car,van,251,745,436,749,494,313,0.98894763,3,0,2,0.6336032388663968,
29,2,car,van,249,749,436,744,500,308,0.9823882,3,0,2,0.616,
30,2,car,van,246,751,436,753,505,317,0.9723565,3,0,2,0.6277227722772277,
31,2,car,van,241,763,433,751,522,318,0.7548614,3,30,2,0.6091954022988506,
32,2,car,van,246,753,436,750,507,314,0.9711972,3,0,2,0.6193293885601578,
33,2,car,van,251,745,433,748,494,315,0.9901451,3,0,2,0.6376518218623481,
34,2,car,van,252,750,433,748,498,315,0.9852432,3,0,2,0.6325301204819277,
35,2,car,van,249,752,435,745,503,310,0.96325326,3,0,2,0.6163021868787276,
36,2,car,van,248,756,432,750,508,318,0.97406626,3,0,2,0.6259842519685039,
37,2,car,van,252,756,430,755,504,325,0.9911878,3,0,2,0.6448412698412699,
38,2,car,van,245,758,436,745,513,309,0.9737028,3,30,2,0.6023391812865497,
39,2,car,van,252,747,435,746,495,311,0.9611737,3,0,2,0.6282828282828283,
40,2,car,van,249,751,437,744,502,307,0.98877203,3,0,2,0.6115537848605578,
41,2,car,van,252,750,432,753,498,321,0.9831583,3,0,2,0.6445783132530121,
42,2,car,van,244,753,436,748,509,312,0.9376707,3,0,2,0.6129666011787819,
43,2,car,van,248,754,435,750,506,315,0.9802954,3,0,2,0.6225296442687747,
44,2,car,van,250,751,434,746,501,312,0.98451245,3,0,2,0.6227544910179641,
45,2,car,van,242,750,437,749,508,312,0.9798773,3,0,2,0.6141732283464567,
46,2,car,van,248,753,435,751,505,316,0.9665193,3,0,2,0.6257425742574257,
47,2,car,van,245,752,436,751,507,315,0.9661207,3,0,2,0.621301775147929,
48,2,car,van,242,759,432,752,517,320,0.97504705,3,0,2,0.6189555125725339,
49,2,car,van,247,751,432,750,504,318,0.98905355,3,0,2,0.6309523809523809,
50,2,car,van,247,759,432,746,512,314,0.9786135,3,0,2,0.61328125,
51,2,car,van,245,754,432,751,509,319,0.9489522,3,0,2,0.6267190569744597,
52,2,car,van,247,752,432,754,505,322,0.9881196,3,0,2,0.6376237623762376,
53,2,car,van,241,755,435,746,514,311,0.95389324,3,30,2,0.6050583657587548,
54,2,car,van,250,748,435,744,498,309,0.99397635,3,0,2,0.6204819277108434,
55,2,car,van,249,754,431,751,505,320,0.9686244,3,0,2,0.6336633663366337,
56,2,car,van,253,746,435,749,493,314,0.9651378,3,0,2,0.6369168356997972,
57,2,car,van,481,957,412,766,476,354,0.92372614,3,0,2,0.7436974789915967,
58,2,car,van,488,937,411,738,449,327,0.9417135,3,0,2,0.7282850779510023,
59,2,car,van,493,951,415,764,458,349,0.96600556,3,0,2,0.7620087336244541,
