,cid,label,vehicle,left,right,top,bottom,width,height,score,distance_estimate,angle_estimate,real_distance,ratio,elapsed_time
0,2,car,van,158,1263,389,812,1105,423,0.27788413,3,30,3,0.38280542986425337,
1,2,car,van,248,759,437,744,511,307,0.95875967,3,30,3,0.38280542986425337,
0,2,car,van,165,1262,383,825,1097,442,0.22265343,3,0,3,0.4029170464904284,
1,2,car,van,249,754,434,748,505,314,0.9467645,3,0,3,0.4029170464904284,
2,2,car,van,158,1263,389,812,1105,423,0.27788413,3,30,3,0.38280542986425337,
3,2,car,van,248,759,437,744,511,307,0.95875967,3,30,3,0.38280542986425337,
0,2,car,van,392,739,446,692,347,246,0.9838788,3,0,3,0.7089337175792507,
1,2,car,van,165,1262,383,825,1097,442,0.22265343,3,0,3,0.4029170464904284,
2,2,car,van,249,754,434,748,505,314,0.9467645,3,0,3,0.4029170464904284,
3,2,car,van,158,1263,389,812,1105,423,0.27788413,3,30,3,0.38280542986425337,
4,2,car,van,248,759,437,744,511,307,0.95875967,3,30,3,0.38280542986425337,
0,2,car,van,393,740,447,695,347,248,0.97791225,3,0,3,0.7146974063400576,
1,2,car,van,392,739,446,692,347,246,0.9838788,3,0,3,0.7089337175792507,
2,2,car,van,165,1262,383,825,1097,442,0.22265343,3,0,3,0.4029170464904284,
3,2,car,van,249,754,434,748,505,314,0.9467645,3,0,3,0.4029170464904284,
4,2,car,van,158,1263,389,812,1105,423,0.27788413,3,30,3,0.38280542986425337,
5,2,car,van,248,759,437,744,511,307,0.95875967,3,30,3,0.38280542986425337,
0,2,car,van,394,731,445,696,337,251,0.98827523,3,0,3,0.744807121661721,
1,2,car,van,393,740,447,695,347,248,0.97791225,3,0,3,0.7146974063400576,
2,2,car,van,392,739,446,692,347,246,0.9838788,3,0,3,0.7089337175792507,
3,2,car,van,165,1262,383,825,1097,442,0.22265343,3,0,3,0.4029170464904284,
4,2,car,van,249,754,434,748,505,314,0.9467645,3,0,3,0.4029170464904284,
5,2,car,van,158,1263,389,812,1105,423,0.27788413,3,30,3,0.38280542986425337,
6,2,car,van,248,759,437,744,511,307,0.95875967,3,30,3,0.38280542986425337,
0,2,car,van,391,731,448,693,340,245,0.9821532,3,0,3,0.7205882352941176,
1,2,car,van,394,731,445,696,337,251,0.98827523,3,0,3,0.744807121661721,
2,2,car,van,393,740,447,695,347,248,0.97791225,3,0,3,0.7146974063400576,
3,2,car,van,392,739,446,692,347,246,0.9838788,3,0,3,0.7089337175792507,
4,2,car,van,165,1262,383,825,1097,442,0.22265343,3,0,3,0.4029170464904284,
5,2,car,van,249,754,434,748,505,314,0.9467645,3,0,3,0.4029170464904284,
6,2,car,van,158,1263,389,812,1105,423,0.27788413,3,30,3,0.38280542986425337,
7,2,car,van,248,759,437,744,511,307,0.95875967,3,30,3,0.38280542986425337,
0,2,car,van,392,739,447,693,347,246,0.9871002,3,0,3,0.7089337175792507,
1,2,car,van,391,731,448,693,340,245,0.9821532,3,0,3,0.7205882352941176,
2,2,car,van,394,731,445,696,337,251,0.98827523,3,0,3,0.744807121661721,
3,2,car,van,393,740,447,695,347,248,0.97791225,3,0,3,0.7146974063400576,
4,2,car,van,392,739,446,692,347,246,0.9838788,3,0,3,0.7089337175792507,
5,2,car,van,165,1262,383,825,1097,442,0.22265343,3,0,3,0.4029170464904284,
6,2,car,van,249,754,434,748,505,314,0.9467645,3,0,3,0.4029170464904284,
7,2,car,van,158,1263,389,812,1105,423,0.27788413,3,30,3,0.38280542986425337,
8,2,car,van,248,759,437,744,511,307,0.95875967,3,30,3,0.38280542986425337,
0,2,car,van,390,734,447,695,344,248,0.97756964,3,0,3,0.7209302325581395,
1,2,car,van,392,739,447,693,347,246,0.9871002,3,0,3,0.7089337175792507,
2,2,car,van,391,731,448,693,340,245,0.9821532,3,0,3,0.7205882352941176,
3,2,car,van,394,731,445,696,337,251,0.98827523,3,0,3,0.744807121661721,
4,2,car,van,393,740,447,695,347,248,0.97791225,3,0,3,0.7146974063400576,
5,2,car,van,392,739,446,692,347,246,0.9838788,3,0,3,0.7089337175792507,
6,2,car,van,165,1262,383,825,1097,442,0.22265343,3,0,3,0.4029170464904284,
7,2,car,van,249,754,434,748,505,314,0.9467645,3,0,3,0.4029170464904284,
8,2,car,van,158,1263,389,812,1105,423,0.27788413,3,30,3,0.38280542986425337,
9,2,car,van,248,759,437,744,511,307,0.95875967,3,30,3,0.38280542986425337,
0,2,car,van,391,736,445,695,345,250,0.98718697,3,0,3,0.7246376811594203,
1,2,car,van,390,734,447,695,344,248,0.97756964,3,0,3,0.7209302325581395,
2,2,car,van,392,739,447,693,347,246,0.9871002,3,0,3,0.7089337175792507,
3,2,car,van,391,731,448,693,340,245,0.9821532,3,0,3,0.7205882352941176,
4,2,car,van,394,731,445,696,337,251,0.98827523,3,0,3,0.744807121661721,
5,2,car,van,393,740,447,695,347,248,0.97791225,3,0,3,0.7146974063400576,
6,2,car,van,392,739,446,692,347,246,0.9838788,3,0,3,0.7089337175792507,
7,2,car,van,165,1262,383,825,1097,442,0.22265343,3,0,3,0.4029170464904284,
8,2,car,van,249,754,434,748,505,314,0.9467645,3,0,3,0.4029170464904284,
9,2,car,van,158,1263,389,812,1105,423,0.27788413,3,30,3,0.38280542986425337,
10,2,car,van,248,759,437,744,511,307,0.95875967,3,30,3,0.38280542986425337,
0,2,car,van,391,735,447,697,344,250,0.9818368,3,0,3,0.7267441860465116,
1,2,car,van,391,736,445,695,345,250,0.98718697,3,0,3,0.7246376811594203,
2,2,car,van,390,734,447,695,344,248,0.97756964,3,0,3,0.7209302325581395,
3,2,car,van,392,739,447,693,347,246,0.9871002,3,0,3,0.7089337175792507,
4,2,car,van,391,731,448,693,340,245,0.9821532,3,0,3,0.7205882352941176,
5,2,car,van,394,731,445,696,337,251,0.98827523,3,0,3,0.744807121661721,
6,2,car,van,393,740,447,695,347,248,0.97791225,3,0,3,0.7146974063400576,
7,2,car,van,392,739,446,692,347,246,0.9838788,3,0,3,0.7089337175792507,
8,2,car,van,165,1262,383,825,1097,442,0.22265343,3,0,3,0.4029170464904284,
9,2,car,van,249,754,434,748,505,314,0.9467645,3,0,3,0.4029170464904284,
10,2,car,van,158,1263,389,812,1105,423,0.27788413,3,30,3,0.38280542986425337,
11,2,car,van,248,759,437,744,511,307,0.95875967,3,30,3,0.38280542986425337,
0,2,car,van,396,741,445,695,345,250,0.9892166,3,0,3,0.7246376811594203,
1,2,car,van,391,735,447,697,344,250,0.9818368,3,0,3,0.7267441860465116,
2,2,car,van,391,736,445,695,345,250,0.98718697,3,0,3,0.7246376811594203,
3,2,car,van,390,734,447,695,344,248,0.97756964,3,0,3,0.7209302325581395,
4,2,car,van,392,739,447,693,347,246,0.9871002,3,0,3,0.7089337175792507,
5,2,car,van,391,731,448,693,340,245,0.9821532,3,0,3,0.7205882352941176,
6,2,car,van,394,731,445,696,337,251,0.98827523,3,0,3,0.744807121661721,
7,2,car,van,393,740,447,695,347,248,0.97791225,3,0,3,0.7146974063400576,
8,2,car,van,392,739,446,692,347,246,0.9838788,3,0,3,0.7089337175792507,
9,2,car,van,165,1262,383,825,1097,442,0.22265343,3,0,3,0.4029170464904284,
10,2,car,van,249,754,434,748,505,314,0.9467645,3,0,3,0.4029170464904284,
11,2,car,van,158,1263,389,812,1105,423,0.27788413,3,30,3,0.38280542986425337,
12,2,car,van,248,759,437,744,511,307,0.95875967,3,30,3,0.38280542986425337,
0,2,car,van,396,735,445,695,339,250,0.9873077,3,0,3,0.7374631268436578,
1,2,car,van,396,741,445,695,345,250,0.9892166,3,0,3,0.7246376811594203,
2,2,car,van,391,735,447,697,344,250,0.9818368,3,0,3,0.7267441860465116,
3,2,car,van,391,736,445,695,345,250,0.98718697,3,0,3,0.7246376811594203,
4,2,car,van,390,734,447,695,344,248,0.97756964,3,0,3,0.7209302325581395,
5,2,car,van,392,739,447,693,347,246,0.9871002,3,0,3,0.7089337175792507,
6,2,car,van,391,731,448,693,340,245,0.9821532,3,0,3,0.7205882352941176,
7,2,car,van,394,731,445,696,337,251,0.98827523,3,0,3,0.744807121661721,
8,2,car,van,393,740,447,695,347,248,0.97791225,3,0,3,0.7146974063400576,
9,2,car,van,392,739,446,692,347,246,0.9838788,3,0,3,0.7089337175792507,
10,2,car,van,165,1262,383,825,1097,442,0.22265343,3,0,3,0.4029170464904284,
11,2,car,van,249,754,434,748,505,314,0.9467645,3,0,3,0.4029170464904284,
12,2,car,van,158,1263,389,812,1105,423,0.27788413,3,30,3,0.38280542986425337,
13,2,car,van,248,759,437,744,511,307,0.95875967,3,30,3,0.38280542986425337,
0,2,car,van,392,734,447,696,342,249,0.98804855,3,0,3,0.7280701754385965,
1,2,car,van,396,735,445,695,339,250,0.9873077,3,0,3,0.7374631268436578,
2,2,car,van,396,741,445,695,345,250,0.9892166,3,0,3,0.7246376811594203,
3,2,car,van,391,735,447,697,344,250,0.9818368,3,0,3,0.7267441860465116,
4,2,car,van,391,736,445,695,345,250,0.98718697,3,0,3,0.7246376811594203,
5,2,car,van,390,734,447,695,344,248,0.97756964,3,0,3,0.7209302325581395,
6,2,car,van,392,739,447,693,347,246,0.9871002,3,0,3,0.7089337175792507,
7,2,car,van,391,731,448,693,340,245,0.9821532,3,0,3,0.7205882352941176,
8,2,car,van,394,731,445,696,337,251,0.98827523,3,0,3,0.744807121661721,
9,2,car,van,393,740,447,695,347,248,0.97791225,3,0,3,0.7146974063400576,
10,2,car,van,392,739,446,692,347,246,0.9838788,3,0,3,0.7089337175792507,
11,2,car,van,165,1262,383,825,1097,442,0.22265343,3,0,3,0.4029170464904284,
12,2,car,van,249,754,434,748,505,314,0.9467645,3,0,3,0.4029170464904284,
13,2,car,van,158,1263,389,812,1105,423,0.27788413,3,30,3,0.38280542986425337,
14,2,car,van,248,759,437,744,511,307,0.95875967,3,30,3,0.38280542986425337,
0,2,car,van,394,730,446,696,336,250,0.9868613,3,0,3,0.7440476190476191,
1,2,car,van,392,734,447,696,342,249,0.98804855,3,0,3,0.7280701754385965,
2,2,car,van,396,735,445,695,339,250,0.9873077,3,0,3,0.7374631268436578,
3,2,car,van,396,741,445,695,345,250,0.9892166,3,0,3,0.7246376811594203,
4,2,car,van,391,735,447,697,344,250,0.9818368,3,0,3,0.7267441860465116,
5,2,car,van,391,736,445,695,345,250,0.98718697,3,0,3,0.7246376811594203,
6,2,car,van,390,734,447,695,344,248,0.97756964,3,0,3,0.7209302325581395,
7,2,car,van,392,739,447,693,347,246,0.9871002,3,0,3,0.7089337175792507,
8,2,car,van,391,731,448,693,340,245,0.9821532,3,0,3,0.7205882352941176,
9,2,car,van,394,731,445,696,337,251,0.98827523,3,0,3,0.744807121661721,
10,2,car,van,393,740,447,695,347,248,0.97791225,3,0,3,0.7146974063400576,
11,2,car,van,392,739,446,692,347,246,0.9838788,3,0,3,0.7089337175792507,
12,2,car,van,165,1262,383,825,1097,442,0.22265343,3,0,3,0.4029170464904284,
13,2,car,van,249,754,434,748,505,314,0.9467645,3,0,3,0.4029170464904284,
14,2,car,van,158,1263,389,812,1105,423,0.27788413,3,30,3,0.38280542986425337,
15,2,car,van,248,759,437,744,511,307,0.95875967,3,30,3,0.38280542986425337,
0,2,car,van,392,737,445,697,345,252,0.9894341,3,0,3,0.7304347826086957,
1,2,car,van,394,730,446,696,336,250,0.9868613,3,0,3,0.7440476190476191,
2,2,car,van,392,734,447,696,342,249,0.98804855,3,0,3,0.7280701754385965,
3,2,car,van,396,735,445,695,339,250,0.9873077,3,0,3,0.7374631268436578,
4,2,car,van,396,741,445,695,345,250,0.9892166,3,0,3,0.7246376811594203,
5,2,car,van,391,735,447,697,344,250,0.9818368,3,0,3,0.7267441860465116,
6,2,car,van,391,736,445,695,345,250,0.98718697,3,0,3,0.7246376811594203,
7,2,car,van,390,734,447,695,344,248,0.97756964,3,0,3,0.7209302325581395,
8,2,car,van,392,739,447,693,347,246,0.9871002,3,0,3,0.7089337175792507,
9,2,car,van,391,731,448,693,340,245,0.9821532,3,0,3,0.7205882352941176,
10,2,car,van,394,731,445,696,337,251,0.98827523,3,0,3,0.744807121661721,
11,2,car,van,393,740,447,695,347,248,0.97791225,3,0,3,0.7146974063400576,
12,2,car,van,392,739,446,692,347,246,0.9838788,3,0,3,0.7089337175792507,
13,2,car,van,165,1262,383,825,1097,442,0.22265343,3,0,3,0.4029170464904284,
14,2,car,van,249,754,434,748,505,314,0.9467645,3,0,3,0.4029170464904284,
15,2,car,van,158,1263,389,812,1105,423,0.27788413,3,30,3,0.38280542986425337,
16,2,car,van,248,759,437,744,511,307,0.95875967,3,30,3,0.38280542986425337,
0,2,car,van,391,736,446,698,345,252,0.9883552,3,0,3,0.7304347826086957,
1,2,car,van,392,737,445,697,345,252,0.9894341,3,0,3,0.7304347826086957,
2,2,car,van,394,730,446,696,336,250,0.9868613,3,0,3,0.7440476190476191,
3,2,car,van,392,734,447,696,342,249,0.98804855,3,0,3,0.7280701754385965,
4,2,car,van,396,735,445,695,339,250,0.9873077,3,0,3,0.7374631268436578,
5,2,car,van,396,741,445,695,345,250,0.9892166,3,0,3,0.7246376811594203,
6,2,car,van,391,735,447,697,344,250,0.9818368,3,0,3,0.7267441860465116,
7,2,car,van,391,736,445,695,345,250,0.98718697,3,0,3,0.7246376811594203,
8,2,car,van,390,734,447,695,344,248,0.97756964,3,0,3,0.7209302325581395,
9,2,car,van,392,739,447,693,347,246,0.9871002,3,0,3,0.7089337175792507,
10,2,car,van,391,731,448,693,340,245,0.9821532,3,0,3,0.7205882352941176,
11,2,car,van,394,731,445,696,337,251,0.98827523,3,0,3,0.744807121661721,
12,2,car,van,393,740,447,695,347,248,0.97791225,3,0,3,0.7146974063400576,
13,2,car,van,392,739,446,692,347,246,0.9838788,3,0,3,0.7089337175792507,
14,2,car,van,165,1262,383,825,1097,442,0.22265343,3,0,3,0.4029170464904284,
15,2,car,van,249,754,434,748,505,314,0.9467645,3,0,3,0.4029170464904284,
16,2,car,van,158,1263,389,812,1105,423,0.27788413,3,30,3,0.38280542986425337,
17,2,car,van,248,759,437,744,511,307,0.95875967,3,30,3,0.38280542986425337,
0,2,car,van,391,730,447,696,339,249,0.98842525,3,0,3,0.7345132743362832,
1,2,car,van,391,736,446,698,345,252,0.9883552,3,0,3,0.7304347826086957,
2,2,car,van,392,737,445,697,345,252,0.9894341,3,0,3,0.7304347826086957,
3,2,car,van,394,730,446,696,336,250,0.9868613,3,0,3,0.7440476190476191,
4,2,car,van,392,734,447,696,342,249,0.98804855,3,0,3,0.7280701754385965,
5,2,car,van,396,735,445,695,339,250,0.9873077,3,0,3,0.7374631268436578,
6,2,car,van,396,741,445,695,345,250,0.9892166,3,0,3,0.7246376811594203,
7,2,car,van,391,735,447,697,344,250,0.9818368,3,0,3,0.7267441860465116,
8,2,car,van,391,736,445,695,345,250,0.98718697,3,0,3,0.7246376811594203,
9,2,car,van,390,734,447,695,344,248,0.97756964,3,0,3,0.7209302325581395,
10,2,car,van,392,739,447,693,347,246,0.9871002,3,0,3,0.7089337175792507,
11,2,car,van,391,731,448,693,340,245,0.9821532,3,0,3,0.7205882352941176,
12,2,car,van,394,731,445,696,337,251,0.98827523,3,0,3,0.744807121661721,
13,2,car,van,393,740,447,695,347,248,0.97791225,3,0,3,0.7146974063400576,
14,2,car,van,392,739,446,692,347,246,0.9838788,3,0,3,0.7089337175792507,
15,2,car,van,165,1262,383,825,1097,442,0.22265343,3,0,3,0.4029170464904284,
16,2,car,van,249,754,434,748,505,314,0.9467645,3,0,3,0.4029170464904284,
17,2,car,van,158,1263,389,812,1105,423,0.27788413,3,30,3,0.38280542986425337,
18,2,car,van,248,759,437,744,511,307,0.95875967,3,30,3,0.38280542986425337,
0,2,car,van,395,736,449,692,341,243,0.97513837,3,0,3,0.7126099706744868,
1,2,car,van,391,730,447,696,339,249,0.98842525,3,0,3,0.7345132743362832,
2,2,car,van,391,736,446,698,345,252,0.9883552,3,0,3,0.7304347826086957,
3,2,car,van,392,737,445,697,345,252,0.9894341,3,0,3,0.7304347826086957,
4,2,car,van,394,730,446,696,336,250,0.9868613,3,0,3,0.7440476190476191,
5,2,car,van,392,734,447,696,342,249,0.98804855,3,0,3,0.7280701754385965,
6,2,car,van,396,735,445,695,339,250,0.9873077,3,0,3,0.7374631268436578,
7,2,car,van,396,741,445,695,345,250,0.9892166,3,0,3,0.7246376811594203,
8,2,car,van,391,735,447,697,344,250,0.9818368,3,0,3,0.7267441860465116,
9,2,car,van,391,736,445,695,345,250,0.98718697,3,0,3,0.7246376811594203,
10,2,car,van,390,734,447,695,344,248,0.97756964,3,0,3,0.7209302325581395,
11,2,car,van,392,739,447,693,347,246,0.9871002,3,0,3,0.7089337175792507,
12,2,car,van,391,731,448,693,340,245,0.9821532,3,0,3,0.7205882352941176,
13,2,car,van,394,731,445,696,337,251,0.98827523,3,0,3,0.744807121661721,
14,2,car,van,393,740,447,695,347,248,0.97791225,3,0,3,0.7146974063400576,
15,2,car,van,392,739,446,692,347,246,0.9838788,3,0,3,0.7089337175792507,
16,2,car,van,165,1262,383,825,1097,442,0.22265343,3,0,3,0.4029170464904284,
17,2,car,van,249,754,434,748,505,314,0.9467645,3,0,3,0.4029170464904284,
18,2,car,van,158,1263,389,812,1105,423,0.27788413,3,30,3,0.38280542986425337,
19,2,car,van,248,759,437,744,511,307,0.95875967,3,30,3,0.38280542986425337,
0,2,car,van,391,735,447,696,344,249,0.9889115,3,0,3,0.7238372093023255,
1,2,car,van,395,736,449,692,341,243,0.97513837,3,0,3,0.7126099706744868,
2,2,car,van,391,730,447,696,339,249,0.98842525,3,0,3,0.7345132743362832,
3,2,car,van,391,736,446,698,345,252,0.9883552,3,0,3,0.7304347826086957,
4,2,car,van,392,737,445,697,345,252,0.9894341,3,0,3,0.7304347826086957,
5,2,car,van,394,730,446,696,336,250,0.9868613,3,0,3,0.7440476190476191,
6,2,car,van,392,734,447,696,342,249,0.98804855,3,0,3,0.7280701754385965,
7,2,car,van,396,735,445,695,339,250,0.9873077,3,0,3,0.7374631268436578,
8,2,car,van,396,741,445,695,345,250,0.9892166,3,0,3,0.7246376811594203,
9,2,car,van,391,735,447,697,344,250,0.9818368,3,0,3,0.7267441860465116,
10,2,car,van,391,736,445,695,345,250,0.98718697,3,0,3,0.7246376811594203,
11,2,car,van,390,734,447,695,344,248,0.97756964,3,0,3,0.7209302325581395,
12,2,car,van,392,739,447,693,347,246,0.9871002,3,0,3,0.7089337175792507,
13,2,car,van,391,731,448,693,340,245,0.9821532,3,0,3,0.7205882352941176,
14,2,car,van,394,731,445,696,337,251,0.98827523,3,0,3,0.744807121661721,
15,2,car,van,393,740,447,695,347,248,0.97791225,3,0,3,0.7146974063400576,
16,2,car,van,392,739,446,692,347,246,0.9838788,3,0,3,0.7089337175792507,
17,2,car,van,165,1262,383,825,1097,442,0.22265343,3,0,3,0.4029170464904284,
18,2,car,van,249,754,434,748,505,314,0.9467645,3,0,3,0.4029170464904284,
19,2,car,van,158,1263,389,812,1105,423,0.27788413,3,30,3,0.38280542986425337,
20,2,car,van,248,759,437,744,511,307,0.95875967,3,30,3,0.38280542986425337,
0,2,car,van,394,734,448,696,340,248,0.98267424,3,0,3,0.7294117647058823,
1,2,car,van,391,735,447,696,344,249,0.9889115,3,0,3,0.7238372093023255,
2,2,car,van,395,736,449,692,341,243,0.97513837,3,0,3,0.7126099706744868,
3,2,car,van,391,730,447,696,339,249,0.98842525,3,0,3,0.7345132743362832,
4,2,car,van,391,736,446,698,345,252,0.9883552,3,0,3,0.7304347826086957,
5,2,car,van,392,737,445,697,345,252,0.9894341,3,0,3,0.7304347826086957,
6,2,car,van,394,730,446,696,336,250,0.9868613,3,0,3,0.7440476190476191,
7,2,car,van,392,734,447,696,342,249,0.98804855,3,0,3,0.7280701754385965,
8,2,car,van,396,735,445,695,339,250,0.9873077,3,0,3,0.7374631268436578,
9,2,car,van,396,741,445,695,345,250,0.9892166,3,0,3,0.7246376811594203,
10,2,car,van,391,735,447,697,344,250,0.9818368,3,0,3,0.7267441860465116,
11,2,car,van,391,736,445,695,345,250,0.98718697,3,0,3,0.7246376811594203,
12,2,car,van,390,734,447,695,344,248,0.97756964,3,0,3,0.7209302325581395,
13,2,car,van,392,739,447,693,347,246,0.9871002,3,0,3,0.7089337175792507,
14,2,car,van,391,731,448,693,340,245,0.9821532,3,0,3,0.7205882352941176,
15,2,car,van,394,731,445,696,337,251,0.98827523,3,0,3,0.744807121661721,
16,2,car,van,393,740,447,695,347,248,0.97791225,3,0,3,0.7146974063400576,
17,2,car,van,392,739,446,692,347,246,0.9838788,3,0,3,0.7089337175792507,
18,2,car,van,165,1262,383,825,1097,442,0.22265343,3,0,3,0.4029170464904284,
19,2,car,van,249,754,434,748,505,314,0.9467645,3,0,3,0.4029170464904284,
20,2,car,van,158,1263,389,812,1105,423,0.27788413,3,30,3,0.38280542986425337,
21,2,car,van,248,759,437,744,511,307,0.95875967,3,30,3,0.38280542986425337,
0,2,car,van,393,734,447,694,341,247,0.9653176,3,0,3,0.7243401759530792,
1,2,car,van,394,734,448,696,340,248,0.98267424,3,0,3,0.7294117647058823,
2,2,car,van,391,735,447,696,344,249,0.9889115,3,0,3,0.7238372093023255,
3,2,car,van,395,736,449,692,341,243,0.97513837,3,0,3,0.7126099706744868,
4,2,car,van,391,730,447,696,339,249,0.98842525,3,0,3,0.7345132743362832,
5,2,car,van,391,736,446,698,345,252,0.9883552,3,0,3,0.7304347826086957,
6,2,car,van,392,737,445,697,345,252,0.9894341,3,0,3,0.7304347826086957,
7,2,car,van,394,730,446,696,336,250,0.9868613,3,0,3,0.7440476190476191,
8,2,car,van,392,734,447,696,342,249,0.98804855,3,0,3,0.7280701754385965,
9,2,car,van,396,735,445,695,339,250,0.9873077,3,0,3,0.7374631268436578,
10,2,car,van,396,741,445,695,345,250,0.9892166,3,0,3,0.7246376811594203,
11,2,car,van,391,735,447,697,344,250,0.9818368,3,0,3,0.7267441860465116,
12,2,car,van,391,736,445,695,345,250,0.98718697,3,0,3,0.7246376811594203,
13,2,car,van,390,734,447,695,344,248,0.97756964,3,0,3,0.7209302325581395,
14,2,car,van,392,739,447,693,347,246,0.9871002,3,0,3,0.7089337175792507,
15,2,car,van,391,731,448,693,340,245,0.9821532,3,0,3,0.7205882352941176,
16,2,car,van,394,731,445,696,337,251,0.98827523,3,0,3,0.744807121661721,
17,2,car,van,393,740,447,695,347,248,0.97791225,3,0,3,0.7146974063400576,
18,2,car,van,392,739,446,692,347,246,0.9838788,3,0,3,0.7089337175792507,
19,2,car,van,165,1262,383,825,1097,442,0.22265343,3,0,3,0.4029170464904284,
20,2,car,van,249,754,434,748,505,314,0.9467645,3,0,3,0.4029170464904284,
21,2,car,van,158,1263,389,812,1105,423,0.27788413,3,30,3,0.38280542986425337,
22,2,car,van,248,759,437,744,511,307,0.95875967,3,30,3,0.38280542986425337,
0,2,car,van,395,736,447,695,341,248,0.9840958,3,0,3,0.7272727272727273,
1,2,car,van,393,734,447,694,341,247,0.9653176,3,0,3,0.7243401759530792,
2,2,car,van,394,734,448,696,340,248,0.98267424,3,0,3,0.7294117647058823,
3,2,car,van,391,735,447,696,344,249,0.9889115,3,0,3,0.7238372093023255,
4,2,car,van,395,736,449,692,341,243,0.97513837,3,0,3,0.7126099706744868,
5,2,car,van,391,730,447,696,339,249,0.98842525,3,0,3,0.7345132743362832,
6,2,car,van,391,736,446,698,345,252,0.9883552,3,0,3,0.7304347826086957,
7,2,car,van,392,737,445,697,345,252,0.9894341,3,0,3,0.7304347826086957,
8,2,car,van,394,730,446,696,336,250,0.9868613,3,0,3,0.7440476190476191,
9,2,car,van,392,734,447,696,342,249,0.98804855,3,0,3,0.7280701754385965,
10,2,car,van,396,735,445,695,339,250,0.9873077,3,0,3,0.7374631268436578,
11,2,car,van,396,741,445,695,345,250,0.9892166,3,0,3,0.7246376811594203,
12,2,car,van,391,735,447,697,344,250,0.9818368,3,0,3,0.7267441860465116,
13,2,car,van,391,736,445,695,345,250,0.98718697,3,0,3,0.7246376811594203,
14,2,car,van,390,734,447,695,344,248,0.97756964,3,0,3,0.7209302325581395,
15,2,car,van,392,739,447,693,347,246,0.9871002,3,0,3,0.7089337175792507,
16,2,car,van,391,731,448,693,340,245,0.9821532,3,0,3,0.7205882352941176,
17,2,car,van,394,731,445,696,337,251,0.98827523,3,0,3,0.744807121661721,
18,2,car,van,393,740,447,695,347,248,0.97791225,3,0,3,0.7146974063400576,
19,2,car,van,392,739,446,692,347,246,0.9838788,3,0,3,0.7089337175792507,
20,2,car,van,165,1262,383,825,1097,442,0.22265343,3,0,3,0.4029170464904284,
21,2,car,van,249,754,434,748,505,314,0.9467645,3,0,3,0.4029170464904284,
22,2,car,van,158,1263,389,812,1105,423,0.27788413,3,30,3,0.38280542986425337,
23,2,car,van,248,759,437,744,511,307,0.95875967,3,30,3,0.38280542986425337,
0,2,car,van,394,733,444,698,339,254,0.9801131,3,0,3,0.7492625368731564,
1,2,car,van,395,736,447,695,341,248,0.9840958,3,0,3,0.7272727272727273,
2,2,car,van,393,734,447,694,341,247,0.9653176,3,0,3,0.7243401759530792,
3,2,car,van,394,734,448,696,340,248,0.98267424,3,0,3,0.7294117647058823,
4,2,car,van,391,735,447,696,344,249,0.9889115,3,0,3,0.7238372093023255,
5,2,car,van,395,736,449,692,341,243,0.97513837,3,0,3,0.7126099706744868,
6,2,car,van,391,730,447,696,339,249,0.98842525,3,0,3,0.7345132743362832,
7,2,car,van,391,736,446,698,345,252,0.9883552,3,0,3,0.7304347826086957,
8,2,car,van,392,737,445,697,345,252,0.9894341,3,0,3,0.7304347826086957,
9,2,car,van,394,730,446,696,336,250,0.9868613,3,0,3,0.7440476190476191,
10,2,car,van,392,734,447,696,342,249,0.98804855,3,0,3,0.7280701754385965,
11,2,car,van,396,735,445,695,339,250,0.9873077,3,0,3,0.7374631268436578,
12,2,car,van,396,741,445,695,345,250,0.9892166,3,0,3,0.7246376811594203,
13,2,car,van,391,735,447,697,344,250,0.9818368,3,0,3,0.7267441860465116,
14,2,car,van,391,736,445,695,345,250,0.98718697,3,0,3,0.7246376811594203,
15,2,car,van,390,734,447,695,344,248,0.97756964,3,0,3,0.7209302325581395,
16,2,car,van,392,739,447,693,347,246,0.9871002,3,0,3,0.7089337175792507,
17,2,car,van,391,731,448,693,340,245,0.9821532,3,0,3,0.7205882352941176,
18,2,car,van,394,731,445,696,337,251,0.98827523,3,0,3,0.744807121661721,
19,2,car,van,393,740,447,695,347,248,0.97791225,3,0,3,0.7146974063400576,
20,2,car,van,392,739,446,692,347,246,0.9838788,3,0,3,0.7089337175792507,
21,2,car,van,165,1262,383,825,1097,442,0.22265343,3,0,3,0.4029170464904284,
22,2,car,van,249,754,434,748,505,314,0.9467645,3,0,3,0.4029170464904284,
23,2,car,van,158,1263,389,812,1105,423,0.27788413,3,30,3,0.38280542986425337,
24,2,car,van,248,759,437,744,511,307,0.95875967,3,30,3,0.38280542986425337,
0,2,car,van,394,737,446,697,343,251,0.98744214,3,0,3,0.7317784256559767,
1,2,car,van,394,733,444,698,339,254,0.9801131,3,0,3,0.7492625368731564,
2,2,car,van,395,736,447,695,341,248,0.9840958,3,0,3,0.7272727272727273,
3,2,car,van,393,734,447,694,341,247,0.9653176,3,0,3,0.7243401759530792,
4,2,car,van,394,734,448,696,340,248,0.98267424,3,0,3,0.7294117647058823,
5,2,car,van,391,735,447,696,344,249,0.9889115,3,0,3,0.7238372093023255,
6,2,car,van,395,736,449,692,341,243,0.97513837,3,0,3,0.7126099706744868,
7,2,car,van,391,730,447,696,339,249,0.98842525,3,0,3,0.7345132743362832,
8,2,car,van,391,736,446,698,345,252,0.9883552,3,0,3,0.7304347826086957,
9,2,car,van,392,737,445,697,345,252,0.9894341,3,0,3,0.7304347826086957,
10,2,car,van,394,730,446,696,336,250,0.9868613,3,0,3,0.7440476190476191,
11,2,car,van,392,734,447,696,342,249,0.98804855,3,0,3,0.7280701754385965,
12,2,car,van,396,735,445,695,339,250,0.9873077,3,0,3,0.7374631268436578,
13,2,car,van,396,741,445,695,345,250,0.9892166,3,0,3,0.7246376811594203,
14,2,car,van,391,735,447,697,344,250,0.9818368,3,0,3,0.7267441860465116,
15,2,car,van,391,736,445,695,345,250,0.98718697,3,0,3,0.7246376811594203,
16,2,car,van,390,734,447,695,344,248,0.97756964,3,0,3,0.7209302325581395,
17,2,car,van,392,739,447,693,347,246,0.9871002,3,0,3,0.7089337175792507,
18,2,car,van,391,731,448,693,340,245,0.9821532,3,0,3,0.7205882352941176,
19,2,car,van,394,731,445,696,337,251,0.98827523,3,0,3,0.744807121661721,
20,2,car,van,393,740,447,695,347,248,0.97791225,3,0,3,0.7146974063400576,
21,2,car,van,392,739,446,692,347,246,0.9838788,3,0,3,0.7089337175792507,
22,2,car,van,165,1262,383,825,1097,442,0.22265343,3,0,3,0.4029170464904284,
23,2,car,van,249,754,434,748,505,314,0.9467645,3,0,3,0.4029170464904284,
24,2,car,van,158,1263,389,812,1105,423,0.27788413,3,30,3,0.38280542986425337,
25,2,car,van,248,759,437,744,511,307,0.95875967,3,30,3,0.38280542986425337,
0,2,car,van,396,736,449,696,340,247,0.96816504,3,0,3,0.7264705882352941,
1,2,car,van,394,737,446,697,343,251,0.98744214,3,0,3,0.7317784256559767,
2,2,car,van,394,733,444,698,339,254,0.9801131,3,0,3,0.7492625368731564,
3,2,car,van,395,736,447,695,341,248,0.9840958,3,0,3,0.7272727272727273,
4,2,car,van,393,734,447,694,341,247,0.9653176,3,0,3,0.7243401759530792,
5,2,car,van,394,734,448,696,340,248,0.98267424,3,0,3,0.7294117647058823,
6,2,car,van,391,735,447,696,344,249,0.9889115,3,0,3,0.7238372093023255,
7,2,car,van,395,736,449,692,341,243,0.97513837,3,0,3,0.7126099706744868,
8,2,car,van,391,730,447,696,339,249,0.98842525,3,0,3,0.7345132743362832,
9,2,car,van,391,736,446,698,345,252,0.9883552,3,0,3,0.7304347826086957,
10,2,car,van,392,737,445,697,345,252,0.9894341,3,0,3,0.7304347826086957,
11,2,car,van,394,730,446,696,336,250,0.9868613,3,0,3,0.7440476190476191,
12,2,car,van,392,734,447,696,342,249,0.98804855,3,0,3,0.7280701754385965,
13,2,car,van,396,735,445,695,339,250,0.9873077,3,0,3,0.7374631268436578,
14,2,car,van,396,741,445,695,345,250,0.9892166,3,0,3,0.7246376811594203,
15,2,car,van,391,735,447,697,344,250,0.9818368,3,0,3,0.7267441860465116,
16,2,car,van,391,736,445,695,345,250,0.98718697,3,0,3,0.7246376811594203,
17,2,car,van,390,734,447,695,344,248,0.97756964,3,0,3,0.7209302325581395,
18,2,car,van,392,739,447,693,347,246,0.9871002,3,0,3,0.7089337175792507,
19,2,car,van,391,731,448,693,340,245,0.9821532,3,0,3,0.7205882352941176,
20,2,car,van,394,731,445,696,337,251,0.98827523,3,0,3,0.744807121661721,
21,2,car,van,393,740,447,695,347,248,0.97791225,3,0,3,0.7146974063400576,
22,2,car,van,392,739,446,692,347,246,0.9838788,3,0,3,0.7089337175792507,
23,2,car,van,165,1262,383,825,1097,442,0.22265343,3,0,3,0.4029170464904284,
24,2,car,van,249,754,434,748,505,314,0.9467645,3,0,3,0.4029170464904284,
25,2,car,van,158,1263,389,812,1105,423,0.27788413,3,30,3,0.38280542986425337,
26,2,car,van,248,759,437,744,511,307,0.95875967,3,30,3,0.38280542986425337,
0,2,car,van,392,736,446,694,344,248,0.9752692,3,0,3,0.7209302325581395,
1,2,car,van,396,736,449,696,340,247,0.96816504,3,0,3,0.7264705882352941,
2,2,car,van,394,737,446,697,343,251,0.98744214,3,0,3,0.7317784256559767,
3,2,car,van,394,733,444,698,339,254,0.9801131,3,0,3,0.7492625368731564,
4,2,car,van,395,736,447,695,341,248,0.9840958,3,0,3,0.7272727272727273,
5,2,car,van,393,734,447,694,341,247,0.9653176,3,0,3,0.7243401759530792,
6,2,car,van,394,734,448,696,340,248,0.98267424,3,0,3,0.7294117647058823,
7,2,car,van,391,735,447,696,344,249,0.9889115,3,0,3,0.7238372093023255,
8,2,car,van,395,736,449,692,341,243,0.97513837,3,0,3,0.7126099706744868,
9,2,car,van,391,730,447,696,339,249,0.98842525,3,0,3,0.7345132743362832,
10,2,car,van,391,736,446,698,345,252,0.9883552,3,0,3,0.7304347826086957,
11,2,car,van,392,737,445,697,345,252,0.9894341,3,0,3,0.7304347826086957,
12,2,car,van,394,730,446,696,336,250,0.9868613,3,0,3,0.7440476190476191,
13,2,car,van,392,734,447,696,342,249,0.98804855,3,0,3,0.7280701754385965,
14,2,car,van,396,735,445,695,339,250,0.9873077,3,0,3,0.7374631268436578,
15,2,car,van,396,741,445,695,345,250,0.9892166,3,0,3,0.7246376811594203,
16,2,car,van,391,735,447,697,344,250,0.9818368,3,0,3,0.7267441860465116,
17,2,car,van,391,736,445,695,345,250,0.98718697,3,0,3,0.7246376811594203,
18,2,car,van,390,734,447,695,344,248,0.97756964,3,0,3,0.7209302325581395,
19,2,car,van,392,739,447,693,347,246,0.9871002,3,0,3,0.7089337175792507,
20,2,car,van,391,731,448,693,340,245,0.9821532,3,0,3,0.7205882352941176,
21,2,car,van,394,731,445,696,337,251,0.98827523,3,0,3,0.744807121661721,
22,2,car,van,393,740,447,695,347,248,0.97791225,3,0,3,0.7146974063400576,
23,2,car,van,392,739,446,692,347,246,0.9838788,3,0,3,0.7089337175792507,
24,2,car,van,165,1262,383,825,1097,442,0.22265343,3,0,3,0.4029170464904284,
25,2,car,van,249,754,434,748,505,314,0.9467645,3,0,3,0.4029170464904284,
26,2,car,van,158,1263,389,812,1105,423,0.27788413,3,30,3,0.38280542986425337,
27,2,car,van,248,759,437,744,511,307,0.95875967,3,30,3,0.38280542986425337,
0,2,car,van,390,735,444,696,345,252,0.97961944,3,0,3,0.7304347826086957,
1,2,car,van,392,736,446,694,344,248,0.9752692,3,0,3,0.7209302325581395,
2,2,car,van,396,736,449,696,340,247,0.96816504,3,0,3,0.7264705882352941,
3,2,car,van,394,737,446,697,343,251,0.98744214,3,0,3,0.7317784256559767,
4,2,car,van,394,733,444,698,339,254,0.9801131,3,0,3,0.7492625368731564,
5,2,car,van,395,736,447,695,341,248,0.9840958,3,0,3,0.7272727272727273,
6,2,car,van,393,734,447,694,341,247,0.9653176,3,0,3,0.7243401759530792,
7,2,car,van,394,734,448,696,340,248,0.98267424,3,0,3,0.7294117647058823,
8,2,car,van,391,735,447,696,344,249,0.9889115,3,0,3,0.7238372093023255,
9,2,car,van,395,736,449,692,341,243,0.97513837,3,0,3,0.7126099706744868,
10,2,car,van,391,730,447,696,339,249,0.98842525,3,0,3,0.7345132743362832,
11,2,car,van,391,736,446,698,345,252,0.9883552,3,0,3,0.7304347826086957,
12,2,car,van,392,737,445,697,345,252,0.9894341,3,0,3,0.7304347826086957,
13,2,car,van,394,730,446,696,336,250,0.9868613,3,0,3,0.7440476190476191,
14,2,car,van,392,734,447,696,342,249,0.98804855,3,0,3,0.7280701754385965,
15,2,car,van,396,735,445,695,339,250,0.9873077,3,0,3,0.7374631268436578,
16,2,car,van,396,741,445,695,345,250,0.9892166,3,0,3,0.7246376811594203,
17,2,car,van,391,735,447,697,344,250,0.9818368,3,0,3,0.7267441860465116,
18,2,car,van,391,736,445,695,345,250,0.98718697,3,0,3,0.7246376811594203,
19,2,car,van,390,734,447,695,344,248,0.97756964,3,0,3,0.7209302325581395,
20,2,car,van,392,739,447,693,347,246,0.9871002,3,0,3,0.7089337175792507,
21,2,car,van,391,731,448,693,340,245,0.9821532,3,0,3,0.7205882352941176,
22,2,car,van,394,731,445,696,337,251,0.98827523,3,0,3,0.744807121661721,
23,2,car,van,393,740,447,695,347,248,0.97791225,3,0,3,0.7146974063400576,
24,2,car,van,392,739,446,692,347,246,0.9838788,3,0,3,0.7089337175792507,
25,2,car,van,165,1262,383,825,1097,442,0.22265343,3,0,3,0.4029170464904284,
26,2,car,van,249,754,434,748,505,314,0.9467645,3,0,3,0.4029170464904284,
27,2,car,van,158,1263,389,812,1105,423,0.27788413,3,30,3,0.38280542986425337,
28,2,car,van,248,759,437,744,511,307,0.95875967,3,30,3,0.38280542986425337,
0,2,car,van,390,736,446,698,346,252,0.9729815,3,0,3,0.7283236994219653,
1,2,car,van,390,735,444,696,345,252,0.97961944,3,0,3,0.7304347826086957,
2,2,car,van,392,736,446,694,344,248,0.9752692,3,0,3,0.7209302325581395,
3,2,car,van,396,736,449,696,340,247,0.96816504,3,0,3,0.7264705882352941,
4,2,car,van,394,737,446,697,343,251,0.98744214,3,0,3,0.7317784256559767,
5,2,car,van,394,733,444,698,339,254,0.9801131,3,0,3,0.7492625368731564,
6,2,car,van,395,736,447,695,341,248,0.9840958,3,0,3,0.7272727272727273,
7,2,car,van,393,734,447,694,341,247,0.9653176,3,0,3,0.7243401759530792,
8,2,car,van,394,734,448,696,340,248,0.98267424,3,0,3,0.7294117647058823,
9,2,car,van,391,735,447,696,344,249,0.9889115,3,0,3,0.7238372093023255,
10,2,car,van,395,736,449,692,341,243,0.97513837,3,0,3,0.7126099706744868,
11,2,car,van,391,730,447,696,339,249,0.98842525,3,0,3,0.7345132743362832,
12,2,car,van,391,736,446,698,345,252,0.9883552,3,0,3,0.7304347826086957,
13,2,car,van,392,737,445,697,345,252,0.9894341,3,0,3,0.7304347826086957,
14,2,car,van,394,730,446,696,336,250,0.9868613,3,0,3,0.7440476190476191,
15,2,car,van,392,734,447,696,342,249,0.98804855,3,0,3,0.7280701754385965,
16,2,car,van,396,735,445,695,339,250,0.9873077,3,0,3,0.7374631268436578,
17,2,car,van,396,741,445,695,345,250,0.9892166,3,0,3,0.7246376811594203,
18,2,car,van,391,735,447,697,344,250,0.9818368,3,0,3,0.7267441860465116,
19,2,car,van,391,736,445,695,345,250,0.98718697,3,0,3,0.7246376811594203,
20,2,car,van,390,734,447,695,344,248,0.97756964,3,0,3,0.7209302325581395,
21,2,car,van,392,739,447,693,347,246,0.9871002,3,0,3,0.7089337175792507,
22,2,car,van,391,731,448,693,340,245,0.9821532,3,0,3,0.7205882352941176,
23,2,car,van,394,731,445,696,337,251,0.98827523,3,0,3,0.744807121661721,
24,2,car,van,393,740,447,695,347,248,0.97791225,3,0,3,0.7146974063400576,
25,2,car,van,392,739,446,692,347,246,0.9838788,3,0,3,0.7089337175792507,
26,2,car,van,165,1262,383,825,1097,442,0.22265343,3,0,3,0.4029170464904284,
27,2,car,van,249,754,434,748,505,314,0.9467645,3,0,3,0.4029170464904284,
28,2,car,van,158,1263,389,812,1105,423,0.27788413,3,30,3,0.38280542986425337,
29,2,car,van,248,759,437,744,511,307,0.95875967,3,30,3,0.38280542986425337,
0,2,car,van,390,733,444,697,343,253,0.98208946,3,0,3,0.7376093294460642,
1,2,car,van,390,736,446,698,346,252,0.9729815,3,0,3,0.7283236994219653,
2,2,car,van,390,735,444,696,345,252,0.97961944,3,0,3,0.7304347826086957,
3,2,car,van,392,736,446,694,344,248,0.9752692,3,0,3,0.7209302325581395,
4,2,car,van,396,736,449,696,340,247,0.96816504,3,0,3,0.7264705882352941,
5,2,car,van,394,737,446,697,343,251,0.98744214,3,0,3,0.7317784256559767,
6,2,car,van,394,733,444,698,339,254,0.9801131,3,0,3,0.7492625368731564,
7,2,car,van,395,736,447,695,341,248,0.9840958,3,0,3,0.7272727272727273,
8,2,car,van,393,734,447,694,341,247,0.9653176,3,0,3,0.7243401759530792,
9,2,car,van,394,734,448,696,340,248,0.98267424,3,0,3,0.7294117647058823,
10,2,car,van,391,735,447,696,344,249,0.9889115,3,0,3,0.7238372093023255,
11,2,car,van,395,736,449,692,341,243,0.97513837,3,0,3,0.7126099706744868,
12,2,car,van,391,730,447,696,339,249,0.98842525,3,0,3,0.7345132743362832,
13,2,car,van,391,736,446,698,345,252,0.9883552,3,0,3,0.7304347826086957,
14,2,car,van,392,737,445,697,345,252,0.9894341,3,0,3,0.7304347826086957,
15,2,car,van,394,730,446,696,336,250,0.9868613,3,0,3,0.7440476190476191,
16,2,car,van,392,734,447,696,342,249,0.98804855,3,0,3,0.7280701754385965,
17,2,car,van,396,735,445,695,339,250,0.9873077,3,0,3,0.7374631268436578,
18,2,car,van,396,741,445,695,345,250,0.9892166,3,0,3,0.7246376811594203,
19,2,car,van,391,735,447,697,344,250,0.9818368,3,0,3,0.7267441860465116,
20,2,car,van,391,736,445,695,345,250,0.98718697,3,0,3,0.7246376811594203,
21,2,car,van,390,734,447,695,344,248,0.97756964,3,0,3,0.7209302325581395,
22,2,car,van,392,739,447,693,347,246,0.9871002,3,0,3,0.7089337175792507,
23,2,car,van,391,731,448,693,340,245,0.9821532,3,0,3,0.7205882352941176,
24,2,car,van,394,731,445,696,337,251,0.98827523,3,0,3,0.744807121661721,
25,2,car,van,393,740,447,695,347,248,0.97791225,3,0,3,0.7146974063400576,
26,2,car,van,392,739,446,692,347,246,0.9838788,3,0,3,0.7089337175792507,
27,2,car,van,165,1262,383,825,1097,442,0.22265343,3,0,3,0.4029170464904284,
28,2,car,van,249,754,434,748,505,314,0.9467645,3,0,3,0.4029170464904284,
29,2,car,van,158,1263,389,812,1105,423,0.27788413,3,30,3,0.38280542986425337,
30,2,car,van,248,759,437,744,511,307,0.95875967,3,30,3,0.38280542986425337,
0,2,car,van,396,733,447,694,337,247,0.9840608,3,0,3,0.7329376854599406,
1,2,car,van,390,733,444,697,343,253,0.98208946,3,0,3,0.7376093294460642,
2,2,car,van,390,736,446,698,346,252,0.9729815,3,0,3,0.7283236994219653,
3,2,car,van,390,735,444,696,345,252,0.97961944,3,0,3,0.7304347826086957,
4,2,car,van,392,736,446,694,344,248,0.9752692,3,0,3,0.7209302325581395,
5,2,car,van,396,736,449,696,340,247,0.96816504,3,0,3,0.7264705882352941,
6,2,car,van,394,737,446,697,343,251,0.98744214,3,0,3,0.7317784256559767,
7,2,car,van,394,733,444,698,339,254,0.9801131,3,0,3,0.7492625368731564,
8,2,car,van,395,736,447,695,341,248,0.9840958,3,0,3,0.7272727272727273,
9,2,car,van,393,734,447,694,341,247,0.9653176,3,0,3,0.7243401759530792,
10,2,car,van,394,734,448,696,340,248,0.98267424,3,0,3,0.7294117647058823,
11,2,car,van,391,735,447,696,344,249,0.9889115,3,0,3,0.7238372093023255,
12,2,car,van,395,736,449,692,341,243,0.97513837,3,0,3,0.7126099706744868,
13,2,car,van,391,730,447,696,339,249,0.98842525,3,0,3,0.7345132743362832,
14,2,car,van,391,736,446,698,345,252,0.9883552,3,0,3,0.7304347826086957,
15,2,car,van,392,737,445,697,345,252,0.9894341,3,0,3,0.7304347826086957,
16,2,car,van,394,730,446,696,336,250,0.9868613,3,0,3,0.7440476190476191,
17,2,car,van,392,734,447,696,342,249,0.98804855,3,0,3,0.7280701754385965,
18,2,car,van,396,735,445,695,339,250,0.9873077,3,0,3,0.7374631268436578,
19,2,car,van,396,741,445,695,345,250,0.9892166,3,0,3,0.7246376811594203,
20,2,car,van,391,735,447,697,344,250,0.9818368,3,0,3,0.7267441860465116,
21,2,car,van,391,736,445,695,345,250,0.98718697,3,0,3,0.7246376811594203,
22,2,car,van,390,734,447,695,344,248,0.97756964,3,0,3,0.7209302325581395,
23,2,car,van,392,739,447,693,347,246,0.9871002,3,0,3,0.7089337175792507,
24,2,car,van,391,731,448,693,340,245,0.9821532,3,0,3,0.7205882352941176,
25,2,car,van,394,731,445,696,337,251,0.98827523,3,0,3,0.744807121661721,
26,2,car,van,393,740,447,695,347,248,0.97791225,3,0,3,0.7146974063400576,
27,2,car,van,392,739,446,692,347,246,0.9838788,3,0,3,0.7089337175792507,
28,2,car,van,165,1262,383,825,1097,442,0.22265343,3,0,3,0.4029170464904284,
29,2,car,van,249,754,434,748,505,314,0.9467645,3,0,3,0.4029170464904284,
30,2,car,van,158,1263,389,812,1105,423,0.27788413,3,30,3,0.38280542986425337,
31,2,car,van,248,759,437,744,511,307,0.95875967,3,30,3,0.38280542986425337,
0,2,car,van,395,739,445,695,344,250,0.9893474,3,0,3,0.7267441860465116,
1,2,car,van,396,733,447,694,337,247,0.9840608,3,0,3,0.7329376854599406,
2,2,car,van,390,733,444,697,343,253,0.98208946,3,0,3,0.7376093294460642,
3,2,car,van,390,736,446,698,346,252,0.9729815,3,0,3,0.7283236994219653,
4,2,car,van,390,735,444,696,345,252,0.97961944,3,0,3,0.7304347826086957,
5,2,car,van,392,736,446,694,344,248,0.9752692,3,0,3,0.7209302325581395,
6,2,car,van,396,736,449,696,340,247,0.96816504,3,0,3,0.7264705882352941,
7,2,car,van,394,737,446,697,343,251,0.98744214,3,0,3,0.7317784256559767,
8,2,car,van,394,733,444,698,339,254,0.9801131,3,0,3,0.7492625368731564,
9,2,car,van,395,736,447,695,341,248,0.9840958,3,0,3,0.7272727272727273,
10,2,car,van,393,734,447,694,341,247,0.9653176,3,0,3,0.7243401759530792,
11,2,car,van,394,734,448,696,340,248,0.98267424,3,0,3,0.7294117647058823,
12,2,car,van,391,735,447,696,344,249,0.9889115,3,0,3,0.7238372093023255,
13,2,car,van,395,736,449,692,341,243,0.97513837,3,0,3,0.7126099706744868,
14,2,car,van,391,730,447,696,339,249,0.98842525,3,0,3,0.7345132743362832,
15,2,car,van,391,736,446,698,345,252,0.9883552,3,0,3,0.7304347826086957,
16,2,car,van,392,737,445,697,345,252,0.9894341,3,0,3,0.7304347826086957,
17,2,car,van,394,730,446,696,336,250,0.9868613,3,0,3,0.7440476190476191,
18,2,car,van,392,734,447,696,342,249,0.98804855,3,0,3,0.7280701754385965,
19,2,car,van,396,735,445,695,339,250,0.9873077,3,0,3,0.7374631268436578,
20,2,car,van,396,741,445,695,345,250,0.9892166,3,0,3,0.7246376811594203,
21,2,car,van,391,735,447,697,344,250,0.9818368,3,0,3,0.7267441860465116,
22,2,car,van,391,736,445,695,345,250,0.98718697,3,0,3,0.7246376811594203,
23,2,car,van,390,734,447,695,344,248,0.97756964,3,0,3,0.7209302325581395,
24,2,car,van,392,739,447,693,347,246,0.9871002,3,0,3,0.7089337175792507,
25,2,car,van,391,731,448,693,340,245,0.9821532,3,0,3,0.7205882352941176,
26,2,car,van,394,731,445,696,337,251,0.98827523,3,0,3,0.744807121661721,
27,2,car,van,393,740,447,695,347,248,0.97791225,3,0,3,0.7146974063400576,
28,2,car,van,392,739,446,692,347,246,0.9838788,3,0,3,0.7089337175792507,
29,2,car,van,165,1262,383,825,1097,442,0.22265343,3,0,3,0.4029170464904284,
30,2,car,van,249,754,434,748,505,314,0.9467645,3,0,3,0.4029170464904284,
31,2,car,van,158,1263,389,812,1105,423,0.27788413,3,30,3,0.38280542986425337,
32,2,car,van,248,759,437,744,511,307,0.95875967,3,30,3,0.38280542986425337,
0,2,car,van,390,736,447,696,346,249,0.98160815,3,0,3,0.7196531791907514,
1,2,car,van,395,739,445,695,344,250,0.9893474,3,0,3,0.7267441860465116,
2,2,car,van,396,733,447,694,337,247,0.9840608,3,0,3,0.7329376854599406,
3,2,car,van,390,733,444,697,343,253,0.98208946,3,0,3,0.7376093294460642,
4,2,car,van,390,736,446,698,346,252,0.9729815,3,0,3,0.7283236994219653,
5,2,car,van,390,735,444,696,345,252,0.97961944,3,0,3,0.7304347826086957,
6,2,car,van,392,736,446,694,344,248,0.9752692,3,0,3,0.7209302325581395,
7,2,car,van,396,736,449,696,340,247,0.96816504,3,0,3,0.7264705882352941,
8,2,car,van,394,737,446,697,343,251,0.98744214,3,0,3,0.7317784256559767,
9,2,car,van,394,733,444,698,339,254,0.9801131,3,0,3,0.7492625368731564,
10,2,car,van,395,736,447,695,341,248,0.9840958,3,0,3,0.7272727272727273,
11,2,car,van,393,734,447,694,341,247,0.9653176,3,0,3,0.7243401759530792,
12,2,car,van,394,734,448,696,340,248,0.98267424,3,0,3,0.7294117647058823,
13,2,car,van,391,735,447,696,344,249,0.9889115,3,0,3,0.7238372093023255,
14,2,car,van,395,736,449,692,341,243,0.97513837,3,0,3,0.7126099706744868,
15,2,car,van,391,730,447,696,339,249,0.98842525,3,0,3,0.7345132743362832,
16,2,car,van,391,736,446,698,345,252,0.9883552,3,0,3,0.7304347826086957,
17,2,car,van,392,737,445,697,345,252,0.9894341,3,0,3,0.7304347826086957,
18,2,car,van,394,730,446,696,336,250,0.9868613,3,0,3,0.7440476190476191,
19,2,car,van,392,734,447,696,342,249,0.98804855,3,0,3,0.7280701754385965,
20,2,car,van,396,735,445,695,339,250,0.9873077,3,0,3,0.7374631268436578,
21,2,car,van,396,741,445,695,345,250,0.9892166,3,0,3,0.7246376811594203,
22,2,car,van,391,735,447,697,344,250,0.9818368,3,0,3,0.7267441860465116,
23,2,car,van,391,736,445,695,345,250,0.98718697,3,0,3,0.7246376811594203,
24,2,car,van,390,734,447,695,344,248,0.97756964,3,0,3,0.7209302325581395,
25,2,car,van,392,739,447,693,347,246,0.9871002,3,0,3,0.7089337175792507,
26,2,car,van,391,731,448,693,340,245,0.9821532,3,0,3,0.7205882352941176,
27,2,car,van,394,731,445,696,337,251,0.98827523,3,0,3,0.744807121661721,
28,2,car,van,393,740,447,695,347,248,0.97791225,3,0,3,0.7146974063400576,
29,2,car,van,392,739,446,692,347,246,0.9838788,3,0,3,0.7089337175792507,
30,2,car,van,165,1262,383,825,1097,442,0.22265343,3,0,3,0.4029170464904284,
31,2,car,van,249,754,434,748,505,314,0.9467645,3,0,3,0.4029170464904284,
32,2,car,van,158,1263,389,812,1105,423,0.27788413,3,30,3,0.38280542986425337,
33,2,car,van,248,759,437,744,511,307,0.95875967,3,30,3,0.38280542986425337,
0,2,car,van,395,736,447,694,341,247,0.9739385,3,0,3,0.7243401759530792,
1,2,car,van,390,736,447,696,346,249,0.98160815,3,0,3,0.7196531791907514,
2,2,car,van,395,739,445,695,344,250,0.9893474,3,0,3,0.7267441860465116,
3,2,car,van,396,733,447,694,337,247,0.9840608,3,0,3,0.7329376854599406,
4,2,car,van,390,733,444,697,343,253,0.98208946,3,0,3,0.7376093294460642,
5,2,car,van,390,736,446,698,346,252,0.9729815,3,0,3,0.7283236994219653,
6,2,car,van,390,735,444,696,345,252,0.97961944,3,0,3,0.7304347826086957,
7,2,car,van,392,736,446,694,344,248,0.9752692,3,0,3,0.7209302325581395,
8,2,car,van,396,736,449,696,340,247,0.96816504,3,0,3,0.7264705882352941,
9,2,car,van,394,737,446,697,343,251,0.98744214,3,0,3,0.7317784256559767,
10,2,car,van,394,733,444,698,339,254,0.9801131,3,0,3,0.7492625368731564,
11,2,car,van,395,736,447,695,341,248,0.9840958,3,0,3,0.7272727272727273,
12,2,car,van,393,734,447,694,341,247,0.9653176,3,0,3,0.7243401759530792,
13,2,car,van,394,734,448,696,340,248,0.98267424,3,0,3,0.7294117647058823,
14,2,car,van,391,735,447,696,344,249,0.9889115,3,0,3,0.7238372093023255,
15,2,car,van,395,736,449,692,341,243,0.97513837,3,0,3,0.7126099706744868,
16,2,car,van,391,730,447,696,339,249,0.98842525,3,0,3,0.7345132743362832,
17,2,car,van,391,736,446,698,345,252,0.9883552,3,0,3,0.7304347826086957,
18,2,car,van,392,737,445,697,345,252,0.9894341,3,0,3,0.7304347826086957,
19,2,car,van,394,730,446,696,336,250,0.9868613,3,0,3,0.7440476190476191,
20,2,car,van,392,734,447,696,342,249,0.98804855,3,0,3,0.7280701754385965,
21,2,car,van,396,735,445,695,339,250,0.9873077,3,0,3,0.7374631268436578,
22,2,car,van,396,741,445,695,345,250,0.9892166,3,0,3,0.7246376811594203,
23,2,car,van,391,735,447,697,344,250,0.9818368,3,0,3,0.7267441860465116,
24,2,car,van,391,736,445,695,345,250,0.98718697,3,0,3,0.7246376811594203,
25,2,car,van,390,734,447,695,344,248,0.97756964,3,0,3,0.7209302325581395,
26,2,car,van,392,739,447,693,347,246,0.9871002,3,0,3,0.7089337175792507,
27,2,car,van,391,731,448,693,340,245,0.9821532,3,0,3,0.7205882352941176,
28,2,car,van,394,731,445,696,337,251,0.98827523,3,0,3,0.744807121661721,
29,2,car,van,393,740,447,695,347,248,0.97791225,3,0,3,0.7146974063400576,
30,2,car,van,392,739,446,692,347,246,0.9838788,3,0,3,0.7089337175792507,
31,2,car,van,165,1262,383,825,1097,442,0.22265343,3,0,3,0.4029170464904284,
32,2,car,van,249,754,434,748,505,314,0.9467645,3,0,3,0.4029170464904284,
33,2,car,van,158,1263,389,812,1105,423,0.27788413,3,30,3,0.38280542986425337,
34,2,car,van,248,759,437,744,511,307,0.95875967,3,30,3,0.38280542986425337,
0,2,car,van,392,735,445,697,343,252,0.9873547,3,0,3,0.7346938775510204,
1,2,car,van,395,736,447,694,341,247,0.9739385,3,0,3,0.7243401759530792,
2,2,car,van,390,736,447,696,346,249,0.98160815,3,0,3,0.7196531791907514,
3,2,car,van,395,739,445,695,344,250,0.9893474,3,0,3,0.7267441860465116,
4,2,car,van,396,733,447,694,337,247,0.9840608,3,0,3,0.7329376854599406,
5,2,car,van,390,733,444,697,343,253,0.98208946,3,0,3,0.7376093294460642,
6,2,car,van,390,736,446,698,346,252,0.9729815,3,0,3,0.7283236994219653,
7,2,car,van,390,735,444,696,345,252,0.97961944,3,0,3,0.7304347826086957,
8,2,car,van,392,736,446,694,344,248,0.9752692,3,0,3,0.7209302325581395,
9,2,car,van,396,736,449,696,340,247,0.96816504,3,0,3,0.7264705882352941,
10,2,car,van,394,737,446,697,343,251,0.98744214,3,0,3,0.7317784256559767,
11,2,car,van,394,733,444,698,339,254,0.9801131,3,0,3,0.7492625368731564,
12,2,car,van,395,736,447,695,341,248,0.9840958,3,0,3,0.7272727272727273,
13,2,car,van,393,734,447,694,341,247,0.9653176,3,0,3,0.7243401759530792,
14,2,car,van,394,734,448,696,340,248,0.98267424,3,0,3,0.7294117647058823,
15,2,car,van,391,735,447,696,344,249,0.9889115,3,0,3,0.7238372093023255,
16,2,car,van,395,736,449,692,341,243,0.97513837,3,0,3,0.7126099706744868,
17,2,car,van,391,730,447,696,339,249,0.98842525,3,0,3,0.7345132743362832,
18,2,car,van,391,736,446,698,345,252,0.9883552,3,0,3,0.7304347826086957,
19,2,car,van,392,737,445,697,345,252,0.9894341,3,0,3,0.7304347826086957,
20,2,car,van,394,730,446,696,336,250,0.9868613,3,0,3,0.7440476190476191,
21,2,car,van,392,734,447,696,342,249,0.98804855,3,0,3,0.7280701754385965,
22,2,car,van,396,735,445,695,339,250,0.9873077,3,0,3,0.7374631268436578,
23,2,car,van,396,741,445,695,345,250,0.9892166,3,0,3,0.7246376811594203,
24,2,car,van,391,735,447,697,344,250,0.9818368,3,0,3,0.7267441860465116,
25,2,car,van,391,736,445,695,345,250,0.98718697,3,0,3,0.7246376811594203,
26,2,car,van,390,734,447,695,344,248,0.97756964,3,0,3,0.7209302325581395,
27,2,car,van,392,739,447,693,347,246,0.9871002,3,0,3,0.7089337175792507,
28,2,car,van,391,731,448,693,340,245,0.9821532,3,0,3,0.7205882352941176,
29,2,car,van,394,731,445,696,337,251,0.98827523,3,0,3,0.744807121661721,
30,2,car,van,393,740,447,695,347,248,0.97791225,3,0,3,0.7146974063400576,
31,2,car,van,392,739,446,692,347,246,0.9838788,3,0,3,0.7089337175792507,
32,2,car,van,165,1262,383,825,1097,442,0.22265343,3,0,3,0.4029170464904284,
33,2,car,van,249,754,434,748,505,314,0.9467645,3,0,3,0.4029170464904284,
34,2,car,van,158,1263,389,812,1105,423,0.27788413,3,30,3,0.38280542986425337,
35,2,car,van,248,759,437,744,511,307,0.95875967,3,30,3,0.38280542986425337,
0,2,car,van,394,733,447,695,339,248,0.97350967,3,0,3,0.7315634218289085,
1,2,car,van,392,735,445,697,343,252,0.9873547,3,0,3,0.7346938775510204,
2,2,car,van,395,736,447,694,341,247,0.9739385,3,0,3,0.7243401759530792,
3,2,car,van,390,736,447,696,346,249,0.98160815,3,0,3,0.7196531791907514,
4,2,car,van,395,739,445,695,344,250,0.9893474,3,0,3,0.7267441860465116,
5,2,car,van,396,733,447,694,337,247,0.9840608,3,0,3,0.7329376854599406,
6,2,car,van,390,733,444,697,343,253,0.98208946,3,0,3,0.7376093294460642,
7,2,car,van,390,736,446,698,346,252,0.9729815,3,0,3,0.7283236994219653,
8,2,car,van,390,735,444,696,345,252,0.97961944,3,0,3,0.7304347826086957,
9,2,car,van,392,736,446,694,344,248,0.9752692,3,0,3,0.7209302325581395,
10,2,car,van,396,736,449,696,340,247,0.96816504,3,0,3,0.7264705882352941,
11,2,car,van,394,737,446,697,343,251,0.98744214,3,0,3,0.7317784256559767,
12,2,car,van,394,733,444,698,339,254,0.9801131,3,0,3,0.7492625368731564,
13,2,car,van,395,736,447,695,341,248,0.9840958,3,0,3,0.7272727272727273,
14,2,car,van,393,734,447,694,341,247,0.9653176,3,0,3,0.7243401759530792,
15,2,car,van,394,734,448,696,340,248,0.98267424,3,0,3,0.7294117647058823,
16,2,car,van,391,735,447,696,344,249,0.9889115,3,0,3,0.7238372093023255,
17,2,car,van,395,736,449,692,341,243,0.97513837,3,0,3,0.7126099706744868,
18,2,car,van,391,730,447,696,339,249,0.98842525,3,0,3,0.7345132743362832,
19,2,car,van,391,736,446,698,345,252,0.9883552,3,0,3,0.7304347826086957,
20,2,car,van,392,737,445,697,345,252,0.9894341,3,0,3,0.7304347826086957,
21,2,car,van,394,730,446,696,336,250,0.9868613,3,0,3,0.7440476190476191,
22,2,car,van,392,734,447,696,342,249,0.98804855,3,0,3,0.7280701754385965,
23,2,car,van,396,735,445,695,339,250,0.9873077,3,0,3,0.7374631268436578,
24,2,car,van,396,741,445,695,345,250,0.9892166,3,0,3,0.7246376811594203,
25,2,car,van,391,735,447,697,344,250,0.9818368,3,0,3,0.7267441860465116,
26,2,car,van,391,736,445,695,345,250,0.98718697,3,0,3,0.7246376811594203,
27,2,car,van,390,734,447,695,344,248,0.97756964,3,0,3,0.7209302325581395,
28,2,car,van,392,739,447,693,347,246,0.9871002,3,0,3,0.7089337175792507,
29,2,car,van,391,731,448,693,340,245,0.9821532,3,0,3,0.7205882352941176,
30,2,car,van,394,731,445,696,337,251,0.98827523,3,0,3,0.744807121661721,
31,2,car,van,393,740,447,695,347,248,0.97791225,3,0,3,0.7146974063400576,
32,2,car,van,392,739,446,692,347,246,0.9838788,3,0,3,0.7089337175792507,
33,2,car,van,165,1262,383,825,1097,442,0.22265343,3,0,3,0.4029170464904284,
34,2,car,van,249,754,434,748,505,314,0.9467645,3,0,3,0.4029170464904284,
35,2,car,van,158,1263,389,812,1105,423,0.27788413,3,30,3,0.38280542986425337,
36,2,car,van,248,759,437,744,511,307,0.95875967,3,30,3,0.38280542986425337,
0,2,car,van,393,739,447,693,346,246,0.98315847,3,0,3,0.7109826589595376,
1,2,car,van,394,733,447,695,339,248,0.97350967,3,0,3,0.7315634218289085,
2,2,car,van,392,735,445,697,343,252,0.9873547,3,0,3,0.7346938775510204,
3,2,car,van,395,736,447,694,341,247,0.9739385,3,0,3,0.7243401759530792,
4,2,car,van,390,736,447,696,346,249,0.98160815,3,0,3,0.7196531791907514,
5,2,car,van,395,739,445,695,344,250,0.9893474,3,0,3,0.7267441860465116,
6,2,car,van,396,733,447,694,337,247,0.9840608,3,0,3,0.7329376854599406,
7,2,car,van,390,733,444,697,343,253,0.98208946,3,0,3,0.7376093294460642,
8,2,car,van,390,736,446,698,346,252,0.9729815,3,0,3,0.7283236994219653,
9,2,car,van,390,735,444,696,345,252,0.97961944,3,0,3,0.7304347826086957,
10,2,car,van,392,736,446,694,344,248,0.9752692,3,0,3,0.7209302325581395,
11,2,car,van,396,736,449,696,340,247,0.96816504,3,0,3,0.7264705882352941,
12,2,car,van,394,737,446,697,343,251,0.98744214,3,0,3,0.7317784256559767,
13,2,car,van,394,733,444,698,339,254,0.9801131,3,0,3,0.7492625368731564,
14,2,car,van,395,736,447,695,341,248,0.9840958,3,0,3,0.7272727272727273,
15,2,car,van,393,734,447,694,341,247,0.9653176,3,0,3,0.7243401759530792,
16,2,car,van,394,734,448,696,340,248,0.98267424,3,0,3,0.7294117647058823,
17,2,car,van,391,735,447,696,344,249,0.9889115,3,0,3,0.7238372093023255,
18,2,car,van,395,736,449,692,341,243,0.97513837,3,0,3,0.7126099706744868,
19,2,car,van,391,730,447,696,339,249,0.98842525,3,0,3,0.7345132743362832,
20,2,car,van,391,736,446,698,345,252,0.9883552,3,0,3,0.7304347826086957,
21,2,car,van,392,737,445,697,345,252,0.9894341,3,0,3,0.7304347826086957,
22,2,car,van,394,730,446,696,336,250,0.9868613,3,0,3,0.7440476190476191,
23,2,car,van,392,734,447,696,342,249,0.98804855,3,0,3,0.7280701754385965,
24,2,car,van,396,735,445,695,339,250,0.9873077,3,0,3,0.7374631268436578,
25,2,car,van,396,741,445,695,345,250,0.9892166,3,0,3,0.7246376811594203,
26,2,car,van,391,735,447,697,344,250,0.9818368,3,0,3,0.7267441860465116,
27,2,car,van,391,736,445,695,345,250,0.98718697,3,0,3,0.7246376811594203,
28,2,car,van,390,734,447,695,344,248,0.97756964,3,0,3,0.7209302325581395,
29,2,car,van,392,739,447,693,347,246,0.9871002,3,0,3,0.7089337175792507,
30,2,car,van,391,731,448,693,340,245,0.9821532,3,0,3,0.7205882352941176,
31,2,car,van,394,731,445,696,337,251,0.98827523,3,0,3,0.744807121661721,
32,2,car,van,393,740,447,695,347,248,0.97791225,3,0,3,0.7146974063400576,
33,2,car,van,392,739,446,692,347,246,0.9838788,3,0,3,0.7089337175792507,
34,2,car,van,165,1262,383,825,1097,442,0.22265343,3,0,3,0.4029170464904284,
35,2,car,van,249,754,434,748,505,314,0.9467645,3,0,3,0.4029170464904284,
36,2,car,van,158,1263,389,812,1105,423,0.27788413,3,30,3,0.38280542986425337,
37,2,car,van,248,759,437,744,511,307,0.95875967,3,30,3,0.38280542986425337,
0,2,car,van,395,737,448,692,342,244,0.9671838,3,0,3,0.7134502923976608,
1,2,car,van,393,739,447,693,346,246,0.98315847,3,0,3,0.7109826589595376,
2,2,car,van,394,733,447,695,339,248,0.97350967,3,0,3,0.7315634218289085,
3,2,car,van,392,735,445,697,343,252,0.9873547,3,0,3,0.7346938775510204,
4,2,car,van,395,736,447,694,341,247,0.9739385,3,0,3,0.7243401759530792,
5,2,car,van,390,736,447,696,346,249,0.98160815,3,0,3,0.7196531791907514,
6,2,car,van,395,739,445,695,344,250,0.9893474,3,0,3,0.7267441860465116,
7,2,car,van,396,733,447,694,337,247,0.9840608,3,0,3,0.7329376854599406,
8,2,car,van,390,733,444,697,343,253,0.98208946,3,0,3,0.7376093294460642,
9,2,car,van,390,736,446,698,346,252,0.9729815,3,0,3,0.7283236994219653,
10,2,car,van,390,735,444,696,345,252,0.97961944,3,0,3,0.7304347826086957,
11,2,car,van,392,736,446,694,344,248,0.9752692,3,0,3,0.7209302325581395,
12,2,car,van,396,736,449,696,340,247,0.96816504,3,0,3,0.7264705882352941,
13,2,car,van,394,737,446,697,343,251,0.98744214,3,0,3,0.7317784256559767,
14,2,car,van,394,733,444,698,339,254,0.9801131,3,0,3,0.7492625368731564,
15,2,car,van,395,736,447,695,341,248,0.9840958,3,0,3,0.7272727272727273,
16,2,car,van,393,734,447,694,341,247,0.9653176,3,0,3,0.7243401759530792,
17,2,car,van,394,734,448,696,340,248,0.98267424,3,0,3,0.7294117647058823,
18,2,car,van,391,735,447,696,344,249,0.9889115,3,0,3,0.7238372093023255,
19,2,car,van,395,736,449,692,341,243,0.97513837,3,0,3,0.7126099706744868,
20,2,car,van,391,730,447,696,339,249,0.98842525,3,0,3,0.7345132743362832,
21,2,car,van,391,736,446,698,345,252,0.9883552,3,0,3,0.7304347826086957,
22,2,car,van,392,737,445,697,345,252,0.9894341,3,0,3,0.7304347826086957,
23,2,car,van,394,730,446,696,336,250,0.9868613,3,0,3,0.7440476190476191,
24,2,car,van,392,734,447,696,342,249,0.98804855,3,0,3,0.7280701754385965,
25,2,car,van,396,735,445,695,339,250,0.9873077,3,0,3,0.7374631268436578,
26,2,car,van,396,741,445,695,345,250,0.9892166,3,0,3,0.7246376811594203,
27,2,car,van,391,735,447,697,344,250,0.9818368,3,0,3,0.7267441860465116,
28,2,car,van,391,736,445,695,345,250,0.98718697,3,0,3,0.7246376811594203,
29,2,car,van,390,734,447,695,344,248,0.97756964,3,0,3,0.7209302325581395,
30,2,car,van,392,739,447,693,347,246,0.9871002,3,0,3,0.7089337175792507,
31,2,car,van,391,731,448,693,340,245,0.9821532,3,0,3,0.7205882352941176,
32,2,car,van,394,731,445,696,337,251,0.98827523,3,0,3,0.744807121661721,
33,2,car,van,393,740,447,695,347,248,0.97791225,3,0,3,0.7146974063400576,
34,2,car,van,392,739,446,692,347,246,0.9838788,3,0,3,0.7089337175792507,
35,2,car,van,165,1262,383,825,1097,442,0.22265343,3,0,3,0.4029170464904284,
36,2,car,van,249,754,434,748,505,314,0.9467645,3,0,3,0.4029170464904284,
37,2,car,van,158,1263,389,812,1105,423,0.27788413,3,30,3,0.38280542986425337,
38,2,car,van,248,759,437,744,511,307,0.95875967,3,30,3,0.38280542986425337,
0,2,car,van,397,739,447,695,342,248,0.97543335,3,0,3,0.7251461988304093,
1,2,car,van,395,737,448,692,342,244,0.9671838,3,0,3,0.7134502923976608,
2,2,car,van,393,739,447,693,346,246,0.98315847,3,0,3,0.7109826589595376,
3,2,car,van,394,733,447,695,339,248,0.97350967,3,0,3,0.7315634218289085,
4,2,car,van,392,735,445,697,343,252,0.9873547,3,0,3,0.7346938775510204,
5,2,car,van,395,736,447,694,341,247,0.9739385,3,0,3,0.7243401759530792,
6,2,car,van,390,736,447,696,346,249,0.98160815,3,0,3,0.7196531791907514,
7,2,car,van,395,739,445,695,344,250,0.9893474,3,0,3,0.7267441860465116,
8,2,car,van,396,733,447,694,337,247,0.9840608,3,0,3,0.7329376854599406,
9,2,car,van,390,733,444,697,343,253,0.98208946,3,0,3,0.7376093294460642,
10,2,car,van,390,736,446,698,346,252,0.9729815,3,0,3,0.7283236994219653,
11,2,car,van,390,735,444,696,345,252,0.97961944,3,0,3,0.7304347826086957,
12,2,car,van,392,736,446,694,344,248,0.9752692,3,0,3,0.7209302325581395,
13,2,car,van,396,736,449,696,340,247,0.96816504,3,0,3,0.7264705882352941,
14,2,car,van,394,737,446,697,343,251,0.98744214,3,0,3,0.7317784256559767,
15,2,car,van,394,733,444,698,339,254,0.9801131,3,0,3,0.7492625368731564,
16,2,car,van,395,736,447,695,341,248,0.9840958,3,0,3,0.7272727272727273,
17,2,car,van,393,734,447,694,341,247,0.9653176,3,0,3,0.7243401759530792,
18,2,car,van,394,734,448,696,340,248,0.98267424,3,0,3,0.7294117647058823,
19,2,car,van,391,735,447,696,344,249,0.9889115,3,0,3,0.7238372093023255,
20,2,car,van,395,736,449,692,341,243,0.97513837,3,0,3,0.7126099706744868,
21,2,car,van,391,730,447,696,339,249,0.98842525,3,0,3,0.7345132743362832,
22,2,car,van,391,736,446,698,345,252,0.9883552,3,0,3,0.7304347826086957,
23,2,car,van,392,737,445,697,345,252,0.9894341,3,0,3,0.7304347826086957,
24,2,car,van,394,730,446,696,336,250,0.9868613,3,0,3,0.7440476190476191,
25,2,car,van,392,734,447,696,342,249,0.98804855,3,0,3,0.7280701754385965,
26,2,car,van,396,735,445,695,339,250,0.9873077,3,0,3,0.7374631268436578,
27,2,car,van,396,741,445,695,345,250,0.9892166,3,0,3,0.7246376811594203,
28,2,car,van,391,735,447,697,344,250,0.9818368,3,0,3,0.7267441860465116,
29,2,car,van,391,736,445,695,345,250,0.98718697,3,0,3,0.7246376811594203,
30,2,car,van,390,734,447,695,344,248,0.97756964,3,0,3,0.7209302325581395,
31,2,car,van,392,739,447,693,347,246,0.9871002,3,0,3,0.7089337175792507,
32,2,car,van,391,731,448,693,340,245,0.9821532,3,0,3,0.7205882352941176,
33,2,car,van,394,731,445,696,337,251,0.98827523,3,0,3,0.744807121661721,
34,2,car,van,393,740,447,695,347,248,0.97791225,3,0,3,0.7146974063400576,
35,2,car,van,392,739,446,692,347,246,0.9838788,3,0,3,0.7089337175792507,
36,2,car,van,165,1262,383,825,1097,442,0.22265343,3,0,3,0.4029170464904284,
37,2,car,van,249,754,434,748,505,314,0.9467645,3,0,3,0.4029170464904284,
38,2,car,van,158,1263,389,812,1105,423,0.27788413,3,30,3,0.38280542986425337,
39,2,car,van,248,759,437,744,511,307,0.95875967,3,30,3,0.38280542986425337,
0,2,car,van,388,738,446,698,350,252,0.9766933,3,0,3,0.72,
1,2,car,van,397,739,447,695,342,248,0.97543335,3,0,3,0.7251461988304093,
2,2,car,van,395,737,448,692,342,244,0.9671838,3,0,3,0.7134502923976608,
3,2,car,van,393,739,447,693,346,246,0.98315847,3,0,3,0.7109826589595376,
4,2,car,van,394,733,447,695,339,248,0.97350967,3,0,3,0.7315634218289085,
5,2,car,van,392,735,445,697,343,252,0.9873547,3,0,3,0.7346938775510204,
6,2,car,van,395,736,447,694,341,247,0.9739385,3,0,3,0.7243401759530792,
7,2,car,van,390,736,447,696,346,249,0.98160815,3,0,3,0.7196531791907514,
8,2,car,van,395,739,445,695,344,250,0.9893474,3,0,3,0.7267441860465116,
9,2,car,van,396,733,447,694,337,247,0.9840608,3,0,3,0.7329376854599406,
10,2,car,van,390,733,444,697,343,253,0.98208946,3,0,3,0.7376093294460642,
11,2,car,van,390,736,446,698,346,252,0.9729815,3,0,3,0.7283236994219653,
12,2,car,van,390,735,444,696,345,252,0.97961944,3,0,3,0.7304347826086957,
13,2,car,van,392,736,446,694,344,248,0.9752692,3,0,3,0.7209302325581395,
14,2,car,van,396,736,449,696,340,247,0.96816504,3,0,3,0.7264705882352941,
15,2,car,van,394,737,446,697,343,251,0.98744214,3,0,3,0.7317784256559767,
16,2,car,van,394,733,444,698,339,254,0.9801131,3,0,3,0.7492625368731564,
17,2,car,van,395,736,447,695,341,248,0.9840958,3,0,3,0.7272727272727273,
18,2,car,van,393,734,447,694,341,247,0.9653176,3,0,3,0.7243401759530792,
19,2,car,van,394,734,448,696,340,248,0.98267424,3,0,3,0.7294117647058823,
20,2,car,van,391,735,447,696,344,249,0.9889115,3,0,3,0.7238372093023255,
21,2,car,van,395,736,449,692,341,243,0.97513837,3,0,3,0.7126099706744868,
22,2,car,van,391,730,447,696,339,249,0.98842525,3,0,3,0.7345132743362832,
23,2,car,van,391,736,446,698,345,252,0.9883552,3,0,3,0.7304347826086957,
24,2,car,van,392,737,445,697,345,252,0.9894341,3,0,3,0.7304347826086957,
25,2,car,van,394,730,446,696,336,250,0.9868613,3,0,3,0.7440476190476191,
26,2,car,van,392,734,447,696,342,249,0.98804855,3,0,3,0.7280701754385965,
27,2,car,van,396,735,445,695,339,250,0.9873077,3,0,3,0.7374631268436578,
28,2,car,van,396,741,445,695,345,250,0.9892166,3,0,3,0.7246376811594203,
29,2,car,van,391,735,447,697,344,250,0.9818368,3,0,3,0.7267441860465116,
30,2,car,van,391,736,445,695,345,250,0.98718697,3,0,3,0.7246376811594203,
31,2,car,van,390,734,447,695,344,248,0.97756964,3,0,3,0.7209302325581395,
32,2,car,van,392,739,447,693,347,246,0.9871002,3,0,3,0.7089337175792507,
33,2,car,van,391,731,448,693,340,245,0.9821532,3,0,3,0.7205882352941176,
34,2,car,van,394,731,445,696,337,251,0.98827523,3,0,3,0.744807121661721,
35,2,car,van,393,740,447,695,347,248,0.97791225,3,0,3,0.7146974063400576,
36,2,car,van,392,739,446,692,347,246,0.9838788,3,0,3,0.7089337175792507,
37,2,car,van,165,1262,383,825,1097,442,0.22265343,3,0,3,0.4029170464904284,
38,2,car,van,249,754,434,748,505,314,0.9467645,3,0,3,0.4029170464904284,
39,2,car,van,158,1263,389,812,1105,423,0.27788413,3,30,3,0.38280542986425337,
40,2,car,van,248,759,437,744,511,307,0.95875967,3,30,3,0.38280542986425337,
0,2,car,van,396,737,449,694,341,245,0.98426396,3,0,3,0.718475073313783,
1,2,car,van,388,738,446,698,350,252,0.9766933,3,0,3,0.72,
2,2,car,van,397,739,447,695,342,248,0.97543335,3,0,3,0.7251461988304093,
3,2,car,van,395,737,448,692,342,244,0.9671838,3,0,3,0.7134502923976608,
4,2,car,van,393,739,447,693,346,246,0.98315847,3,0,3,0.7109826589595376,
5,2,car,van,394,733,447,695,339,248,0.97350967,3,0,3,0.7315634218289085,
6,2,car,van,392,735,445,697,343,252,0.9873547,3,0,3,0.7346938775510204,
7,2,car,van,395,736,447,694,341,247,0.9739385,3,0,3,0.7243401759530792,
8,2,car,van,390,736,447,696,346,249,0.98160815,3,0,3,0.7196531791907514,
9,2,car,van,395,739,445,695,344,250,0.9893474,3,0,3,0.7267441860465116,
10,2,car,van,396,733,447,694,337,247,0.9840608,3,0,3,0.7329376854599406,
11,2,car,van,390,733,444,697,343,253,0.98208946,3,0,3,0.7376093294460642,
12,2,car,van,390,736,446,698,346,252,0.9729815,3,0,3,0.7283236994219653,
13,2,car,van,390,735,444,696,345,252,0.97961944,3,0,3,0.7304347826086957,
14,2,car,van,392,736,446,694,344,248,0.9752692,3,0,3,0.7209302325581395,
15,2,car,van,396,736,449,696,340,247,0.96816504,3,0,3,0.7264705882352941,
16,2,car,van,394,737,446,697,343,251,0.98744214,3,0,3,0.7317784256559767,
17,2,car,van,394,733,444,698,339,254,0.9801131,3,0,3,0.7492625368731564,
18,2,car,van,395,736,447,695,341,248,0.9840958,3,0,3,0.7272727272727273,
19,2,car,van,393,734,447,694,341,247,0.9653176,3,0,3,0.7243401759530792,
20,2,car,van,394,734,448,696,340,248,0.98267424,3,0,3,0.7294117647058823,
21,2,car,van,391,735,447,696,344,249,0.9889115,3,0,3,0.7238372093023255,
22,2,car,van,395,736,449,692,341,243,0.97513837,3,0,3,0.7126099706744868,
23,2,car,van,391,730,447,696,339,249,0.98842525,3,0,3,0.7345132743362832,
24,2,car,van,391,736,446,698,345,252,0.9883552,3,0,3,0.7304347826086957,
25,2,car,van,392,737,445,697,345,252,0.9894341,3,0,3,0.7304347826086957,
26,2,car,van,394,730,446,696,336,250,0.9868613,3,0,3,0.7440476190476191,
27,2,car,van,392,734,447,696,342,249,0.98804855,3,0,3,0.7280701754385965,
28,2,car,van,396,735,445,695,339,250,0.9873077,3,0,3,0.7374631268436578,
29,2,car,van,396,741,445,695,345,250,0.9892166,3,0,3,0.7246376811594203,
30,2,car,van,391,735,447,697,344,250,0.9818368,3,0,3,0.7267441860465116,
31,2,car,van,391,736,445,695,345,250,0.98718697,3,0,3,0.7246376811594203,
32,2,car,van,390,734,447,695,344,248,0.97756964,3,0,3,0.7209302325581395,
33,2,car,van,392,739,447,693,347,246,0.9871002,3,0,3,0.7089337175792507,
34,2,car,van,391,731,448,693,340,245,0.9821532,3,0,3,0.7205882352941176,
35,2,car,van,394,731,445,696,337,251,0.98827523,3,0,3,0.744807121661721,
36,2,car,van,393,740,447,695,347,248,0.97791225,3,0,3,0.7146974063400576,
37,2,car,van,392,739,446,692,347,246,0.9838788,3,0,3,0.7089337175792507,
38,2,car,van,165,1262,383,825,1097,442,0.22265343,3,0,3,0.4029170464904284,
39,2,car,van,249,754,434,748,505,314,0.9467645,3,0,3,0.4029170464904284,
40,2,car,van,158,1263,389,812,1105,423,0.27788413,3,30,3,0.38280542986425337,
41,2,car,van,248,759,437,744,511,307,0.95875967,3,30,3,0.38280542986425337,
0,2,car,van,395,735,446,694,340,248,0.9673877,3,0,3,0.7294117647058823,
1,2,car,van,396,737,449,694,341,245,0.98426396,3,0,3,0.718475073313783,
2,2,car,van,388,738,446,698,350,252,0.9766933,3,0,3,0.72,
3,2,car,van,397,739,447,695,342,248,0.97543335,3,0,3,0.7251461988304093,
4,2,car,van,395,737,448,692,342,244,0.9671838,3,0,3,0.7134502923976608,
5,2,car,van,393,739,447,693,346,246,0.98315847,3,0,3,0.7109826589595376,
6,2,car,van,394,733,447,695,339,248,0.97350967,3,0,3,0.7315634218289085,
7,2,car,van,392,735,445,697,343,252,0.9873547,3,0,3,0.7346938775510204,
8,2,car,van,395,736,447,694,341,247,0.9739385,3,0,3,0.7243401759530792,
9,2,car,van,390,736,447,696,346,249,0.98160815,3,0,3,0.7196531791907514,
10,2,car,van,395,739,445,695,344,250,0.9893474,3,0,3,0.7267441860465116,
11,2,car,van,396,733,447,694,337,247,0.9840608,3,0,3,0.7329376854599406,
12,2,car,van,390,733,444,697,343,253,0.98208946,3,0,3,0.7376093294460642,
13,2,car,van,390,736,446,698,346,252,0.9729815,3,0,3,0.7283236994219653,
14,2,car,van,390,735,444,696,345,252,0.97961944,3,0,3,0.7304347826086957,
15,2,car,van,392,736,446,694,344,248,0.9752692,3,0,3,0.7209302325581395,
16,2,car,van,396,736,449,696,340,247,0.96816504,3,0,3,0.7264705882352941,
17,2,car,van,394,737,446,697,343,251,0.98744214,3,0,3,0.7317784256559767,
18,2,car,van,394,733,444,698,339,254,0.9801131,3,0,3,0.7492625368731564,
19,2,car,van,395,736,447,695,341,248,0.9840958,3,0,3,0.7272727272727273,
20,2,car,van,393,734,447,694,341,247,0.9653176,3,0,3,0.7243401759530792,
21,2,car,van,394,734,448,696,340,248,0.98267424,3,0,3,0.7294117647058823,
22,2,car,van,391,735,447,696,344,249,0.9889115,3,0,3,0.7238372093023255,
23,2,car,van,395,736,449,692,341,243,0.97513837,3,0,3,0.7126099706744868,
24,2,car,van,391,730,447,696,339,249,0.98842525,3,0,3,0.7345132743362832,
25,2,car,van,391,736,446,698,345,252,0.9883552,3,0,3,0.7304347826086957,
26,2,car,van,392,737,445,697,345,252,0.9894341,3,0,3,0.7304347826086957,
27,2,car,van,394,730,446,696,336,250,0.9868613,3,0,3,0.7440476190476191,
28,2,car,van,392,734,447,696,342,249,0.98804855,3,0,3,0.7280701754385965,
29,2,car,van,396,735,445,695,339,250,0.9873077,3,0,3,0.7374631268436578,
30,2,car,van,396,741,445,695,345,250,0.9892166,3,0,3,0.7246376811594203,
31,2,car,van,391,735,447,697,344,250,0.9818368,3,0,3,0.7267441860465116,
32,2,car,van,391,736,445,695,345,250,0.98718697,3,0,3,0.7246376811594203,
33,2,car,van,390,734,447,695,344,248,0.97756964,3,0,3,0.7209302325581395,
34,2,car,van,392,739,447,693,347,246,0.9871002,3,0,3,0.7089337175792507,
35,2,car,van,391,731,448,693,340,245,0.9821532,3,0,3,0.7205882352941176,
36,2,car,van,394,731,445,696,337,251,0.98827523,3,0,3,0.744807121661721,
37,2,car,van,393,740,447,695,347,248,0.97791225,3,0,3,0.7146974063400576,
38,2,car,van,392,739,446,692,347,246,0.9838788,3,0,3,0.7089337175792507,
39,2,car,van,165,1262,383,825,1097,442,0.22265343,3,0,3,0.4029170464904284,
40,2,car,van,249,754,434,748,505,314,0.9467645,3,0,3,0.4029170464904284,
41,2,car,van,158,1263,389,812,1105,423,0.27788413,3,30,3,0.38280542986425337,
42,2,car,van,248,759,437,744,511,307,0.95875967,3,30,3,0.38280542986425337,
0,2,car,van,390,736,446,696,346,250,0.9762527,3,0,3,0.7225433526011561,
1,2,car,van,395,735,446,694,340,248,0.9673877,3,0,3,0.7294117647058823,
2,2,car,van,396,737,449,694,341,245,0.98426396,3,0,3,0.718475073313783,
3,2,car,van,388,738,446,698,350,252,0.9766933,3,0,3,0.72,
4,2,car,van,397,739,447,695,342,248,0.97543335,3,0,3,0.7251461988304093,
5,2,car,van,395,737,448,692,342,244,0.9671838,3,0,3,0.7134502923976608,
6,2,car,van,393,739,447,693,346,246,0.98315847,3,0,3,0.7109826589595376,
7,2,car,van,394,733,447,695,339,248,0.97350967,3,0,3,0.7315634218289085,
8,2,car,van,392,735,445,697,343,252,0.9873547,3,0,3,0.7346938775510204,
9,2,car,van,395,736,447,694,341,247,0.9739385,3,0,3,0.7243401759530792,
10,2,car,van,390,736,447,696,346,249,0.98160815,3,0,3,0.7196531791907514,
11,2,car,van,395,739,445,695,344,250,0.9893474,3,0,3,0.7267441860465116,
12,2,car,van,396,733,447,694,337,247,0.9840608,3,0,3,0.7329376854599406,
13,2,car,van,390,733,444,697,343,253,0.98208946,3,0,3,0.7376093294460642,
14,2,car,van,390,736,446,698,346,252,0.9729815,3,0,3,0.7283236994219653,
15,2,car,van,390,735,444,696,345,252,0.97961944,3,0,3,0.7304347826086957,
16,2,car,van,392,736,446,694,344,248,0.9752692,3,0,3,0.7209302325581395,
17,2,car,van,396,736,449,696,340,247,0.96816504,3,0,3,0.7264705882352941,
18,2,car,van,394,737,446,697,343,251,0.98744214,3,0,3,0.7317784256559767,
19,2,car,van,394,733,444,698,339,254,0.9801131,3,0,3,0.7492625368731564,
20,2,car,van,395,736,447,695,341,248,0.9840958,3,0,3,0.7272727272727273,
21,2,car,van,393,734,447,694,341,247,0.9653176,3,0,3,0.7243401759530792,
22,2,car,van,394,734,448,696,340,248,0.98267424,3,0,3,0.7294117647058823,
23,2,car,van,391,735,447,696,344,249,0.9889115,3,0,3,0.7238372093023255,
24,2,car,van,395,736,449,692,341,243,0.97513837,3,0,3,0.7126099706744868,
25,2,car,van,391,730,447,696,339,249,0.98842525,3,0,3,0.7345132743362832,
26,2,car,van,391,736,446,698,345,252,0.9883552,3,0,3,0.7304347826086957,
27,2,car,van,392,737,445,697,345,252,0.9894341,3,0,3,0.7304347826086957,
28,2,car,van,394,730,446,696,336,250,0.9868613,3,0,3,0.7440476190476191,
29,2,car,van,392,734,447,696,342,249,0.98804855,3,0,3,0.7280701754385965,
30,2,car,van,396,735,445,695,339,250,0.9873077,3,0,3,0.7374631268436578,
31,2,car,van,396,741,445,695,345,250,0.9892166,3,0,3,0.7246376811594203,
32,2,car,van,391,735,447,697,344,250,0.9818368,3,0,3,0.7267441860465116,
33,2,car,van,391,736,445,695,345,250,0.98718697,3,0,3,0.7246376811594203,
34,2,car,van,390,734,447,695,344,248,0.97756964,3,0,3,0.7209302325581395,
35,2,car,van,392,739,447,693,347,246,0.9871002,3,0,3,0.7089337175792507,
36,2,car,van,391,731,448,693,340,245,0.9821532,3,0,3,0.7205882352941176,
37,2,car,van,394,731,445,696,337,251,0.98827523,3,0,3,0.744807121661721,
38,2,car,van,393,740,447,695,347,248,0.97791225,3,0,3,0.7146974063400576,
39,2,car,van,392,739,446,692,347,246,0.9838788,3,0,3,0.7089337175792507,
40,2,car,van,165,1262,383,825,1097,442,0.22265343,3,0,3,0.4029170464904284,
41,2,car,van,249,754,434,748,505,314,0.9467645,3,0,3,0.4029170464904284,
42,2,car,van,158,1263,389,812,1105,423,0.27788413,3,30,3,0.38280542986425337,
43,2,car,van,248,759,437,744,511,307,0.95875967,3,30,3,0.38280542986425337,
0,2,car,van,390,734,446,691,344,245,0.973118,3,0,3,0.7122093023255814,
1,2,car,van,390,736,446,696,346,250,0.9762527,3,0,3,0.7225433526011561,
2,2,car,van,395,735,446,694,340,248,0.9673877,3,0,3,0.7294117647058823,
3,2,car,van,396,737,449,694,341,245,0.98426396,3,0,3,0.718475073313783,
4,2,car,van,388,738,446,698,350,252,0.9766933,3,0,3,0.72,
5,2,car,van,397,739,447,695,342,248,0.97543335,3,0,3,0.7251461988304093,
6,2,car,van,395,737,448,692,342,244,0.9671838,3,0,3,0.7134502923976608,
7,2,car,van,393,739,447,693,346,246,0.98315847,3,0,3,0.7109826589595376,
8,2,car,van,394,733,447,695,339,248,0.97350967,3,0,3,0.7315634218289085,
9,2,car,van,392,735,445,697,343,252,0.9873547,3,0,3,0.7346938775510204,
10,2,car,van,395,736,447,694,341,247,0.9739385,3,0,3,0.7243401759530792,
11,2,car,van,390,736,447,696,346,249,0.98160815,3,0,3,0.7196531791907514,
12,2,car,van,395,739,445,695,344,250,0.9893474,3,0,3,0.7267441860465116,
13,2,car,van,396,733,447,694,337,247,0.9840608,3,0,3,0.7329376854599406,
14,2,car,van,390,733,444,697,343,253,0.98208946,3,0,3,0.7376093294460642,
15,2,car,van,390,736,446,698,346,252,0.9729815,3,0,3,0.7283236994219653,
16,2,car,van,390,735,444,696,345,252,0.97961944,3,0,3,0.7304347826086957,
17,2,car,van,392,736,446,694,344,248,0.9752692,3,0,3,0.7209302325581395,
18,2,car,van,396,736,449,696,340,247,0.96816504,3,0,3,0.7264705882352941,
19,2,car,van,394,737,446,697,343,251,0.98744214,3,0,3,0.7317784256559767,
20,2,car,van,394,733,444,698,339,254,0.9801131,3,0,3,0.7492625368731564,
21,2,car,van,395,736,447,695,341,248,0.9840958,3,0,3,0.7272727272727273,
22,2,car,van,393,734,447,694,341,247,0.9653176,3,0,3,0.7243401759530792,
23,2,car,van,394,734,448,696,340,248,0.98267424,3,0,3,0.7294117647058823,
24,2,car,van,391,735,447,696,344,249,0.9889115,3,0,3,0.7238372093023255,
25,2,car,van,395,736,449,692,341,243,0.97513837,3,0,3,0.7126099706744868,
26,2,car,van,391,730,447,696,339,249,0.98842525,3,0,3,0.7345132743362832,
27,2,car,van,391,736,446,698,345,252,0.9883552,3,0,3,0.7304347826086957,
28,2,car,van,392,737,445,697,345,252,0.9894341,3,0,3,0.7304347826086957,
29,2,car,van,394,730,446,696,336,250,0.9868613,3,0,3,0.7440476190476191,
30,2,car,van,392,734,447,696,342,249,0.98804855,3,0,3,0.7280701754385965,
31,2,car,van,396,735,445,695,339,250,0.9873077,3,0,3,0.7374631268436578,
32,2,car,van,396,741,445,695,345,250,0.9892166,3,0,3,0.7246376811594203,
33,2,car,van,391,735,447,697,344,250,0.9818368,3,0,3,0.7267441860465116,
34,2,car,van,391,736,445,695,345,250,0.98718697,3,0,3,0.7246376811594203,
35,2,car,van,390,734,447,695,344,248,0.97756964,3,0,3,0.7209302325581395,
36,2,car,van,392,739,447,693,347,246,0.9871002,3,0,3,0.7089337175792507,
37,2,car,van,391,731,448,693,340,245,0.9821532,3,0,3,0.7205882352941176,
38,2,car,van,394,731,445,696,337,251,0.98827523,3,0,3,0.744807121661721,
39,2,car,van,393,740,447,695,347,248,0.97791225,3,0,3,0.7146974063400576,
40,2,car,van,392,739,446,692,347,246,0.9838788,3,0,3,0.7089337175792507,
41,2,car,van,165,1262,383,825,1097,442,0.22265343,3,0,3,0.4029170464904284,
42,2,car,van,249,754,434,748,505,314,0.9467645,3,0,3,0.4029170464904284,
43,2,car,van,158,1263,389,812,1105,423,0.27788413,3,30,3,0.38280542986425337,
44,2,car,van,248,759,437,744,511,307,0.95875967,3,30,3,0.38280542986425337,
0,2,car,van,394,734,447,696,340,249,0.98190403,3,0,3,0.7323529411764705,
1,2,car,van,390,734,446,691,344,245,0.973118,3,0,3,0.7122093023255814,
2,2,car,van,390,736,446,696,346,250,0.9762527,3,0,3,0.7225433526011561,
3,2,car,van,395,735,446,694,340,248,0.9673877,3,0,3,0.7294117647058823,
4,2,car,van,396,737,449,694,341,245,0.98426396,3,0,3,0.718475073313783,
5,2,car,van,388,738,446,698,350,252,0.9766933,3,0,3,0.72,
6,2,car,van,397,739,447,695,342,248,0.97543335,3,0,3,0.7251461988304093,
7,2,car,van,395,737,448,692,342,244,0.9671838,3,0,3,0.7134502923976608,
8,2,car,van,393,739,447,693,346,246,0.98315847,3,0,3,0.7109826589595376,
9,2,car,van,394,733,447,695,339,248,0.97350967,3,0,3,0.7315634218289085,
10,2,car,van,392,735,445,697,343,252,0.9873547,3,0,3,0.7346938775510204,
11,2,car,van,395,736,447,694,341,247,0.9739385,3,0,3,0.7243401759530792,
12,2,car,van,390,736,447,696,346,249,0.98160815,3,0,3,0.7196531791907514,
13,2,car,van,395,739,445,695,344,250,0.9893474,3,0,3,0.7267441860465116,
14,2,car,van,396,733,447,694,337,247,0.9840608,3,0,3,0.7329376854599406,
15,2,car,van,390,733,444,697,343,253,0.98208946,3,0,3,0.7376093294460642,
16,2,car,van,390,736,446,698,346,252,0.9729815,3,0,3,0.7283236994219653,
17,2,car,van,390,735,444,696,345,252,0.97961944,3,0,3,0.7304347826086957,
18,2,car,van,392,736,446,694,344,248,0.9752692,3,0,3,0.7209302325581395,
19,2,car,van,396,736,449,696,340,247,0.96816504,3,0,3,0.7264705882352941,
20,2,car,van,394,737,446,697,343,251,0.98744214,3,0,3,0.7317784256559767,
21,2,car,van,394,733,444,698,339,254,0.9801131,3,0,3,0.7492625368731564,
22,2,car,van,395,736,447,695,341,248,0.9840958,3,0,3,0.7272727272727273,
23,2,car,van,393,734,447,694,341,247,0.9653176,3,0,3,0.7243401759530792,
24,2,car,van,394,734,448,696,340,248,0.98267424,3,0,3,0.7294117647058823,
25,2,car,van,391,735,447,696,344,249,0.9889115,3,0,3,0.7238372093023255,
26,2,car,van,395,736,449,692,341,243,0.97513837,3,0,3,0.7126099706744868,
27,2,car,van,391,730,447,696,339,249,0.98842525,3,0,3,0.7345132743362832,
28,2,car,van,391,736,446,698,345,252,0.9883552,3,0,3,0.7304347826086957,
29,2,car,van,392,737,445,697,345,252,0.9894341,3,0,3,0.7304347826086957,
30,2,car,van,394,730,446,696,336,250,0.9868613,3,0,3,0.7440476190476191,
31,2,car,van,392,734,447,696,342,249,0.98804855,3,0,3,0.7280701754385965,
32,2,car,van,396,735,445,695,339,250,0.9873077,3,0,3,0.7374631268436578,
33,2,car,van,396,741,445,695,345,250,0.9892166,3,0,3,0.7246376811594203,
34,2,car,van,391,735,447,697,344,250,0.9818368,3,0,3,0.7267441860465116,
35,2,car,van,391,736,445,695,345,250,0.98718697,3,0,3,0.7246376811594203,
36,2,car,van,390,734,447,695,344,248,0.97756964,3,0,3,0.7209302325581395,
37,2,car,van,392,739,447,693,347,246,0.9871002,3,0,3,0.7089337175792507,
38,2,car,van,391,731,448,693,340,245,0.9821532,3,0,3,0.7205882352941176,
39,2,car,van,394,731,445,696,337,251,0.98827523,3,0,3,0.744807121661721,
40,2,car,van,393,740,447,695,347,248,0.97791225,3,0,3,0.7146974063400576,
41,2,car,van,392,739,446,692,347,246,0.9838788,3,0,3,0.7089337175792507,
42,2,car,van,165,1262,383,825,1097,442,0.22265343,3,0,3,0.4029170464904284,
43,2,car,van,249,754,434,748,505,314,0.9467645,3,0,3,0.4029170464904284,
44,2,car,van,158,1263,389,812,1105,423,0.27788413,3,30,3,0.38280542986425337,
45,2,car,van,248,759,437,744,511,307,0.95875967,3,30,3,0.38280542986425337,
0,2,car,van,393,734,446,695,341,249,0.9891658,3,0,3,0.7302052785923754,
1,2,car,van,394,734,447,696,340,249,0.98190403,3,0,3,0.7323529411764705,
2,2,car,van,390,734,446,691,344,245,0.973118,3,0,3,0.7122093023255814,
3,2,car,van,390,736,446,696,346,250,0.9762527,3,0,3,0.7225433526011561,
4,2,car,van,395,735,446,694,340,248,0.9673877,3,0,3,0.7294117647058823,
5,2,car,van,396,737,449,694,341,245,0.98426396,3,0,3,0.718475073313783,
6,2,car,van,388,738,446,698,350,252,0.9766933,3,0,3,0.72,
7,2,car,van,397,739,447,695,342,248,0.97543335,3,0,3,0.7251461988304093,
8,2,car,van,395,737,448,692,342,244,0.9671838,3,0,3,0.7134502923976608,
9,2,car,van,393,739,447,693,346,246,0.98315847,3,0,3,0.7109826589595376,
10,2,car,van,394,733,447,695,339,248,0.97350967,3,0,3,0.7315634218289085,
11,2,car,van,392,735,445,697,343,252,0.9873547,3,0,3,0.7346938775510204,
12,2,car,van,395,736,447,694,341,247,0.9739385,3,0,3,0.7243401759530792,
13,2,car,van,390,736,447,696,346,249,0.98160815,3,0,3,0.7196531791907514,
14,2,car,van,395,739,445,695,344,250,0.9893474,3,0,3,0.7267441860465116,
15,2,car,van,396,733,447,694,337,247,0.9840608,3,0,3,0.7329376854599406,
16,2,car,van,390,733,444,697,343,253,0.98208946,3,0,3,0.7376093294460642,
17,2,car,van,390,736,446,698,346,252,0.9729815,3,0,3,0.7283236994219653,
18,2,car,van,390,735,444,696,345,252,0.97961944,3,0,3,0.7304347826086957,
19,2,car,van,392,736,446,694,344,248,0.9752692,3,0,3,0.7209302325581395,
20,2,car,van,396,736,449,696,340,247,0.96816504,3,0,3,0.7264705882352941,
21,2,car,van,394,737,446,697,343,251,0.98744214,3,0,3,0.7317784256559767,
22,2,car,van,394,733,444,698,339,254,0.9801131,3,0,3,0.7492625368731564,
23,2,car,van,395,736,447,695,341,248,0.9840958,3,0,3,0.7272727272727273,
24,2,car,van,393,734,447,694,341,247,0.9653176,3,0,3,0.7243401759530792,
25,2,car,van,394,734,448,696,340,248,0.98267424,3,0,3,0.7294117647058823,
26,2,car,van,391,735,447,696,344,249,0.9889115,3,0,3,0.7238372093023255,
27,2,car,van,395,736,449,692,341,243,0.97513837,3,0,3,0.7126099706744868,
28,2,car,van,391,730,447,696,339,249,0.98842525,3,0,3,0.7345132743362832,
29,2,car,van,391,736,446,698,345,252,0.9883552,3,0,3,0.7304347826086957,
30,2,car,van,392,737,445,697,345,252,0.9894341,3,0,3,0.7304347826086957,
31,2,car,van,394,730,446,696,336,250,0.9868613,3,0,3,0.7440476190476191,
32,2,car,van,392,734,447,696,342,249,0.98804855,3,0,3,0.7280701754385965,
33,2,car,van,396,735,445,695,339,250,0.9873077,3,0,3,0.7374631268436578,
34,2,car,van,396,741,445,695,345,250,0.9892166,3,0,3,0.7246376811594203,
35,2,car,van,391,735,447,697,344,250,0.9818368,3,0,3,0.7267441860465116,
36,2,car,van,391,736,445,695,345,250,0.98718697,3,0,3,0.7246376811594203,
37,2,car,van,390,734,447,695,344,248,0.97756964,3,0,3,0.7209302325581395,
38,2,car,van,392,739,447,693,347,246,0.9871002,3,0,3,0.7089337175792507,
39,2,car,van,391,731,448,693,340,245,0.9821532,3,0,3,0.7205882352941176,
40,2,car,van,394,731,445,696,337,251,0.98827523,3,0,3,0.744807121661721,
41,2,car,van,393,740,447,695,347,248,0.97791225,3,0,3,0.7146974063400576,
42,2,car,van,392,739,446,692,347,246,0.9838788,3,0,3,0.7089337175792507,
43,2,car,van,165,1262,383,825,1097,442,0.22265343,3,0,3,0.4029170464904284,
44,2,car,van,249,754,434,748,505,314,0.9467645,3,0,3,0.4029170464904284,
45,2,car,van,158,1263,389,812,1105,423,0.27788413,3,30,3,0.38280542986425337,
46,2,car,van,248,759,437,744,511,307,0.95875967,3,30,3,0.38280542986425337,
